County,Claim Month/ Year,ProgramCode,Year,Name,Meal Group,Days Served,Free Eligible,Reduced Eligible,Paid Eligible,Enroll,Free Meals,Reduced Meals,Paid Meals,Total Meals,Average Daily Meals
SAN DIEGO,Oct 2014,CACF,2015,A PLACE OF OUR OWN CHILD,CHILD_BREAKFAST,23,57,4,5,66,692,49,60,801,34.8261
SAN DIEGO,Oct 2014,CACF,2015,A PLACE OF OUR OWN CHILD,CHILD_LUNCH,23,57,4,5,66,823,58,72,953,41.4348
SAN DIEGO,Oct 2014,CACF,2015,A PLACE OF OUR OWN CHILD,CHILD_SNACK_PM,23,57,4,5,66,435,31,38,504,21.913
SAN DIEGO,Oct 2014,CACF,2015,A PLACE OF OUR OWN CHILD,OSCH_CHILD_BREAKFAST,23,29,0,1,30,29,0,1,30,1.3043
SAN DIEGO,Oct 2014,CACF,2015,A PLACE OF OUR OWN CHILD,OSCH_CHILD_LUNCH,23,29,0,1,30,73,0,2,75,3.2609
SAN DIEGO,Oct 2014,CACF,2015,A PLACE OF OUR OWN CHILD,OSCH_CHILD_SNACK_PM,23,29,0,1,30,466,0,16,482,20.9565
SAN DIEGO,Nov 2014,CACF,2015,A PLACE OF OUR OWN CHILD,CHILD_BREAKFAST,18,57,4,5,66,598,42,52,692,38.4444
SAN DIEGO,Nov 2014,CACF,2015,A PLACE OF OUR OWN CHILD,CHILD_LUNCH,18,57,4,5,66,631,44,56,731,40.6111
SAN DIEGO,Nov 2014,CACF,2015,A PLACE OF OUR OWN CHILD,CHILD_SNACK_PM,18,57,4,5,66,307,22,27,356,19.7778
SAN DIEGO,Nov 2014,CACF,2015,A PLACE OF OUR OWN CHILD,OSCH_CHILD_BREAKFAST,18,29,0,1,30,42,0,1,43,2.3889
SAN DIEGO,Nov 2014,CACF,2015,A PLACE OF OUR OWN CHILD,OSCH_CHILD_LUNCH,18,29,0,1,30,61,0,2,63,3.5
SAN DIEGO,Nov 2014,CACF,2015,A PLACE OF OUR OWN CHILD,OSCH_CHILD_SNACK_PM,18,29,0,1,30,262,0,9,271,15.0556
SAN DIEGO,Dec 2014,CACF,2015,A PLACE OF OUR OWN CHILD,CHILD_BREAKFAST,19,67,7,1,75,670,70,10,750,39.4737
SAN DIEGO,Dec 2014,CACF,2015,A PLACE OF OUR OWN CHILD,CHILD_LUNCH,19,67,7,1,75,797,83,12,892,46.9474
SAN DIEGO,Dec 2014,CACF,2015,A PLACE OF OUR OWN CHILD,CHILD_SNACK_PM,19,67,7,1,75,402,42,6,450,23.6842
SAN DIEGO,Dec 2014,CACF,2015,A PLACE OF OUR OWN CHILD,OSCH_CHILD_BREAKFAST,19,25,0,2,27,37,0,3,40,2.1053
SAN DIEGO,Dec 2014,CACF,2015,A PLACE OF OUR OWN CHILD,OSCH_CHILD_LUNCH,19,25,0,2,27,413,0,33,446,23.4737
SAN DIEGO,Dec 2014,CACF,2015,A PLACE OF OUR OWN CHILD,OSCH_CHILD_SNACK_PM,19,25,0,2,27,307,0,25,332,17.4737
SAN DIEGO,Jan 2015,CACF,2015,A PLACE OF OUR OWN CHILD,CHILD_BREAKFAST,21,67,7,1,75,681,71,10,762,36.2857
SAN DIEGO,Jan 2015,CACF,2015,A PLACE OF OUR OWN CHILD,CHILD_LUNCH,21,67,7,1,75,801,84,12,897,42.7143
SAN DIEGO,Jan 2015,CACF,2015,A PLACE OF OUR OWN CHILD,CHILD_SNACK_PM,21,67,7,1,75,414,43,6,463,22.0476
SAN DIEGO,Jan 2015,CACF,2015,A PLACE OF OUR OWN CHILD,OSCH_CHILD_BREAKFAST,21,25,0,2,27,47,0,4,51,2.4286
SAN DIEGO,Jan 2015,CACF,2015,A PLACE OF OUR OWN CHILD,OSCH_CHILD_LUNCH,21,25,0,2,27,352,0,28,380,18.0952
SAN DIEGO,Jan 2015,CACF,2015,A PLACE OF OUR OWN CHILD,OSCH_CHILD_SNACK_PM,21,25,0,2,27,349,0,28,377,17.9524
SAN DIEGO,Feb 2015,CACF,2015,A PLACE OF OUR OWN CHILD,CHILD_BREAKFAST,19,67,7,1,75,750,78,12,840,44.2105
SAN DIEGO,Feb 2015,CACF,2015,A PLACE OF OUR OWN CHILD,CHILD_LUNCH,19,67,7,1,75,815,85,12,912,48
SAN DIEGO,Feb 2015,CACF,2015,A PLACE OF OUR OWN CHILD,CHILD_SNACK_PM,19,67,7,1,75,547,57,8,612,32.2105
SAN DIEGO,Feb 2015,CACF,2015,A PLACE OF OUR OWN CHILD,OSCH_CHILD_BREAKFAST,19,25,0,2,27,28,0,2,30,1.5789
SAN DIEGO,Feb 2015,CACF,2015,A PLACE OF OUR OWN CHILD,OSCH_CHILD_LUNCH,19,25,0,2,27,76,0,6,82,4.3158
SAN DIEGO,Feb 2015,CACF,2015,A PLACE OF OUR OWN CHILD,OSCH_CHILD_SNACK_PM,19,25,0,2,27,462,0,37,499,26.2632
SAN DIEGO,Mar 2015,CACF,2015,A PLACE OF OUR OWN CHILD,CHILD_BREAKFAST,22,67,7,1,75,875,91,14,980,44.5455
SAN DIEGO,Mar 2015,CACF,2015,A PLACE OF OUR OWN CHILD,CHILD_LUNCH,22,67,7,1,75,1016,106,15,1137,51.6818
SAN DIEGO,Mar 2015,CACF,2015,A PLACE OF OUR OWN CHILD,CHILD_SNACK_PM,22,67,7,1,75,539,56,8,603,27.4091
SAN DIEGO,Mar 2015,CACF,2015,A PLACE OF OUR OWN CHILD,OSCH_CHILD_BREAKFAST,22,25,0,2,27,27,0,2,29,1.3182
SAN DIEGO,Mar 2015,CACF,2015,A PLACE OF OUR OWN CHILD,OSCH_CHILD_LUNCH,22,25,0,2,27,33,0,3,36,1.6364
SAN DIEGO,Mar 2015,CACF,2015,A PLACE OF OUR OWN CHILD,OSCH_CHILD_SNACK_PM,22,25,0,2,27,357,0,29,386,17.5455
SAN DIEGO,Apr 2015,CACF,2015,A PLACE OF OUR OWN CHILD,CHILD_BREAKFAST,22,84,7,4,95,935,78,44,1057,48.0455
SAN DIEGO,Apr 2015,CACF,2015,A PLACE OF OUR OWN CHILD,CHILD_LUNCH,22,84,7,4,95,1141,95,54,1290,58.6364
SAN DIEGO,Apr 2015,CACF,2015,A PLACE OF OUR OWN CHILD,CHILD_SNACK_PM,22,84,7,4,95,751,63,35,849,38.5909
SAN DIEGO,Apr 2015,CACF,2015,A PLACE OF OUR OWN CHILD,OSCH_CHILD_BREAKFAST,22,32,0,2,34,280,0,17,297,13.5
SAN DIEGO,Apr 2015,CACF,2015,A PLACE OF OUR OWN CHILD,OSCH_CHILD_LUNCH,22,32,0,2,34,389,0,24,413,18.7727
SAN DIEGO,Apr 2015,CACF,2015,A PLACE OF OUR OWN CHILD,OSCH_CHILD_SNACK_PM,22,32,0,2,34,583,0,36,619,28.1364
SAN DIEGO,May 2015,CACF,2015,A PLACE OF OUR OWN CHILD,CHILD_BREAKFAST,20,84,7,4,95,600,50,29,679,33.95
SAN DIEGO,May 2015,CACF,2015,A PLACE OF OUR OWN CHILD,CHILD_LUNCH,20,84,7,4,95,813,68,38,919,45.95
SAN DIEGO,May 2015,CACF,2015,A PLACE OF OUR OWN CHILD,CHILD_SNACK_PM,20,84,7,4,95,694,58,33,785,39.25
SAN DIEGO,May 2015,CACF,2015,A PLACE OF OUR OWN CHILD,OSCH_CHILD_LUNCH,20,32,0,2,34,19,0,1,20,1
SAN DIEGO,May 2015,CACF,2015,A PLACE OF OUR OWN CHILD,OSCH_CHILD_SNACK_PM,20,32,0,2,34,374,0,23,397,19.85
SAN DIEGO,Jun 2015,CACF,2015,A PLACE OF OUR OWN CHILD,CHILD_BREAKFAST,22,84,7,4,95,636,53,30,719,32.6818
SAN DIEGO,Jun 2015,CACF,2015,A PLACE OF OUR OWN CHILD,CHILD_LUNCH,22,84,7,4,95,821,68,40,929,42.2273
SAN DIEGO,Jun 2015,CACF,2015,A PLACE OF OUR OWN CHILD,CHILD_SNACK_PM,22,84,7,4,95,567,47,27,641,29.1364
SAN DIEGO,Jun 2015,CACF,2015,A PLACE OF OUR OWN CHILD,OSCH_CHILD_BREAKFAST,22,32,0,2,34,189,0,12,201,9.1364
SAN DIEGO,Jun 2015,CACF,2015,A PLACE OF OUR OWN CHILD,OSCH_CHILD_LUNCH,22,32,0,2,34,242,0,15,257,11.6818
SAN DIEGO,Jun 2015,CACF,2015,A PLACE OF OUR OWN CHILD,OSCH_CHILD_SNACK_PM,22,32,0,2,34,337,0,21,358,16.2727
SAN DIEGO,Jul 2015,CACF,2015,A PLACE OF OUR OWN CHILD,CHILD_BREAKFAST,22,84,7,4,95,649,54,31,734,33.3636
SAN DIEGO,Jul 2015,CACF,2015,A PLACE OF OUR OWN CHILD,CHILD_LUNCH,22,84,7,4,95,812,68,38,918,41.7273
SAN DIEGO,Jul 2015,CACF,2015,A PLACE OF OUR OWN CHILD,CHILD_SNACK_PM,22,84,7,4,95,697,58,33,788,35.8182
SAN DIEGO,Jul 2015,CACF,2015,A PLACE OF OUR OWN CHILD,OSCH_CHILD_BREAKFAST,22,32,0,2,34,463,0,29,492,22.3636
SAN DIEGO,Jul 2015,CACF,2015,A PLACE OF OUR OWN CHILD,OSCH_CHILD_LUNCH,22,32,0,2,34,568,0,35,603,27.4091
SAN DIEGO,Jul 2015,CACF,2015,A PLACE OF OUR OWN CHILD,OSCH_CHILD_SNACK_PM,22,32,0,2,34,575,0,36,611,27.7727
SAN DIEGO,Aug 2015,CACF,2015,A PLACE OF OUR OWN CHILD,CHILD_BREAKFAST,21,84,7,4,95,716,60,34,810,38.5714
SAN DIEGO,Aug 2015,CACF,2015,A PLACE OF OUR OWN CHILD,CHILD_LUNCH,21,84,7,4,95,825,69,39,933,44.4286
SAN DIEGO,Aug 2015,CACF,2015,A PLACE OF OUR OWN CHILD,CHILD_SNACK_PM,21,84,7,4,95,615,51,30,696,33.1429
SAN DIEGO,Aug 2015,CACF,2015,A PLACE OF OUR OWN CHILD,OSCH_CHILD_BREAKFAST,21,32,0,2,34,240,0,15,255,12.1429
SAN DIEGO,Aug 2015,CACF,2015,A PLACE OF OUR OWN CHILD,OSCH_CHILD_LUNCH,21,32,0,2,34,285,0,18,303,14.4286
SAN DIEGO,Aug 2015,CACF,2015,A PLACE OF OUR OWN CHILD,OSCH_CHILD_SNACK_PM,21,32,0,2,34,414,0,26,440,20.9524
SAN DIEGO,Sep 2015,CACF,2015,A PLACE OF OUR OWN CHILD,CHILD_BREAKFAST,21,84,7,4,95,906,76,43,1025,48.8095
SAN DIEGO,Sep 2015,CACF,2015,A PLACE OF OUR OWN CHILD,CHILD_LUNCH,21,84,7,4,95,1051,88,50,1189,56.619
SAN DIEGO,Sep 2015,CACF,2015,A PLACE OF OUR OWN CHILD,CHILD_SNACK_PM,21,84,7,4,95,647,54,31,732,34.8571
SAN DIEGO,Sep 2015,CACF,2015,A PLACE OF OUR OWN CHILD,OSCH_CHILD_SNACK_PM,21,32,0,2,34,402,0,25,427,20.3333
SAN DIEGO,Oct 2014,CACF,2015,ALL ABOUT KIDS PRESCHOOL,CHILD_BREAKFAST,27,17,8,28,53,138,65,227,430,15.9259
SAN DIEGO,Oct 2014,CACF,2015,ALL ABOUT KIDS PRESCHOOL,CHILD_LUNCH,27,17,8,28,53,237,111,390,738,27.3333
SAN DIEGO,Oct 2014,CACF,2015,ALL ABOUT KIDS PRESCHOOL,CHILD_SNACK_AM,27,17,8,28,53,229,108,376,713,26.4074
SAN DIEGO,Oct 2014,CACF,2015,ALL ABOUT KIDS PRESCHOOL,CHILD_SNACK_PM,27,17,8,28,53,192,90,315,597,22.1111
SAN DIEGO,Oct 2014,CACF,2015,ALL ABOUT KIDS PRESCHOOL,CHILD_SUPPER,27,17,8,28,53,31,15,52,98,3.6296
SAN DIEGO,Oct 2014,CACF,2015,ALL ABOUT KIDS PRESCHOOL,OSCH_CHILD_BREAKFAST,27,2,5,9,16,23,57,101,181,6.7037
SAN DIEGO,Oct 2014,CACF,2015,ALL ABOUT KIDS PRESCHOOL,OSCH_CHILD_SNACK_NT,27,2,5,9,16,1,2,2,5,0.1852
SAN DIEGO,Oct 2014,CACF,2015,ALL ABOUT KIDS PRESCHOOL,OSCH_CHILD_SNACK_PM,27,2,5,9,16,18,45,82,145,5.3704
SAN DIEGO,Oct 2014,CACF,2015,ALL ABOUT KIDS PRESCHOOL,OSCH_CHILD_SUPPER,27,2,5,9,16,5,11,20,36,1.3333
SAN DIEGO,Nov 2014,CACF,2015,ALL ABOUT KIDS PRESCHOOL,CHILD_BREAKFAST,24,17,8,28,53,120,57,198,375,15.625
SAN DIEGO,Nov 2014,CACF,2015,ALL ABOUT KIDS PRESCHOOL,CHILD_LUNCH,24,17,8,28,53,198,93,326,617,25.7083
SAN DIEGO,Nov 2014,CACF,2015,ALL ABOUT KIDS PRESCHOOL,CHILD_SNACK_AM,24,17,8,28,53,185,87,305,577,24.0417
SAN DIEGO,Nov 2014,CACF,2015,ALL ABOUT KIDS PRESCHOOL,CHILD_SNACK_PM,24,17,8,28,53,168,79,278,525,21.875
SAN DIEGO,Nov 2014,CACF,2015,ALL ABOUT KIDS PRESCHOOL,CHILD_SUPPER,24,17,8,28,53,25,12,41,78,3.25
SAN DIEGO,Nov 2014,CACF,2015,ALL ABOUT KIDS PRESCHOOL,OSCH_CHILD_BREAKFAST,24,2,5,9,16,17,41,74,132,5.5
SAN DIEGO,Nov 2014,CACF,2015,ALL ABOUT KIDS PRESCHOOL,OSCH_CHILD_LUNCH,24,2,5,9,16,2,6,10,18,0.75
SAN DIEGO,Nov 2014,CACF,2015,ALL ABOUT KIDS PRESCHOOL,OSCH_CHILD_SNACK_AM,24,2,5,9,16,2,5,8,15,0.625
SAN DIEGO,Nov 2014,CACF,2015,ALL ABOUT KIDS PRESCHOOL,OSCH_CHILD_SNACK_PM,24,2,5,9,16,14,35,64,113,4.7083
SAN DIEGO,Nov 2014,CACF,2015,ALL ABOUT KIDS PRESCHOOL,OSCH_CHILD_SUPPER,24,2,5,9,16,4,10,18,32,1.3333
SAN DIEGO,Dec 2014,CACF,2015,ALL ABOUT KIDS PRESCHOOL,CHILD_BREAKFAST,24,17,8,28,53,127,60,210,397,16.5417
SAN DIEGO,Dec 2014,CACF,2015,ALL ABOUT KIDS PRESCHOOL,CHILD_LUNCH,24,17,8,28,53,224,105,369,698,29.0833
SAN DIEGO,Dec 2014,CACF,2015,ALL ABOUT KIDS PRESCHOOL,CHILD_SNACK_AM,24,17,8,28,53,216,102,356,674,28.0833
SAN DIEGO,Dec 2014,CACF,2015,ALL ABOUT KIDS PRESCHOOL,CHILD_SNACK_PM,24,17,8,28,53,188,88,310,586,24.4167
SAN DIEGO,Dec 2014,CACF,2015,ALL ABOUT KIDS PRESCHOOL,CHILD_SUPPER,24,17,8,28,53,31,15,52,98,4.0833
SAN DIEGO,Dec 2014,CACF,2015,ALL ABOUT KIDS PRESCHOOL,OSCH_CHILD_BREAKFAST,24,2,5,9,16,16,39,70,125,5.2083
SAN DIEGO,Dec 2014,CACF,2015,ALL ABOUT KIDS PRESCHOOL,OSCH_CHILD_LUNCH,24,2,5,9,16,2,4,7,13,0.5417
SAN DIEGO,Dec 2014,CACF,2015,ALL ABOUT KIDS PRESCHOOL,OSCH_CHILD_SNACK_AM,24,2,5,9,16,2,4,7,13,0.5417
SAN DIEGO,Dec 2014,CACF,2015,ALL ABOUT KIDS PRESCHOOL,OSCH_CHILD_SNACK_PM,24,2,5,9,16,14,35,62,111,4.625
SAN DIEGO,Dec 2014,CACF,2015,ALL ABOUT KIDS PRESCHOOL,OSCH_CHILD_SUPPER,24,2,5,9,16,5,12,21,38,1.5833
SAN DIEGO,Jan 2015,CACF,2015,ALL ABOUT KIDS PRESCHOOL,CHILD_BREAKFAST,26,17,8,28,53,151,71,248,470,18.0769
SAN DIEGO,Jan 2015,CACF,2015,ALL ABOUT KIDS PRESCHOOL,CHILD_LUNCH,26,17,8,28,53,238,112,391,741,28.5
SAN DIEGO,Jan 2015,CACF,2015,ALL ABOUT KIDS PRESCHOOL,CHILD_SNACK_AM,26,17,8,28,53,227,107,373,707,27.1923
SAN DIEGO,Jan 2015,CACF,2015,ALL ABOUT KIDS PRESCHOOL,CHILD_SNACK_PM,26,17,8,28,53,210,99,346,655,25.1923
SAN DIEGO,Jan 2015,CACF,2015,ALL ABOUT KIDS PRESCHOOL,CHILD_SUPPER,26,17,8,28,53,30,14,48,92,3.5385
SAN DIEGO,Jan 2015,CACF,2015,ALL ABOUT KIDS PRESCHOOL,OSCH_CHILD_BREAKFAST,26,2,5,9,16,14,36,65,115,4.4231
SAN DIEGO,Jan 2015,CACF,2015,ALL ABOUT KIDS PRESCHOOL,OSCH_CHILD_LUNCH,26,2,5,9,16,1,3,5,9,0.3462
SAN DIEGO,Jan 2015,CACF,2015,ALL ABOUT KIDS PRESCHOOL,OSCH_CHILD_SNACK_AM,26,2,5,9,16,1,3,5,9,0.3462
SAN DIEGO,Jan 2015,CACF,2015,ALL ABOUT KIDS PRESCHOOL,OSCH_CHILD_SNACK_PM,26,2,5,9,16,13,33,59,105,4.0385
SAN DIEGO,Jan 2015,CACF,2015,ALL ABOUT KIDS PRESCHOOL,OSCH_CHILD_SUPPER,26,2,5,9,16,4,11,20,35,1.3462
SAN DIEGO,Feb 2015,CACF,2015,ALL ABOUT KIDS PRESCHOOL,CHILD_BREAKFAST,24,17,8,28,53,134,63,221,418,17.4167
SAN DIEGO,Feb 2015,CACF,2015,ALL ABOUT KIDS PRESCHOOL,CHILD_LUNCH,24,17,8,28,53,203,95,334,632,26.3333
SAN DIEGO,Feb 2015,CACF,2015,ALL ABOUT KIDS PRESCHOOL,CHILD_SNACK_AM,24,17,8,28,53,230,108,378,716,29.8333
SAN DIEGO,Feb 2015,CACF,2015,ALL ABOUT KIDS PRESCHOOL,CHILD_SNACK_PM,24,17,8,28,53,208,98,343,649,27.0417
SAN DIEGO,Feb 2015,CACF,2015,ALL ABOUT KIDS PRESCHOOL,CHILD_SUPPER,24,17,8,28,53,8,4,14,26,1.0833
SAN DIEGO,Feb 2015,CACF,2015,ALL ABOUT KIDS PRESCHOOL,OSCH_CHILD_BREAKFAST,24,2,5,9,16,14,35,63,112,4.6667
SAN DIEGO,Feb 2015,CACF,2015,ALL ABOUT KIDS PRESCHOOL,OSCH_CHILD_LUNCH,24,2,5,9,16,1,3,7,11,0.4583
SAN DIEGO,Feb 2015,CACF,2015,ALL ABOUT KIDS PRESCHOOL,OSCH_CHILD_SNACK_AM,24,2,5,9,16,1,3,7,11,0.4583
SAN DIEGO,Feb 2015,CACF,2015,ALL ABOUT KIDS PRESCHOOL,OSCH_CHILD_SNACK_PM,24,2,5,9,16,12,30,54,96,4
SAN DIEGO,Feb 2015,CACF,2015,ALL ABOUT KIDS PRESCHOOL,OSCH_CHILD_SUPPER,24,2,5,9,16,2,4,6,12,0.5
SAN DIEGO,Mar 2015,CACF,2015,ALL ABOUT KIDS PRESCHOOL,CHILD_BREAKFAST,26,17,8,28,53,195,92,320,607,23.3462
SAN DIEGO,Mar 2015,CACF,2015,ALL ABOUT KIDS PRESCHOOL,CHILD_LUNCH,26,17,8,28,53,299,141,493,933,35.8846
SAN DIEGO,Mar 2015,CACF,2015,ALL ABOUT KIDS PRESCHOOL,CHILD_SNACK_AM,26,17,8,28,53,279,131,460,870,33.4615
SAN DIEGO,Mar 2015,CACF,2015,ALL ABOUT KIDS PRESCHOOL,CHILD_SNACK_PM,26,17,8,28,53,269,127,443,839,32.2692
SAN DIEGO,Mar 2015,CACF,2015,ALL ABOUT KIDS PRESCHOOL,CHILD_SUPPER,26,17,8,28,53,44,21,71,136,5.2308
SAN DIEGO,Mar 2015,CACF,2015,ALL ABOUT KIDS PRESCHOOL,OSCH_CHILD_BREAKFAST,26,2,5,9,16,11,27,49,87,3.3462
SAN DIEGO,Mar 2015,CACF,2015,ALL ABOUT KIDS PRESCHOOL,OSCH_CHILD_LUNCH,26,2,5,9,16,2,6,10,18,0.6923
SAN DIEGO,Mar 2015,CACF,2015,ALL ABOUT KIDS PRESCHOOL,OSCH_CHILD_SNACK_AM,26,2,5,9,16,1,3,6,10,0.3846
SAN DIEGO,Mar 2015,CACF,2015,ALL ABOUT KIDS PRESCHOOL,OSCH_CHILD_SNACK_PM,26,2,5,9,16,14,36,64,114,4.3846
SAN DIEGO,Mar 2015,CACF,2015,ALL ABOUT KIDS PRESCHOOL,OSCH_CHILD_SUPPER,26,2,5,9,16,4,10,17,31,1.1923
SAN DIEGO,Apr 2015,CACF,2015,ALL ABOUT KIDS PRESCHOOL,CHILD_BREAKFAST,26,17,8,28,53,168,79,277,524,20.1538
SAN DIEGO,Apr 2015,CACF,2015,ALL ABOUT KIDS PRESCHOOL,CHILD_LUNCH,26,17,8,28,53,296,139,488,923,35.5
SAN DIEGO,Apr 2015,CACF,2015,ALL ABOUT KIDS PRESCHOOL,CHILD_SNACK_AM,26,17,8,28,53,276,130,454,860,33.0769
SAN DIEGO,Apr 2015,CACF,2015,ALL ABOUT KIDS PRESCHOOL,CHILD_SNACK_PM,26,17,8,28,53,268,126,442,836,32.1538
SAN DIEGO,Apr 2015,CACF,2015,ALL ABOUT KIDS PRESCHOOL,CHILD_SUPPER,26,17,8,28,53,56,27,93,176,6.7692
SAN DIEGO,Apr 2015,CACF,2015,ALL ABOUT KIDS PRESCHOOL,OSCH_CHILD_BREAKFAST,26,2,5,9,16,12,29,52,93,3.5769
SAN DIEGO,Apr 2015,CACF,2015,ALL ABOUT KIDS PRESCHOOL,OSCH_CHILD_LUNCH,26,2,5,9,16,6,14,25,45,1.7308
SAN DIEGO,Apr 2015,CACF,2015,ALL ABOUT KIDS PRESCHOOL,OSCH_CHILD_SNACK_AM,26,2,5,9,16,5,13,25,43,1.6538
SAN DIEGO,Apr 2015,CACF,2015,ALL ABOUT KIDS PRESCHOOL,OSCH_CHILD_SNACK_PM,26,2,5,9,16,16,40,71,127,4.8846
SAN DIEGO,Apr 2015,CACF,2015,ALL ABOUT KIDS PRESCHOOL,OSCH_CHILD_SUPPER,26,2,5,9,16,5,12,20,37,1.4231
SAN DIEGO,May 2015,CACF,2015,ALL ABOUT KIDS PRESCHOOL,CHILD_BREAKFAST,26,17,8,28,53,150,71,247,468,18
SAN DIEGO,May 2015,CACF,2015,ALL ABOUT KIDS PRESCHOOL,CHILD_LUNCH,26,17,8,28,53,267,126,439,832,32
SAN DIEGO,May 2015,CACF,2015,ALL ABOUT KIDS PRESCHOOL,CHILD_SNACK_AM,26,17,8,28,53,243,114,400,757,29.1154
SAN DIEGO,May 2015,CACF,2015,ALL ABOUT KIDS PRESCHOOL,CHILD_SNACK_NT,26,17,8,28,53,21,10,35,66,2.5385
SAN DIEGO,May 2015,CACF,2015,ALL ABOUT KIDS PRESCHOOL,CHILD_SNACK_PM,26,17,8,28,53,253,119,417,789,30.3462
SAN DIEGO,May 2015,CACF,2015,ALL ABOUT KIDS PRESCHOOL,CHILD_SUPPER,26,17,8,28,53,53,25,87,165,6.3462
SAN DIEGO,May 2015,CACF,2015,ALL ABOUT KIDS PRESCHOOL,OSCH_CHILD_BREAKFAST,26,2,5,9,16,14,36,64,114,4.3846
SAN DIEGO,May 2015,CACF,2015,ALL ABOUT KIDS PRESCHOOL,OSCH_CHILD_LUNCH,26,2,5,9,16,1,3,5,9,0.3462
SAN DIEGO,May 2015,CACF,2015,ALL ABOUT KIDS PRESCHOOL,OSCH_CHILD_SNACK_AM,26,2,5,9,16,1,1,2,4,0.1538
SAN DIEGO,May 2015,CACF,2015,ALL ABOUT KIDS PRESCHOOL,OSCH_CHILD_SNACK_NT,26,2,5,9,16,2,5,10,17,0.6538
SAN DIEGO,May 2015,CACF,2015,ALL ABOUT KIDS PRESCHOOL,OSCH_CHILD_SNACK_PM,26,2,5,9,16,18,46,82,146,5.6154
SAN DIEGO,May 2015,CACF,2015,ALL ABOUT KIDS PRESCHOOL,OSCH_CHILD_SUPPER,26,2,5,9,16,6,14,24,44,1.6923
SAN DIEGO,Jun 2015,CACF,2015,ALL ABOUT KIDS PRESCHOOL,CHILD_BREAKFAST,26,17,8,28,53,175,82,289,546,21
SAN DIEGO,Jun 2015,CACF,2015,ALL ABOUT KIDS PRESCHOOL,CHILD_LUNCH,26,17,8,28,53,296,139,488,923,35.5
SAN DIEGO,Jun 2015,CACF,2015,ALL ABOUT KIDS PRESCHOOL,CHILD_SNACK_AM,26,17,8,28,53,272,128,448,848,32.6154
SAN DIEGO,Jun 2015,CACF,2015,ALL ABOUT KIDS PRESCHOOL,CHILD_SNACK_NT,26,17,8,28,53,14,6,23,43,1.6538
SAN DIEGO,Jun 2015,CACF,2015,ALL ABOUT KIDS PRESCHOOL,CHILD_SNACK_PM,26,17,8,28,53,282,132,464,878,33.7692
SAN DIEGO,Jun 2015,CACF,2015,ALL ABOUT KIDS PRESCHOOL,CHILD_SUPPER,26,17,8,28,53,51,24,83,158,6.0769
SAN DIEGO,Jun 2015,CACF,2015,ALL ABOUT KIDS PRESCHOOL,OSCH_CHILD_BREAKFAST,26,2,5,9,16,17,42,74,133,5.1154
SAN DIEGO,Jun 2015,CACF,2015,ALL ABOUT KIDS PRESCHOOL,OSCH_CHILD_LUNCH,26,2,5,9,16,9,23,40,72,2.7692
SAN DIEGO,Jun 2015,CACF,2015,ALL ABOUT KIDS PRESCHOOL,OSCH_CHILD_SNACK_AM,26,2,5,9,16,8,19,33,60,2.3077
SAN DIEGO,Jun 2015,CACF,2015,ALL ABOUT KIDS PRESCHOOL,OSCH_CHILD_SNACK_NT,26,2,5,9,16,2,4,6,12,0.4615
SAN DIEGO,Jun 2015,CACF,2015,ALL ABOUT KIDS PRESCHOOL,OSCH_CHILD_SNACK_PM,26,2,5,9,16,23,57,103,183,7.0385
SAN DIEGO,Jun 2015,CACF,2015,ALL ABOUT KIDS PRESCHOOL,OSCH_CHILD_SUPPER,26,2,5,9,16,5,13,22,40,1.5385
SAN DIEGO,Jul 2015,CACF,2015,ALL ABOUT KIDS PRESCHOOL,CHILD_BREAKFAST,27,17,8,28,53,172,81,282,535,19.8148
SAN DIEGO,Jul 2015,CACF,2015,ALL ABOUT KIDS PRESCHOOL,CHILD_LUNCH,27,17,8,28,53,295,139,487,921,34.1111
SAN DIEGO,Jul 2015,CACF,2015,ALL ABOUT KIDS PRESCHOOL,CHILD_SNACK_AM,27,17,8,28,53,273,128,449,850,31.4815
SAN DIEGO,Jul 2015,CACF,2015,ALL ABOUT KIDS PRESCHOOL,CHILD_SNACK_NT,27,17,8,28,53,19,9,30,58,2.1481
SAN DIEGO,Jul 2015,CACF,2015,ALL ABOUT KIDS PRESCHOOL,CHILD_SNACK_PM,27,17,8,28,53,273,129,450,852,31.5556
SAN DIEGO,Jul 2015,CACF,2015,ALL ABOUT KIDS PRESCHOOL,CHILD_SUPPER,27,17,8,28,53,34,16,55,105,3.8889
SAN DIEGO,Jul 2015,CACF,2015,ALL ABOUT KIDS PRESCHOOL,OSCH_CHILD_BREAKFAST,27,2,5,9,16,20,49,89,158,5.8519
SAN DIEGO,Jul 2015,CACF,2015,ALL ABOUT KIDS PRESCHOOL,OSCH_CHILD_LUNCH,27,2,5,9,16,27,68,123,218,8.0741
SAN DIEGO,Jul 2015,CACF,2015,ALL ABOUT KIDS PRESCHOOL,OSCH_CHILD_SNACK_AM,27,2,5,9,16,26,64,114,204,7.5556
SAN DIEGO,Jul 2015,CACF,2015,ALL ABOUT KIDS PRESCHOOL,OSCH_CHILD_SNACK_NT,27,2,5,9,16,2,5,9,16,0.5926
SAN DIEGO,Jul 2015,CACF,2015,ALL ABOUT KIDS PRESCHOOL,OSCH_CHILD_SNACK_PM,27,2,5,9,16,24,60,107,191,7.0741
SAN DIEGO,Jul 2015,CACF,2015,ALL ABOUT KIDS PRESCHOOL,OSCH_CHILD_SUPPER,27,2,5,9,16,4,11,19,34,1.2593
SAN DIEGO,Aug 2015,CACF,2015,ALL ABOUT KIDS PRESCHOOL,CHILD_BREAKFAST,26,17,8,28,53,158,74,261,493,18.9615
SAN DIEGO,Aug 2015,CACF,2015,ALL ABOUT KIDS PRESCHOOL,CHILD_LUNCH,26,17,8,28,53,283,133,465,881,33.8846
SAN DIEGO,Aug 2015,CACF,2015,ALL ABOUT KIDS PRESCHOOL,CHILD_SNACK_AM,26,17,8,28,53,254,120,419,793,30.5
SAN DIEGO,Aug 2015,CACF,2015,ALL ABOUT KIDS PRESCHOOL,CHILD_SNACK_NT,26,17,8,28,53,17,8,27,52,2
SAN DIEGO,Aug 2015,CACF,2015,ALL ABOUT KIDS PRESCHOOL,CHILD_SNACK_PM,26,17,8,28,53,274,129,450,853,32.8077
SAN DIEGO,Aug 2015,CACF,2015,ALL ABOUT KIDS PRESCHOOL,CHILD_SUPPER,26,17,8,28,53,54,25,89,168,6.4615
SAN DIEGO,Aug 2015,CACF,2015,ALL ABOUT KIDS PRESCHOOL,OSCH_CHILD_BREAKFAST,26,2,5,9,16,22,54,97,173,6.6538
SAN DIEGO,Aug 2015,CACF,2015,ALL ABOUT KIDS PRESCHOOL,OSCH_CHILD_LUNCH,26,2,5,9,16,22,56,101,179,6.8846
SAN DIEGO,Aug 2015,CACF,2015,ALL ABOUT KIDS PRESCHOOL,OSCH_CHILD_SNACK_AM,26,2,5,9,16,19,48,86,153,5.8846
SAN DIEGO,Aug 2015,CACF,2015,ALL ABOUT KIDS PRESCHOOL,OSCH_CHILD_SNACK_NT,26,2,5,9,16,2,4,6,12,0.4615
SAN DIEGO,Aug 2015,CACF,2015,ALL ABOUT KIDS PRESCHOOL,OSCH_CHILD_SNACK_PM,26,2,5,9,16,21,51,92,164,6.3077
SAN DIEGO,Aug 2015,CACF,2015,ALL ABOUT KIDS PRESCHOOL,OSCH_CHILD_SUPPER,26,2,5,9,16,4,10,17,31,1.1923
SAN DIEGO,Sep 2015,CACF,2015,ALL ABOUT KIDS PRESCHOOL,CHILD_BREAKFAST,26,17,8,28,53,146,69,241,456,17.5385
SAN DIEGO,Sep 2015,CACF,2015,ALL ABOUT KIDS PRESCHOOL,CHILD_LUNCH,26,17,8,28,53,281,132,464,877,33.7308
SAN DIEGO,Sep 2015,CACF,2015,ALL ABOUT KIDS PRESCHOOL,CHILD_SNACK_AM,26,17,8,28,53,255,120,421,796,30.6154
SAN DIEGO,Sep 2015,CACF,2015,ALL ABOUT KIDS PRESCHOOL,CHILD_SNACK_NT,26,17,8,28,53,5,2,9,16,0.6154
SAN DIEGO,Sep 2015,CACF,2015,ALL ABOUT KIDS PRESCHOOL,CHILD_SNACK_PM,26,17,8,28,53,482,227,794,1503,57.8077
SAN DIEGO,Sep 2015,CACF,2015,ALL ABOUT KIDS PRESCHOOL,CHILD_SUPPER,26,17,8,28,53,41,19,67,127,4.8846
SAN DIEGO,Sep 2015,CACF,2015,ALL ABOUT KIDS PRESCHOOL,OSCH_CHILD_BREAKFAST,26,2,5,9,16,21,51,92,164,6.3077
SAN DIEGO,Sep 2015,CACF,2015,ALL ABOUT KIDS PRESCHOOL,OSCH_CHILD_LUNCH,26,2,5,9,16,1,1,2,4,0.1538
SAN DIEGO,Sep 2015,CACF,2015,ALL ABOUT KIDS PRESCHOOL,OSCH_CHILD_SNACK_AM,26,2,5,9,16,0,1,2,3,0.1154
SAN DIEGO,Sep 2015,CACF,2015,ALL ABOUT KIDS PRESCHOOL,OSCH_CHILD_SNACK_NT,26,2,5,9,16,0,1,2,3,0.1154
SAN DIEGO,Sep 2015,CACF,2015,ALL ABOUT KIDS PRESCHOOL,OSCH_CHILD_SNACK_PM,26,2,5,9,16,12,31,56,99,3.8077
SAN DIEGO,Sep 2015,CACF,2015,ALL ABOUT KIDS PRESCHOOL,OSCH_CHILD_SUPPER,26,2,5,9,16,3,7,12,22,0.8462
SAN DIEGO,Oct 2014,CACF,2015,All Kids Academy Head Start Inc.,HS_CHILD_BREAKFAST,22,1122,0,0,1122,10179,0,0,10179,462.6818
SAN DIEGO,Oct 2014,CACF,2015,All Kids Academy Head Start Inc.,HS_CHILD_LUNCH,22,1122,0,0,1122,15860,0,0,15860,720.9091
SAN DIEGO,Oct 2014,CACF,2015,All Kids Academy Head Start Inc.,HS_CHILD_SNACK_PM,22,1122,0,0,1122,9287,0,0,9287,422.1364
SAN DIEGO,Nov 2014,CACF,2015,All Kids Academy Head Start Inc.,HS_CHILD_BREAKFAST,14,1122,0,0,1122,6235,0,0,6235,445.3571
SAN DIEGO,Nov 2014,CACF,2015,All Kids Academy Head Start Inc.,HS_CHILD_LUNCH,14,1122,0,0,1122,9491,0,0,9491,677.9286
SAN DIEGO,Nov 2014,CACF,2015,All Kids Academy Head Start Inc.,HS_CHILD_SNACK_PM,14,1122,0,0,1122,5586,0,0,5586,399
SAN DIEGO,Dec 2014,CACF,2015,All Kids Academy Head Start Inc.,HS_CHILD_BREAKFAST,17,1122,0,0,1122,6559,0,0,6559,385.8235
SAN DIEGO,Dec 2014,CACF,2015,All Kids Academy Head Start Inc.,HS_CHILD_LUNCH,17,1122,0,0,1122,10072,0,0,10072,592.4706
SAN DIEGO,Dec 2014,CACF,2015,All Kids Academy Head Start Inc.,HS_CHILD_SNACK_PM,17,1122,0,0,1122,5854,0,0,5854,344.3529
SAN DIEGO,Jan 2015,CACF,2015,All Kids Academy Head Start Inc.,HS_CHILD_BREAKFAST,19,1122,0,0,1122,7706,0,0,7706,405.5789
SAN DIEGO,Jan 2015,CACF,2015,All Kids Academy Head Start Inc.,HS_CHILD_LUNCH,19,1122,0,0,1122,12070,0,0,12070,635.2632
SAN DIEGO,Jan 2015,CACF,2015,All Kids Academy Head Start Inc.,HS_CHILD_SNACK_PM,19,1122,0,0,1122,7292,0,0,7292,383.7895
SAN DIEGO,Feb 2015,CACF,2015,All Kids Academy Head Start Inc.,HS_CHILD_BREAKFAST,18,1122,0,0,1122,7722,0,0,7722,429
SAN DIEGO,Feb 2015,CACF,2015,All Kids Academy Head Start Inc.,HS_CHILD_LUNCH,18,1122,0,0,1122,12129,0,0,12129,673.8333
SAN DIEGO,Feb 2015,CACF,2015,All Kids Academy Head Start Inc.,HS_CHILD_SNACK_PM,18,1122,0,0,1122,7106,0,0,7106,394.7778
SAN DIEGO,Mar 2015,CACF,2015,All Kids Academy Head Start Inc.,HS_CHILD_BREAKFAST,19,1122,0,0,1122,8215,0,0,8215,432.3684
SAN DIEGO,Mar 2015,CACF,2015,All Kids Academy Head Start Inc.,HS_CHILD_LUNCH,19,1122,0,0,1122,13065,0,0,13065,687.6316
SAN DIEGO,Mar 2015,CACF,2015,All Kids Academy Head Start Inc.,HS_CHILD_SNACK_PM,19,1122,0,0,1122,7502,0,0,7502,394.8421
SAN DIEGO,Apr 2015,CACF,2015,All Kids Academy Head Start Inc.,HS_CHILD_BREAKFAST,18,1122,0,0,1122,7418,0,0,7418,412.1111
SAN DIEGO,Apr 2015,CACF,2015,All Kids Academy Head Start Inc.,HS_CHILD_LUNCH,18,1122,0,0,1122,11756,0,0,11756,653.1111
SAN DIEGO,Apr 2015,CACF,2015,All Kids Academy Head Start Inc.,HS_CHILD_SNACK_PM,18,1122,0,0,1122,6851,0,0,6851,380.6111
SAN DIEGO,May 2015,CACF,2015,All Kids Academy Head Start Inc.,HS_CHILD_BREAKFAST,20,1122,0,0,1122,7537,0,0,7537,376.85
SAN DIEGO,May 2015,CACF,2015,All Kids Academy Head Start Inc.,HS_CHILD_LUNCH,20,1122,0,0,1122,11618,0,0,11618,580.9
SAN DIEGO,May 2015,CACF,2015,All Kids Academy Head Start Inc.,HS_CHILD_SNACK_PM,20,1122,0,0,1122,6963,0,0,6963,348.15
SAN DIEGO,Jun 2015,CACF,2015,All Kids Academy Head Start Inc.,HS_CHILD_BREAKFAST,14,1122,0,0,1122,5046,0,0,5046,360.4286
SAN DIEGO,Jun 2015,CACF,2015,All Kids Academy Head Start Inc.,HS_CHILD_LUNCH,14,1122,0,0,1122,7988,0,0,7988,570.5714
SAN DIEGO,Jun 2015,CACF,2015,All Kids Academy Head Start Inc.,HS_CHILD_SNACK_PM,14,1122,0,0,1122,4526,0,0,4526,323.2857
SAN DIEGO,Aug 2015,CACF,2015,All Kids Academy Head Start Inc.,HS_CHILD_BREAKFAST,12,1122,0,0,1122,516,0,0,516,43
SAN DIEGO,Aug 2015,CACF,2015,All Kids Academy Head Start Inc.,HS_CHILD_LUNCH,12,1122,0,0,1122,838,0,0,838,69.8333
SAN DIEGO,Aug 2015,CACF,2015,All Kids Academy Head Start Inc.,HS_CHILD_SNACK_PM,12,1122,0,0,1122,612,0,0,612,51
SAN DIEGO,Sep 2015,CACF,2015,All Kids Academy Head Start Inc.,HS_CHILD_BREAKFAST,21,1122,0,0,1122,6277,0,0,6277,298.9048
SAN DIEGO,Sep 2015,CACF,2015,All Kids Academy Head Start Inc.,HS_CHILD_LUNCH,21,1122,0,0,1122,9543,0,0,9543,454.4286
SAN DIEGO,Sep 2015,CACF,2015,All Kids Academy Head Start Inc.,HS_CHILD_SNACK_PM,21,1122,0,0,1122,6062,0,0,6062,288.6667
SAN DIEGO,Oct 2014,CACF,2015,AMERICARE ADHC INC ,ADULT_BREAKFAST,23,218,0,9,227,2744,0,113,2857,124.2174
SAN DIEGO,Oct 2014,CACF,2015,AMERICARE ADHC INC ,ADULT_LUNCH,23,218,0,9,227,2803,0,116,2919,126.913
SAN DIEGO,Oct 2014,CACF,2015,AMERICARE ADHC INC ,ADULT_SNACK_AM,23,218,0,9,227,60,0,2,62,2.6957
SAN DIEGO,Oct 2014,CACF,2015,AMERICARE ADHC INC ,ADULT_SNACK_PM,23,218,0,9,227,724,0,30,754,32.7826
SAN DIEGO,Nov 2014,CACF,2015,AMERICARE ADHC INC ,ADULT_BREAKFAST,19,218,0,9,227,2295,0,95,2390,125.7895
SAN DIEGO,Nov 2014,CACF,2015,AMERICARE ADHC INC ,ADULT_LUNCH,19,218,0,9,227,2330,0,96,2426,127.6842
SAN DIEGO,Nov 2014,CACF,2015,AMERICARE ADHC INC ,ADULT_SNACK_AM,19,218,0,9,227,36,0,2,38,2
SAN DIEGO,Nov 2014,CACF,2015,AMERICARE ADHC INC ,ADULT_SNACK_PM,19,218,0,9,227,668,0,28,696,36.6316
SAN DIEGO,Dec 2014,CACF,2015,AMERICARE ADHC INC ,ADULT_BREAKFAST,21,218,0,9,227,2522,0,104,2626,125.0476
SAN DIEGO,Dec 2014,CACF,2015,AMERICARE ADHC INC ,ADULT_LUNCH,21,218,0,9,227,2540,0,105,2645,125.9524
SAN DIEGO,Dec 2014,CACF,2015,AMERICARE ADHC INC ,ADULT_SNACK_AM,21,218,0,9,227,18,0,1,19,0.9048
SAN DIEGO,Dec 2014,CACF,2015,AMERICARE ADHC INC ,ADULT_SNACK_PM,21,218,0,9,227,683,0,28,711,33.8571
SAN DIEGO,Jan 2015,CACF,2015,AMERICARE ADHC INC ,ADULT_BREAKFAST,21,218,0,9,227,2483,0,102,2585,123.0952
SAN DIEGO,Jan 2015,CACF,2015,AMERICARE ADHC INC ,ADULT_LUNCH,21,218,0,9,227,2489,0,103,2592,123.4286
SAN DIEGO,Jan 2015,CACF,2015,AMERICARE ADHC INC ,ADULT_SNACK_AM,21,218,0,9,227,7,0,0,7,0.3333
SAN DIEGO,Jan 2015,CACF,2015,AMERICARE ADHC INC ,ADULT_SNACK_PM,21,218,0,9,227,645,0,27,672,32
SAN DIEGO,Feb 2015,CACF,2015,AMERICARE ADHC INC ,ADULT_BREAKFAST,20,218,0,9,227,2382,0,98,2480,124
SAN DIEGO,Feb 2015,CACF,2015,AMERICARE ADHC INC ,ADULT_LUNCH,20,218,0,9,227,2388,0,98,2486,124.3
SAN DIEGO,Feb 2015,CACF,2015,AMERICARE ADHC INC ,ADULT_SNACK_AM,20,218,0,9,227,10,0,0,10,0.5
SAN DIEGO,Feb 2015,CACF,2015,AMERICARE ADHC INC ,ADULT_SNACK_PM,20,218,0,9,227,676,0,28,704,35.2
SAN DIEGO,Mar 2015,CACF,2015,AMERICARE ADHC INC ,ADULT_BREAKFAST,22,218,0,9,227,2656,0,110,2766,125.7273
SAN DIEGO,Mar 2015,CACF,2015,AMERICARE ADHC INC ,ADULT_LUNCH,22,218,0,9,227,2687,0,111,2798,127.1818
SAN DIEGO,Mar 2015,CACF,2015,AMERICARE ADHC INC ,ADULT_SNACK_AM,22,218,0,9,227,31,0,1,32,1.4545
SAN DIEGO,Mar 2015,CACF,2015,AMERICARE ADHC INC ,ADULT_SNACK_PM,22,218,0,9,227,713,0,29,742,33.7273
SAN DIEGO,Apr 2015,CACF,2015,AMERICARE ADHC INC ,ADULT_BREAKFAST,22,218,0,9,227,2639,0,109,2748,124.9091
SAN DIEGO,Apr 2015,CACF,2015,AMERICARE ADHC INC ,ADULT_LUNCH,22,218,0,9,227,2655,0,109,2764,125.6364
SAN DIEGO,Apr 2015,CACF,2015,AMERICARE ADHC INC ,ADULT_SNACK_AM,22,218,0,9,227,15,0,1,16,0.7273
SAN DIEGO,Apr 2015,CACF,2015,AMERICARE ADHC INC ,ADULT_SNACK_PM,22,218,0,9,227,688,0,28,716,32.5455
SAN DIEGO,May 2015,CACF,2015,AMERICARE ADHC INC ,ADULT_BREAKFAST,20,218,0,9,227,2470,0,102,2572,128.6
SAN DIEGO,May 2015,CACF,2015,AMERICARE ADHC INC ,ADULT_LUNCH,20,218,0,9,227,2494,0,103,2597,129.85
SAN DIEGO,May 2015,CACF,2015,AMERICARE ADHC INC ,ADULT_SNACK_AM,20,218,0,9,227,25,0,1,26,1.3
SAN DIEGO,May 2015,CACF,2015,AMERICARE ADHC INC ,ADULT_SNACK_PM,20,218,0,9,227,662,0,27,689,34.45
SAN DIEGO,Jun 2015,CACF,2015,AMERICARE ADHC INC ,ADULT_BREAKFAST,22,218,0,9,227,2648,0,109,2757,125.3182
SAN DIEGO,Jun 2015,CACF,2015,AMERICARE ADHC INC ,ADULT_LUNCH,22,218,0,9,227,2684,0,111,2795,127.0455
SAN DIEGO,Jun 2015,CACF,2015,AMERICARE ADHC INC ,ADULT_SNACK_AM,22,218,0,9,227,37,0,2,39,1.7727
SAN DIEGO,Jun 2015,CACF,2015,AMERICARE ADHC INC ,ADULT_SNACK_PM,22,218,0,9,227,732,0,30,762,34.6364
SAN DIEGO,Jul 2015,CACF,2015,AMERICARE ADHC INC ,ADULT_BREAKFAST,23,218,0,9,227,2790,0,115,2905,126.3043
SAN DIEGO,Jul 2015,CACF,2015,AMERICARE ADHC INC ,ADULT_LUNCH,23,218,0,9,227,2816,0,116,2932,127.4783
SAN DIEGO,Jul 2015,CACF,2015,AMERICARE ADHC INC ,ADULT_SNACK_AM,23,218,0,9,227,26,0,1,27,1.1739
SAN DIEGO,Jul 2015,CACF,2015,AMERICARE ADHC INC ,ADULT_SNACK_PM,23,218,0,9,227,665,0,27,692,30.087
SAN DIEGO,Aug 2015,CACF,2015,AMERICARE ADHC INC ,ADULT_BREAKFAST,21,218,0,9,227,2568,0,106,2674,127.3333
SAN DIEGO,Aug 2015,CACF,2015,AMERICARE ADHC INC ,ADULT_LUNCH,21,218,0,9,227,2597,0,107,2704,128.7619
SAN DIEGO,Aug 2015,CACF,2015,AMERICARE ADHC INC ,ADULT_SNACK_AM,21,218,0,9,227,29,0,1,30,1.4286
SAN DIEGO,Aug 2015,CACF,2015,AMERICARE ADHC INC ,ADULT_SNACK_PM,21,218,0,9,227,704,0,29,733,34.9048
SAN DIEGO,Sep 2015,CACF,2015,AMERICARE ADHC INC ,ADULT_BREAKFAST,21,218,0,9,227,2537,0,105,2642,125.8095
SAN DIEGO,Sep 2015,CACF,2015,AMERICARE ADHC INC ,ADULT_LUNCH,21,218,0,9,227,2564,0,106,2670,127.1429
SAN DIEGO,Sep 2015,CACF,2015,AMERICARE ADHC INC ,ADULT_SNACK_AM,21,218,0,9,227,29,0,1,30,1.4286
SAN DIEGO,Sep 2015,CACF,2015,AMERICARE ADHC INC ,ADULT_SNACK_PM,21,218,0,9,227,638,0,26,664,31.619
SAN DIEGO,Oct 2014,CACF,2015,ASSOC STUDENTS CSU SAN DIEGO CHILDRENS CENTER ,CHILD_BREAKFAST,23,37,12,159,208,396,128,1703,2227,96.8261
SAN DIEGO,Oct 2014,CACF,2015,ASSOC STUDENTS CSU SAN DIEGO CHILDRENS CENTER ,CHILD_LUNCH,23,37,12,159,208,616,200,2644,3460,150.4348
SAN DIEGO,Oct 2014,CACF,2015,ASSOC STUDENTS CSU SAN DIEGO CHILDRENS CENTER ,CHILD_SNACK_PM,23,37,12,159,208,574,186,2464,3224,140.1739
SAN DIEGO,Nov 2014,CACF,2015,ASSOC STUDENTS CSU SAN DIEGO CHILDRENS CENTER ,CHILD_BREAKFAST,17,37,12,159,208,291,95,1252,1638,96.3529
SAN DIEGO,Nov 2014,CACF,2015,ASSOC STUDENTS CSU SAN DIEGO CHILDRENS CENTER ,CHILD_LUNCH,17,37,12,159,208,444,144,1909,2497,146.8824
SAN DIEGO,Nov 2014,CACF,2015,ASSOC STUDENTS CSU SAN DIEGO CHILDRENS CENTER ,CHILD_SNACK_PM,17,37,12,159,208,418,136,1795,2349,138.1765
SAN DIEGO,Dec 2014,CACF,2015,ASSOC STUDENTS CSU SAN DIEGO CHILDRENS CENTER ,CHILD_BREAKFAST,15,37,12,159,208,234,76,1007,1317,87.8
SAN DIEGO,Dec 2014,CACF,2015,ASSOC STUDENTS CSU SAN DIEGO CHILDRENS CENTER ,CHILD_LUNCH,15,37,12,159,208,379,123,1627,2129,141.9333
SAN DIEGO,Dec 2014,CACF,2015,ASSOC STUDENTS CSU SAN DIEGO CHILDRENS CENTER ,CHILD_SNACK_PM,15,37,12,159,208,348,113,1495,1956,130.4
SAN DIEGO,Jan 2015,CACF,2015,ASSOC STUDENTS CSU SAN DIEGO CHILDRENS CENTER ,CHILD_BREAKFAST,19,37,12,159,208,268,87,1150,1505,79.2105
SAN DIEGO,Jan 2015,CACF,2015,ASSOC STUDENTS CSU SAN DIEGO CHILDRENS CENTER ,CHILD_LUNCH,19,37,12,159,208,428,139,1837,2404,126.5263
SAN DIEGO,Jan 2015,CACF,2015,ASSOC STUDENTS CSU SAN DIEGO CHILDRENS CENTER ,CHILD_SNACK_PM,19,37,12,159,208,396,128,1700,2224,117.0526
SAN DIEGO,Feb 2015,CACF,2015,ASSOC STUDENTS CSU SAN DIEGO CHILDRENS CENTER ,CHILD_BREAKFAST,20,37,12,159,208,331,107,1425,1863,93.15
SAN DIEGO,Feb 2015,CACF,2015,ASSOC STUDENTS CSU SAN DIEGO CHILDRENS CENTER ,CHILD_LUNCH,20,37,12,159,208,529,172,2273,2974,148.7
SAN DIEGO,Feb 2015,CACF,2015,ASSOC STUDENTS CSU SAN DIEGO CHILDRENS CENTER ,CHILD_SNACK_PM,20,37,12,159,208,482,156,2074,2712,135.6
SAN DIEGO,Mar 2015,CACF,2015,ASSOC STUDENTS CSU SAN DIEGO CHILDRENS CENTER ,CHILD_BREAKFAST,21,37,12,159,208,338,110,1453,1901,90.5238
SAN DIEGO,Mar 2015,CACF,2015,ASSOC STUDENTS CSU SAN DIEGO CHILDRENS CENTER ,CHILD_LUNCH,21,37,12,159,208,577,187,2482,3246,154.5714
SAN DIEGO,Mar 2015,CACF,2015,ASSOC STUDENTS CSU SAN DIEGO CHILDRENS CENTER ,CHILD_SNACK_PM,21,37,12,159,208,539,175,2317,3031,144.3333
SAN DIEGO,Apr 2015,CACF,2015,ASSOC STUDENTS CSU SAN DIEGO CHILDRENS CENTER ,CHILD_BREAKFAST,22,37,12,159,208,329,107,1412,1848,84
SAN DIEGO,Apr 2015,CACF,2015,ASSOC STUDENTS CSU SAN DIEGO CHILDRENS CENTER ,CHILD_LUNCH,22,37,12,159,208,577,187,2480,3244,147.4545
SAN DIEGO,Apr 2015,CACF,2015,ASSOC STUDENTS CSU SAN DIEGO CHILDRENS CENTER ,CHILD_SNACK_PM,22,37,12,159,208,534,173,2295,3002,136.4545
SAN DIEGO,May 2015,CACF,2015,ASSOC STUDENTS CSU SAN DIEGO CHILDRENS CENTER ,CHILD_BREAKFAST,20,37,12,159,208,285,92,1223,1600,80
SAN DIEGO,May 2015,CACF,2015,ASSOC STUDENTS CSU SAN DIEGO CHILDRENS CENTER ,CHILD_LUNCH,20,37,12,159,208,491,159,2108,2758,137.9
SAN DIEGO,May 2015,CACF,2015,ASSOC STUDENTS CSU SAN DIEGO CHILDRENS CENTER ,CHILD_SNACK_PM,20,37,12,159,208,459,149,1972,2580,129
SAN DIEGO,Jun 2015,CACF,2015,ASSOC STUDENTS CSU SAN DIEGO CHILDRENS CENTER ,CHILD_BREAKFAST,22,37,12,159,208,265,86,1138,1489,67.6818
SAN DIEGO,Jun 2015,CACF,2015,ASSOC STUDENTS CSU SAN DIEGO CHILDRENS CENTER ,CHILD_LUNCH,22,37,12,159,208,467,152,2008,2627,119.4091
SAN DIEGO,Jun 2015,CACF,2015,ASSOC STUDENTS CSU SAN DIEGO CHILDRENS CENTER ,CHILD_SNACK_PM,22,37,12,159,208,419,136,1799,2354,107
SAN DIEGO,Jul 2015,CACF,2015,ASSOC STUDENTS CSU SAN DIEGO CHILDRENS CENTER ,CHILD_BREAKFAST,21,37,12,159,208,237,77,1020,1334,63.5238
SAN DIEGO,Jul 2015,CACF,2015,ASSOC STUDENTS CSU SAN DIEGO CHILDRENS CENTER ,CHILD_LUNCH,21,37,12,159,208,430,140,1848,2418,115.1429
SAN DIEGO,Jul 2015,CACF,2015,ASSOC STUDENTS CSU SAN DIEGO CHILDRENS CENTER ,CHILD_SNACK_PM,21,37,12,159,208,392,127,1685,2204,104.9524
SAN DIEGO,Aug 2015,CACF,2015,ASSOC STUDENTS CSU SAN DIEGO CHILDRENS CENTER ,CHILD_BREAKFAST,20,37,12,159,208,239,77,1027,1343,67.15
SAN DIEGO,Aug 2015,CACF,2015,ASSOC STUDENTS CSU SAN DIEGO CHILDRENS CENTER ,CHILD_LUNCH,20,37,12,159,208,408,132,1755,2295,114.75
SAN DIEGO,Aug 2015,CACF,2015,ASSOC STUDENTS CSU SAN DIEGO CHILDRENS CENTER ,CHILD_SNACK_PM,20,37,12,159,208,370,120,1591,2081,104.05
SAN DIEGO,Sep 2015,CACF,2015,ASSOC STUDENTS CSU SAN DIEGO CHILDRENS CENTER ,CHILD_BREAKFAST,21,37,12,159,208,331,107,1424,1862,88.6667
SAN DIEGO,Sep 2015,CACF,2015,ASSOC STUDENTS CSU SAN DIEGO CHILDRENS CENTER ,CHILD_LUNCH,21,37,12,159,208,530,172,2275,2977,141.7619
SAN DIEGO,Sep 2015,CACF,2015,ASSOC STUDENTS CSU SAN DIEGO CHILDRENS CENTER ,CHILD_SNACK_PM,21,37,12,159,208,476,154,2045,2675,127.381
SAN DIEGO,Oct 2014,CACF,2015,ATC PACIFIC LLC,CHILD_BREAKFAST,23,17,3,19,39,259,46,290,595,25.8696
SAN DIEGO,Oct 2014,CACF,2015,ATC PACIFIC LLC,CHILD_LUNCH,23,17,3,19,39,241,43,270,554,24.087
SAN DIEGO,Oct 2014,CACF,2015,ATC PACIFIC LLC,CHILD_SNACK_PM,23,17,3,19,39,182,32,203,417,18.1304
SAN DIEGO,Oct 2014,CACF,2015,ATC PACIFIC LLC,OSCH_CHILD_BREAKFAST,23,10,0,5,15,118,0,59,177,7.6957
SAN DIEGO,Oct 2014,CACF,2015,ATC PACIFIC LLC,OSCH_CHILD_SNACK_PM,23,10,0,5,15,100,0,50,150,6.5217
SAN DIEGO,Nov 2014,CACF,2015,ATC PACIFIC LLC,CHILD_BREAKFAST,16,17,3,19,39,187,33,209,429,26.8125
SAN DIEGO,Nov 2014,CACF,2015,ATC PACIFIC LLC,CHILD_LUNCH,16,17,3,19,39,169,30,189,388,24.25
SAN DIEGO,Nov 2014,CACF,2015,ATC PACIFIC LLC,CHILD_SNACK_PM,16,17,3,19,39,93,16,104,213,13.3125
SAN DIEGO,Nov 2014,CACF,2015,ATC PACIFIC LLC,OSCH_CHILD_BREAKFAST,16,11,0,5,16,94,0,42,136,8.5
SAN DIEGO,Nov 2014,CACF,2015,ATC PACIFIC LLC,OSCH_CHILD_LUNCH,16,11,0,5,16,17,0,7,24,1.5
SAN DIEGO,Nov 2014,CACF,2015,ATC PACIFIC LLC,OSCH_CHILD_SNACK_PM,16,11,0,5,16,102,0,47,149,9.3125
SAN DIEGO,Dec 2014,CACF,2015,ATC PACIFIC LLC,CHILD_BREAKFAST,19,17,3,19,39,197,35,221,453,23.8421
SAN DIEGO,Dec 2014,CACF,2015,ATC PACIFIC LLC,CHILD_LUNCH,19,17,3,19,39,183,32,205,420,22.1053
SAN DIEGO,Dec 2014,CACF,2015,ATC PACIFIC LLC,CHILD_SNACK_PM,19,17,3,19,39,155,27,173,355,18.6842
SAN DIEGO,Dec 2014,CACF,2015,ATC PACIFIC LLC,OSCH_CHILD_BREAKFAST,19,11,0,5,16,85,0,38,123,6.4737
SAN DIEGO,Dec 2014,CACF,2015,ATC PACIFIC LLC,OSCH_CHILD_LUNCH,19,11,0,5,16,17,0,8,25,1.3158
SAN DIEGO,Dec 2014,CACF,2015,ATC PACIFIC LLC,OSCH_CHILD_SNACK_PM,19,11,0,5,16,83,0,38,121,6.3684
SAN DIEGO,Jan 2015,CACF,2015,ATC PACIFIC LLC,CHILD_BREAKFAST,20,17,3,19,39,144,25,162,331,16.55
SAN DIEGO,Jan 2015,CACF,2015,ATC PACIFIC LLC,CHILD_LUNCH,20,17,3,19,39,180,32,200,412,20.6
SAN DIEGO,Jan 2015,CACF,2015,ATC PACIFIC LLC,CHILD_SNACK_PM,20,17,3,19,39,138,24,155,317,15.85
SAN DIEGO,Jan 2015,CACF,2015,ATC PACIFIC LLC,OSCH_CHILD_BREAKFAST,20,11,0,5,16,91,0,42,133,6.65
SAN DIEGO,Jan 2015,CACF,2015,ATC PACIFIC LLC,OSCH_CHILD_LUNCH,20,11,0,5,16,1,0,1,2,0.1
SAN DIEGO,Jan 2015,CACF,2015,ATC PACIFIC LLC,OSCH_CHILD_SNACK_PM,20,11,0,5,16,88,0,40,128,6.4
SAN DIEGO,Feb 2015,CACF,2015,ATC PACIFIC LLC,CHILD_BREAKFAST,19,17,3,19,39,135,24,151,310,16.3158
SAN DIEGO,Feb 2015,CACF,2015,ATC PACIFIC LLC,CHILD_LUNCH,19,17,3,19,39,157,28,175,360,18.9474
SAN DIEGO,Feb 2015,CACF,2015,ATC PACIFIC LLC,CHILD_SNACK_PM,19,17,3,19,39,127,22,142,291,15.3158
SAN DIEGO,Feb 2015,CACF,2015,ATC PACIFIC LLC,OSCH_CHILD_BREAKFAST,19,11,0,5,16,98,0,44,142,7.4737
SAN DIEGO,Feb 2015,CACF,2015,ATC PACIFIC LLC,OSCH_CHILD_SNACK_PM,19,11,0,5,16,88,0,40,128,6.7368
SAN DIEGO,Mar 2015,CACF,2015,ATC PACIFIC LLC,CHILD_BREAKFAST,22,9,2,14,25,107,24,167,298,13.5455
SAN DIEGO,Mar 2015,CACF,2015,ATC PACIFIC LLC,CHILD_LUNCH,22,9,2,14,25,148,33,231,412,18.7273
SAN DIEGO,Mar 2015,CACF,2015,ATC PACIFIC LLC,CHILD_SNACK_PM,22,9,2,14,25,117,26,181,324,14.7273
SAN DIEGO,Mar 2015,CACF,2015,ATC PACIFIC LLC,OSCH_CHILD_BREAKFAST,22,9,0,6,15,87,0,58,145,6.5909
SAN DIEGO,Mar 2015,CACF,2015,ATC PACIFIC LLC,OSCH_CHILD_LUNCH,22,9,0,6,15,5,0,3,8,0.3636
SAN DIEGO,Mar 2015,CACF,2015,ATC PACIFIC LLC,OSCH_CHILD_SNACK_PM,22,9,0,6,15,86,0,57,143,6.5
SAN DIEGO,Apr 2015,CACF,2015,ATC PACIFIC LLC,CHILD_BREAKFAST,22,9,2,14,25,134,30,207,371,16.8636
SAN DIEGO,Apr 2015,CACF,2015,ATC PACIFIC LLC,CHILD_LUNCH,22,9,2,14,25,149,33,233,415,18.8636
SAN DIEGO,Apr 2015,CACF,2015,ATC PACIFIC LLC,CHILD_SNACK_PM,22,9,2,14,25,126,28,195,349,15.8636
SAN DIEGO,Apr 2015,CACF,2015,ATC PACIFIC LLC,OSCH_CHILD_BREAKFAST,22,9,0,6,15,77,0,51,128,5.8182
SAN DIEGO,Apr 2015,CACF,2015,ATC PACIFIC LLC,OSCH_CHILD_LUNCH,22,9,0,6,15,20,0,13,33,1.5
SAN DIEGO,Apr 2015,CACF,2015,ATC PACIFIC LLC,OSCH_CHILD_SNACK_PM,22,9,0,6,15,73,0,48,121,5.5
SAN DIEGO,May 2015,CACF,2015,ATC PACIFIC LLC,CHILD_BREAKFAST,20,9,2,13,24,121,27,174,322,16.1
SAN DIEGO,May 2015,CACF,2015,ATC PACIFIC LLC,CHILD_LUNCH,20,9,2,13,24,156,35,224,415,20.75
SAN DIEGO,May 2015,CACF,2015,ATC PACIFIC LLC,CHILD_SNACK_PM,20,9,2,13,24,121,27,175,323,16.15
SAN DIEGO,May 2015,CACF,2015,ATC PACIFIC LLC,OSCH_CHILD_BREAKFAST,20,8,0,6,14,73,0,54,127,6.35
SAN DIEGO,May 2015,CACF,2015,ATC PACIFIC LLC,OSCH_CHILD_SNACK_PM,20,8,0,6,14,57,0,42,99,4.95
SAN DIEGO,Jun 2015,CACF,2015,ATC PACIFIC LLC,CHILD_BREAKFAST,22,8,2,14,24,105,26,185,316,14.3636
SAN DIEGO,Jun 2015,CACF,2015,ATC PACIFIC LLC,CHILD_LUNCH,22,8,2,14,24,140,35,244,419,19.0455
SAN DIEGO,Jun 2015,CACF,2015,ATC PACIFIC LLC,CHILD_SNACK_PM,22,8,2,14,24,112,28,197,337,15.3182
SAN DIEGO,Jun 2015,CACF,2015,ATC PACIFIC LLC,OSCH_CHILD_BREAKFAST,22,5,0,5,10,63,0,63,126,5.7273
SAN DIEGO,Jun 2015,CACF,2015,ATC PACIFIC LLC,OSCH_CHILD_LUNCH,22,5,0,5,10,27,0,27,54,2.4545
SAN DIEGO,Jun 2015,CACF,2015,ATC PACIFIC LLC,OSCH_CHILD_SNACK_PM,22,5,0,5,10,52,0,52,104,4.7273
SAN DIEGO,Jul 2015,CACF,2015,ATC PACIFIC LLC,CHILD_BREAKFAST,22,8,2,14,24,103,26,181,310,14.0909
SAN DIEGO,Jul 2015,CACF,2015,ATC PACIFIC LLC,CHILD_LUNCH,22,8,2,14,24,135,34,235,404,18.3636
SAN DIEGO,Jul 2015,CACF,2015,ATC PACIFIC LLC,CHILD_SNACK_PM,22,8,2,14,24,119,30,207,356,16.1818
SAN DIEGO,Jul 2015,CACF,2015,ATC PACIFIC LLC,OSCH_CHILD_BREAKFAST,22,5,0,5,10,41,0,40,81,3.6818
SAN DIEGO,Jul 2015,CACF,2015,ATC PACIFIC LLC,OSCH_CHILD_LUNCH,22,5,0,5,10,44,0,43,87,3.9545
SAN DIEGO,Jul 2015,CACF,2015,ATC PACIFIC LLC,OSCH_CHILD_SNACK_PM,22,5,0,5,10,30,0,30,60,2.7273
SAN DIEGO,Aug 2015,CACF,2015,ATC PACIFIC LLC,CHILD_BREAKFAST,21,6,2,12,20,92,31,182,305,14.5238
SAN DIEGO,Aug 2015,CACF,2015,ATC PACIFIC LLC,CHILD_LUNCH,21,6,2,12,20,115,38,230,383,18.2381
SAN DIEGO,Aug 2015,CACF,2015,ATC PACIFIC LLC,CHILD_SNACK_PM,21,6,2,12,20,110,37,218,365,17.381
SAN DIEGO,Aug 2015,CACF,2015,ATC PACIFIC LLC,OSCH_CHILD_BREAKFAST,21,5,0,5,10,33,0,32,65,3.0952
SAN DIEGO,Aug 2015,CACF,2015,ATC PACIFIC LLC,OSCH_CHILD_LUNCH,21,5,0,5,10,37,0,37,74,3.5238
SAN DIEGO,Aug 2015,CACF,2015,ATC PACIFIC LLC,OSCH_CHILD_SNACK_PM,21,5,0,5,10,34,0,33,67,3.1905
SAN DIEGO,Sep 2015,CACF,2015,ATC PACIFIC LLC,CHILD_BREAKFAST,21,6,2,11,19,92,31,167,290,13.8095
SAN DIEGO,Sep 2015,CACF,2015,ATC PACIFIC LLC,CHILD_LUNCH,21,6,2,11,19,112,37,207,356,16.9524
SAN DIEGO,Sep 2015,CACF,2015,ATC PACIFIC LLC,CHILD_SNACK_PM,21,6,2,11,19,117,39,214,370,17.619
SAN DIEGO,Sep 2015,CACF,2015,ATC PACIFIC LLC,OSCH_CHILD_BREAKFAST,21,5,0,5,10,47,0,46,93,4.4286
SAN DIEGO,Sep 2015,CACF,2015,ATC PACIFIC LLC,OSCH_CHILD_LUNCH,21,5,0,5,10,2,0,2,4,0.1905
SAN DIEGO,Sep 2015,CACF,2015,ATC PACIFIC LLC,OSCH_CHILD_SNACK_PM,21,5,0,5,10,30,0,30,60,2.8571
SAN DIEGO,Oct 2014,CACF,2015,Boys & Girls Club of Greater San Diego,CHILD_BREAKFAST,23,45,11,3,59,624,152,42,818,35.5652
SAN DIEGO,Oct 2014,CACF,2015,Boys & Girls Club of Greater San Diego,CHILD_LUNCH,23,45,11,3,59,782,191,52,1025,44.5652
SAN DIEGO,Oct 2014,CACF,2015,Boys & Girls Club of Greater San Diego,CHILD_SNACK_PM,23,45,11,3,59,762,186,51,999,43.4348
SAN DIEGO,Oct 2014,CACF,2015,Boys & Girls Club of Greater San Diego,OSCH_CHILD_BREAKFAST,23,41,5,2,48,37,4,2,43,1.8696
SAN DIEGO,Oct 2014,CACF,2015,Boys & Girls Club of Greater San Diego,OSCH_CHILD_LUNCH,23,41,5,2,48,395,48,20,463,20.1304
SAN DIEGO,Oct 2014,CACF,2015,Boys & Girls Club of Greater San Diego,OSCH_CHILD_SNACK_PM,23,41,5,2,48,675,82,33,790,34.3478
SAN DIEGO,Nov 2014,CACF,2015,Boys & Girls Club of Greater San Diego,CHILD_BREAKFAST,17,45,11,3,59,493,120,33,646,38
SAN DIEGO,Nov 2014,CACF,2015,Boys & Girls Club of Greater San Diego,CHILD_LUNCH,17,45,11,3,59,593,145,40,778,45.7647
SAN DIEGO,Nov 2014,CACF,2015,Boys & Girls Club of Greater San Diego,CHILD_SNACK_PM,17,45,11,3,59,561,137,37,735,43.2353
SAN DIEGO,Nov 2014,CACF,2015,Boys & Girls Club of Greater San Diego,OSCH_CHILD_BREAKFAST,17,41,5,2,48,56,7,2,65,3.8235
SAN DIEGO,Nov 2014,CACF,2015,Boys & Girls Club of Greater San Diego,OSCH_CHILD_LUNCH,17,41,5,2,48,308,38,15,361,21.2353
SAN DIEGO,Nov 2014,CACF,2015,Boys & Girls Club of Greater San Diego,OSCH_CHILD_SNACK_PM,17,41,5,2,48,467,57,23,547,32.1765
SAN DIEGO,Dec 2014,CACF,2015,Boys & Girls Club of Greater San Diego,CHILD_BREAKFAST,18,45,11,3,59,489,119,33,641,35.6111
SAN DIEGO,Dec 2014,CACF,2015,Boys & Girls Club of Greater San Diego,CHILD_LUNCH,18,45,11,3,59,607,148,41,796,44.2222
SAN DIEGO,Dec 2014,CACF,2015,Boys & Girls Club of Greater San Diego,CHILD_SNACK_PM,18,45,11,3,59,569,139,38,746,41.4444
SAN DIEGO,Dec 2014,CACF,2015,Boys & Girls Club of Greater San Diego,OSCH_CHILD_BREAKFAST,18,41,5,2,48,44,5,2,51,2.8333
SAN DIEGO,Dec 2014,CACF,2015,Boys & Girls Club of Greater San Diego,OSCH_CHILD_LUNCH,18,41,5,2,48,283,34,14,331,18.3889
SAN DIEGO,Dec 2014,CACF,2015,Boys & Girls Club of Greater San Diego,OSCH_CHILD_SNACK_PM,18,41,5,2,48,459,56,22,537,29.8333
SAN DIEGO,Jan 2015,CACF,2015,Boys & Girls Club of Greater San Diego,CHILD_BREAKFAST,19,45,11,3,59,529,129,36,694,36.5263
SAN DIEGO,Jan 2015,CACF,2015,Boys & Girls Club of Greater San Diego,CHILD_LUNCH,19,45,11,3,59,660,161,45,866,45.5789
SAN DIEGO,Jan 2015,CACF,2015,Boys & Girls Club of Greater San Diego,CHILD_SNACK_PM,19,45,11,3,59,657,161,44,862,45.3684
SAN DIEGO,Jan 2015,CACF,2015,Boys & Girls Club of Greater San Diego,OSCH_CHILD_BREAKFAST,19,41,5,2,48,19,2,1,22,1.1579
SAN DIEGO,Jan 2015,CACF,2015,Boys & Girls Club of Greater San Diego,OSCH_CHILD_LUNCH,19,41,5,2,48,285,35,14,334,17.5789
SAN DIEGO,Jan 2015,CACF,2015,Boys & Girls Club of Greater San Diego,OSCH_CHILD_SNACK_PM,19,41,5,2,48,507,62,25,594,31.2632
SAN DIEGO,Feb 2015,CACF,2015,Boys & Girls Club of Greater San Diego,CHILD_BREAKFAST,20,45,11,3,59,571,140,38,749,37.45
SAN DIEGO,Feb 2015,CACF,2015,Boys & Girls Club of Greater San Diego,CHILD_LUNCH,20,45,11,3,59,718,176,48,942,47.1
SAN DIEGO,Feb 2015,CACF,2015,Boys & Girls Club of Greater San Diego,CHILD_SNACK_PM,20,45,11,3,59,692,169,46,907,45.35
SAN DIEGO,Feb 2015,CACF,2015,Boys & Girls Club of Greater San Diego,OSCH_CHILD_BREAKFAST,20,41,5,2,48,26,3,1,30,1.5
SAN DIEGO,Feb 2015,CACF,2015,Boys & Girls Club of Greater San Diego,OSCH_CHILD_LUNCH,20,41,5,2,48,282,34,14,330,16.5
SAN DIEGO,Feb 2015,CACF,2015,Boys & Girls Club of Greater San Diego,OSCH_CHILD_SNACK_PM,20,41,5,2,48,501,61,25,587,29.35
SAN DIEGO,Mar 2015,CACF,2015,Boys & Girls Club of Greater San Diego,CHILD_BREAKFAST,22,45,11,3,59,696,170,46,912,41.4545
SAN DIEGO,Mar 2015,CACF,2015,Boys & Girls Club of Greater San Diego,CHILD_LUNCH,22,45,11,3,59,827,202,55,1084,49.2727
SAN DIEGO,Mar 2015,CACF,2015,Boys & Girls Club of Greater San Diego,CHILD_SNACK_PM,22,45,11,3,59,807,197,54,1058,48.0909
SAN DIEGO,Mar 2015,CACF,2015,Boys & Girls Club of Greater San Diego,OSCH_CHILD_BREAKFAST,22,41,5,2,48,39,5,2,46,2.0909
SAN DIEGO,Mar 2015,CACF,2015,Boys & Girls Club of Greater San Diego,OSCH_CHILD_LUNCH,22,41,5,2,48,313,38,16,367,16.6818
SAN DIEGO,Mar 2015,CACF,2015,Boys & Girls Club of Greater San Diego,OSCH_CHILD_SNACK_PM,22,41,5,2,48,572,70,28,670,30.4545
SAN DIEGO,Apr 2015,CACF,2015,Boys & Girls Club of Greater San Diego,CHILD_BREAKFAST,22,45,11,3,59,691,169,46,906,41.1818
SAN DIEGO,Apr 2015,CACF,2015,Boys & Girls Club of Greater San Diego,CHILD_LUNCH,22,45,11,3,59,827,202,55,1084,49.2727
SAN DIEGO,Apr 2015,CACF,2015,Boys & Girls Club of Greater San Diego,CHILD_SNACK_PM,22,45,11,3,59,778,190,52,1020,46.3636
SAN DIEGO,Apr 2015,CACF,2015,Boys & Girls Club of Greater San Diego,OSCH_CHILD_BREAKFAST,22,41,5,2,48,160,19,8,187,8.5
SAN DIEGO,Apr 2015,CACF,2015,Boys & Girls Club of Greater San Diego,OSCH_CHILD_LUNCH,22,41,5,2,48,371,45,18,434,19.7273
SAN DIEGO,Apr 2015,CACF,2015,Boys & Girls Club of Greater San Diego,OSCH_CHILD_SNACK_PM,22,41,5,2,48,529,64,26,619,28.1364
SAN DIEGO,May 2015,CACF,2015,Boys & Girls Club of Greater San Diego,CHILD_BREAKFAST,20,45,11,3,59,660,161,45,866,43.3
SAN DIEGO,May 2015,CACF,2015,Boys & Girls Club of Greater San Diego,CHILD_LUNCH,20,45,11,3,59,776,190,51,1017,50.85
SAN DIEGO,May 2015,CACF,2015,Boys & Girls Club of Greater San Diego,CHILD_SNACK_PM,20,45,11,3,59,741,181,49,971,48.55
SAN DIEGO,May 2015,CACF,2015,Boys & Girls Club of Greater San Diego,OSCH_CHILD_LUNCH,20,41,5,2,48,247,30,12,289,14.45
SAN DIEGO,May 2015,CACF,2015,Boys & Girls Club of Greater San Diego,OSCH_CHILD_SNACK_PM,20,41,5,2,48,474,58,23,555,27.75
SAN DIEGO,Jun 2015,CACF,2015,Boys & Girls Club of Greater San Diego,CHILD_BREAKFAST,22,45,11,3,59,736,180,49,965,43.8636
SAN DIEGO,Jun 2015,CACF,2015,Boys & Girls Club of Greater San Diego,CHILD_LUNCH,22,45,11,3,59,855,209,57,1121,50.9545
SAN DIEGO,Jun 2015,CACF,2015,Boys & Girls Club of Greater San Diego,CHILD_SNACK_PM,22,45,11,3,59,801,196,53,1050,47.7273
SAN DIEGO,Jun 2015,CACF,2015,Boys & Girls Club of Greater San Diego,OSCH_CHILD_BREAKFAST,22,41,5,2,48,207,25,10,242,11
SAN DIEGO,Jun 2015,CACF,2015,Boys & Girls Club of Greater San Diego,OSCH_CHILD_LUNCH,22,41,5,2,48,377,46,18,441,20.0455
SAN DIEGO,Jun 2015,CACF,2015,Boys & Girls Club of Greater San Diego,OSCH_CHILD_SNACK_PM,22,41,5,2,48,457,56,22,535,24.3182
SAN DIEGO,Jul 2015,CACF,2015,Boys & Girls Club of Greater San Diego,CHILD_BREAKFAST,22,45,11,3,59,641,157,43,841,38.2273
SAN DIEGO,Jul 2015,CACF,2015,Boys & Girls Club of Greater San Diego,CHILD_LUNCH,22,45,11,3,59,722,176,48,946,43
SAN DIEGO,Jul 2015,CACF,2015,Boys & Girls Club of Greater San Diego,CHILD_SNACK_PM,22,45,11,3,59,681,166,46,893,40.5909
SAN DIEGO,Jul 2015,CACF,2015,Boys & Girls Club of Greater San Diego,OSCH_CHILD_BREAKFAST,22,41,5,2,48,572,70,28,670,30.4545
SAN DIEGO,Jul 2015,CACF,2015,Boys & Girls Club of Greater San Diego,OSCH_CHILD_LUNCH,22,41,5,2,48,675,82,33,790,35.9091
SAN DIEGO,Jul 2015,CACF,2015,Boys & Girls Club of Greater San Diego,OSCH_CHILD_SNACK_PM,22,41,5,2,48,589,72,29,690,31.3636
SAN DIEGO,Aug 2015,CACF,2015,Boys & Girls Club of Greater San Diego,CHILD_BREAKFAST,21,45,11,3,59,612,149,41,802,38.1905
SAN DIEGO,Aug 2015,CACF,2015,Boys & Girls Club of Greater San Diego,CHILD_LUNCH,21,45,11,3,59,711,174,47,932,44.381
SAN DIEGO,Aug 2015,CACF,2015,Boys & Girls Club of Greater San Diego,CHILD_SNACK_PM,21,45,11,3,59,669,163,45,877,41.7619
SAN DIEGO,Aug 2015,CACF,2015,Boys & Girls Club of Greater San Diego,OSCH_CHILD_BREAKFAST,21,41,5,2,48,249,30,12,291,13.8571
SAN DIEGO,Aug 2015,CACF,2015,Boys & Girls Club of Greater San Diego,OSCH_CHILD_LUNCH,21,41,5,2,48,379,46,19,444,21.1429
SAN DIEGO,Aug 2015,CACF,2015,Boys & Girls Club of Greater San Diego,OSCH_CHILD_SNACK_PM,21,41,5,2,48,522,64,25,611,29.0952
SAN DIEGO,Sep 2015,CACF,2015,Boys & Girls Club of Greater San Diego,CHILD_BREAKFAST,21,45,11,3,59,615,150,42,807,38.4286
SAN DIEGO,Sep 2015,CACF,2015,Boys & Girls Club of Greater San Diego,CHILD_LUNCH,21,45,11,3,59,728,178,49,955,45.4762
SAN DIEGO,Sep 2015,CACF,2015,Boys & Girls Club of Greater San Diego,CHILD_SNACK_PM,21,45,11,3,59,664,162,44,870,41.4286
SAN DIEGO,Sep 2015,CACF,2015,Boys & Girls Club of Greater San Diego,OSCH_CHILD_LUNCH,21,41,5,2,48,155,19,8,182,8.6667
SAN DIEGO,Sep 2015,CACF,2015,Boys & Girls Club of Greater San Diego,OSCH_CHILD_SNACK_PM,21,41,5,2,48,524,64,26,614,29.2381
SAN DIEGO,Oct 2014,CACF,2015,BOYS & GIRLS CLUB OF IMPERIAL BEACH ,ATRISK_CHILD_SNACK,23,150,0,0,150,1413,0,0,1413,61.4348
SAN DIEGO,Dec 2014,CACF,2015,BOYS & GIRLS CLUB OF IMPERIAL BEACH ,ATRISK_CHILD_SNACK,15,150,0,0,150,986,0,0,986,65.7333
SAN DIEGO,Aug 2015,CACF,2015,BOYS & GIRLS CLUB OF IMPERIAL BEACH ,ATRISK_CHILD_SNACK,21,150,0,0,150,1274,0,0,1274,60.6667
SAN DIEGO,Sep 2015,CACF,2015,BOYS & GIRLS CLUB OF IMPERIAL BEACH ,ATRISK_CHILD_SNACK,21,150,0,0,150,1324,0,0,1324,63.0476
SAN DIEGO,Dec 2014,CACF,2015,"BOYS & GIRLS CLUBS OF OCEANSIDE, CALIFORNIA, INCORPORATED",ATRISK_CHILD_SNACK,6,125,0,0,125,249,0,0,249,41.5
SAN DIEGO,Dec 2014,CACF,2015,"BOYS & GIRLS CLUBS OF OCEANSIDE, CALIFORNIA, INCORPORATED",ATRISK_CHILD_SUPPER,6,125,0,0,125,385,0,0,385,64.1667
SAN DIEGO,Jan 2015,CACF,2015,"BOYS & GIRLS CLUBS OF OCEANSIDE, CALIFORNIA, INCORPORATED",ATRISK_CHILD_SNACK,19,133,0,0,133,313,0,0,313,16.4737
SAN DIEGO,Jan 2015,CACF,2015,"BOYS & GIRLS CLUBS OF OCEANSIDE, CALIFORNIA, INCORPORATED",ATRISK_CHILD_SUPPER,19,133,0,0,133,1020,0,0,1020,53.6842
SAN DIEGO,Feb 2015,CACF,2015,"BOYS & GIRLS CLUBS OF OCEANSIDE, CALIFORNIA, INCORPORATED",ATRISK_CHILD_SNACK,19,266,0,0,266,474,0,0,474,24.9474
SAN DIEGO,Feb 2015,CACF,2015,"BOYS & GIRLS CLUBS OF OCEANSIDE, CALIFORNIA, INCORPORATED",ATRISK_CHILD_SUPPER,19,266,0,0,266,1189,0,0,1189,62.5789
SAN DIEGO,Mar 2015,CACF,2015,"BOYS & GIRLS CLUBS OF OCEANSIDE, CALIFORNIA, INCORPORATED",ATRISK_CHILD_SNACK,22,161,0,0,161,679,0,0,679,30.8636
SAN DIEGO,Mar 2015,CACF,2015,"BOYS & GIRLS CLUBS OF OCEANSIDE, CALIFORNIA, INCORPORATED",ATRISK_CHILD_SUPPER,22,161,0,0,161,1415,0,0,1415,64.3182
SAN DIEGO,Apr 2015,CACF,2015,"BOYS & GIRLS CLUBS OF OCEANSIDE, CALIFORNIA, INCORPORATED",ATRISK_CHILD_SNACK,22,264,0,0,264,776,0,0,776,35.2727
SAN DIEGO,Apr 2015,CACF,2015,"BOYS & GIRLS CLUBS OF OCEANSIDE, CALIFORNIA, INCORPORATED",ATRISK_CHILD_SUPPER,22,264,0,0,264,1425,0,0,1425,64.7727
SAN DIEGO,May 2015,CACF,2015,"BOYS & GIRLS CLUBS OF OCEANSIDE, CALIFORNIA, INCORPORATED",ATRISK_CHILD_SNACK,20,147,0,0,147,457,0,0,457,22.85
SAN DIEGO,May 2015,CACF,2015,"BOYS & GIRLS CLUBS OF OCEANSIDE, CALIFORNIA, INCORPORATED",ATRISK_CHILD_SUPPER,20,147,0,0,147,1315,0,0,1315,65.75
SAN DIEGO,Aug 2015,CACF,2015,"BOYS & GIRLS CLUBS OF OCEANSIDE, CALIFORNIA, INCORPORATED",ATRISK_CHILD_SNACK,11,98,0,0,98,378,0,0,378,34.3636
SAN DIEGO,Aug 2015,CACF,2015,"BOYS & GIRLS CLUBS OF OCEANSIDE, CALIFORNIA, INCORPORATED",ATRISK_CHILD_SUPPER,11,98,0,0,98,840,0,0,840,76.3636
SAN DIEGO,Sep 2015,CACF,2015,"BOYS & GIRLS CLUBS OF OCEANSIDE, CALIFORNIA, INCORPORATED",ATRISK_CHILD_SNACK,21,147,0,0,147,711,0,0,711,33.8571
SAN DIEGO,Sep 2015,CACF,2015,"BOYS & GIRLS CLUBS OF OCEANSIDE, CALIFORNIA, INCORPORATED",ATRISK_CHILD_SUPPER,21,147,0,0,147,1320,0,0,1320,62.8571
SAN DIEGO,Nov 2014,CACF,2015,BOYS CLUB OF FALLBROOK,ATRISK_CHILD_SNACK,5,341,0,0,341,103,0,0,103,20.6
SAN DIEGO,Nov 2014,CACF,2015,BOYS CLUB OF FALLBROOK,ATRISK_CHILD_SUPPER,5,341,0,0,341,449,0,0,449,89.8
SAN DIEGO,Dec 2014,CACF,2015,BOYS CLUB OF FALLBROOK,ATRISK_CHILD_SUPPER,15,197,0,0,197,1966,0,0,1966,131.0667
SAN DIEGO,Jan 2015,CACF,2015,BOYS CLUB OF FALLBROOK,ATRISK_CHILD_SUPPER,19,256,0,0,256,2517,0,0,2517,132.4737
SAN DIEGO,Feb 2015,CACF,2015,BOYS CLUB OF FALLBROOK,ATRISK_CHILD_SNACK,20,275,0,0,275,72,0,0,72,3.6
SAN DIEGO,Feb 2015,CACF,2015,BOYS CLUB OF FALLBROOK,ATRISK_CHILD_SUPPER,20,275,0,0,275,2516,0,0,2516,125.8
SAN DIEGO,Mar 2015,CACF,2015,BOYS CLUB OF FALLBROOK,ATRISK_CHILD_SNACK,22,225,0,0,225,59,0,0,59,2.6818
SAN DIEGO,Mar 2015,CACF,2015,BOYS CLUB OF FALLBROOK,ATRISK_CHILD_SUPPER,22,225,0,0,225,2935,0,0,2935,133.4091
SAN DIEGO,Apr 2015,CACF,2015,BOYS CLUB OF FALLBROOK,ATRISK_CHILD_SNACK,22,279,0,0,279,75,0,0,75,3.4091
SAN DIEGO,Apr 2015,CACF,2015,BOYS CLUB OF FALLBROOK,ATRISK_CHILD_SUPPER,22,279,0,0,279,2998,0,0,2998,136.2727
SAN DIEGO,May 2015,CACF,2015,BOYS CLUB OF FALLBROOK,ATRISK_CHILD_SUPPER,19,303,0,0,303,2833,0,0,2833,149.1053
SAN DIEGO,Oct 2014,CACF,2015,CA RELIABLE MEDICAL SYSTEMS INC ,ADULT_BREAKFAST,31,469,0,0,469,5462,0,0,5462,176.1935
SAN DIEGO,Oct 2014,CACF,2015,CA RELIABLE MEDICAL SYSTEMS INC ,ADULT_LUNCH,31,469,0,0,469,5462,0,0,5462,176.1935
SAN DIEGO,Oct 2014,CACF,2015,CA RELIABLE MEDICAL SYSTEMS INC ,ADULT_SNACK_AM,31,469,0,0,469,5462,0,0,5462,176.1935
SAN DIEGO,Nov 2014,CACF,2015,CA RELIABLE MEDICAL SYSTEMS INC ,ADULT_BREAKFAST,30,469,0,0,469,5167,0,0,5167,172.2333
SAN DIEGO,Nov 2014,CACF,2015,CA RELIABLE MEDICAL SYSTEMS INC ,ADULT_LUNCH,30,469,0,0,469,5167,0,0,5167,172.2333
SAN DIEGO,Nov 2014,CACF,2015,CA RELIABLE MEDICAL SYSTEMS INC ,ADULT_SNACK_AM,30,469,0,0,469,5167,0,0,5167,172.2333
SAN DIEGO,Dec 2014,CACF,2015,CA RELIABLE MEDICAL SYSTEMS INC ,ADULT_BREAKFAST,31,469,0,0,469,5380,0,0,5380,173.5484
SAN DIEGO,Dec 2014,CACF,2015,CA RELIABLE MEDICAL SYSTEMS INC ,ADULT_LUNCH,31,469,0,0,469,5380,0,0,5380,173.5484
SAN DIEGO,Dec 2014,CACF,2015,CA RELIABLE MEDICAL SYSTEMS INC ,ADULT_SNACK_AM,31,469,0,0,469,5380,0,0,5380,173.5484
SAN DIEGO,Jan 2015,CACF,2015,CA RELIABLE MEDICAL SYSTEMS INC ,ADULT_BREAKFAST,31,469,0,0,469,5298,0,0,5298,170.9032
SAN DIEGO,Jan 2015,CACF,2015,CA RELIABLE MEDICAL SYSTEMS INC ,ADULT_LUNCH,31,469,0,0,469,5298,0,0,5298,170.9032
SAN DIEGO,Jan 2015,CACF,2015,CA RELIABLE MEDICAL SYSTEMS INC ,ADULT_SNACK_AM,31,469,0,0,469,5298,0,0,5298,170.9032
SAN DIEGO,Feb 2015,CACF,2015,CA RELIABLE MEDICAL SYSTEMS INC ,ADULT_BREAKFAST,28,469,0,0,469,4912,0,0,4912,175.4286
SAN DIEGO,Feb 2015,CACF,2015,CA RELIABLE MEDICAL SYSTEMS INC ,ADULT_LUNCH,28,469,0,0,469,4912,0,0,4912,175.4286
SAN DIEGO,Feb 2015,CACF,2015,CA RELIABLE MEDICAL SYSTEMS INC ,ADULT_SNACK_AM,28,469,0,0,469,4912,0,0,4912,175.4286
SAN DIEGO,Mar 2015,CACF,2015,CA RELIABLE MEDICAL SYSTEMS INC ,ADULT_BREAKFAST,31,469,0,0,469,5278,0,0,5278,170.2581
SAN DIEGO,Mar 2015,CACF,2015,CA RELIABLE MEDICAL SYSTEMS INC ,ADULT_LUNCH,31,469,0,0,469,5278,0,0,5278,170.2581
SAN DIEGO,Mar 2015,CACF,2015,CA RELIABLE MEDICAL SYSTEMS INC ,ADULT_SNACK_AM,31,469,0,0,469,5278,0,0,5278,170.2581
SAN DIEGO,Apr 2015,CACF,2015,CA RELIABLE MEDICAL SYSTEMS INC ,ADULT_BREAKFAST,29,469,0,0,469,5003,0,0,5003,172.5172
SAN DIEGO,Apr 2015,CACF,2015,CA RELIABLE MEDICAL SYSTEMS INC ,ADULT_LUNCH,29,469,0,0,469,5003,0,0,5003,172.5172
SAN DIEGO,Apr 2015,CACF,2015,CA RELIABLE MEDICAL SYSTEMS INC ,ADULT_SNACK_AM,29,469,0,0,469,5003,0,0,5003,172.5172
SAN DIEGO,May 2015,CACF,2015,CA RELIABLE MEDICAL SYSTEMS INC ,ADULT_BREAKFAST,31,469,0,0,469,5403,0,0,5403,174.2903
SAN DIEGO,May 2015,CACF,2015,CA RELIABLE MEDICAL SYSTEMS INC ,ADULT_LUNCH,31,469,0,0,469,5403,0,0,5403,174.2903
SAN DIEGO,May 2015,CACF,2015,CA RELIABLE MEDICAL SYSTEMS INC ,ADULT_SNACK_AM,31,469,0,0,469,5403,0,0,5403,174.2903
SAN DIEGO,Jun 2015,CACF,2015,CA RELIABLE MEDICAL SYSTEMS INC ,ADULT_BREAKFAST,30,469,0,0,469,5243,0,0,5243,174.7667
SAN DIEGO,Jun 2015,CACF,2015,CA RELIABLE MEDICAL SYSTEMS INC ,ADULT_LUNCH,30,469,0,0,469,5243,0,0,5243,174.7667
SAN DIEGO,Jun 2015,CACF,2015,CA RELIABLE MEDICAL SYSTEMS INC ,ADULT_SNACK_AM,30,469,0,0,469,5243,0,0,5243,174.7667
SAN DIEGO,Jul 2015,CACF,2015,CA RELIABLE MEDICAL SYSTEMS INC ,ADULT_BREAKFAST,31,469,0,0,469,5431,0,0,5431,175.1935
SAN DIEGO,Jul 2015,CACF,2015,CA RELIABLE MEDICAL SYSTEMS INC ,ADULT_LUNCH,31,469,0,0,469,5431,0,0,5431,175.1935
SAN DIEGO,Jul 2015,CACF,2015,CA RELIABLE MEDICAL SYSTEMS INC ,ADULT_SNACK_AM,31,469,0,0,469,5431,0,0,5431,175.1935
SAN DIEGO,Aug 2015,CACF,2015,CA RELIABLE MEDICAL SYSTEMS INC ,ADULT_BREAKFAST,31,469,0,0,469,5581,0,0,5581,180.0323
SAN DIEGO,Aug 2015,CACF,2015,CA RELIABLE MEDICAL SYSTEMS INC ,ADULT_LUNCH,31,469,0,0,469,5581,0,0,5581,180.0323
SAN DIEGO,Aug 2015,CACF,2015,CA RELIABLE MEDICAL SYSTEMS INC ,ADULT_SNACK_AM,31,469,0,0,469,5581,0,0,5581,180.0323
SAN DIEGO,Sep 2015,CACF,2015,CA RELIABLE MEDICAL SYSTEMS INC ,ADULT_BREAKFAST,30,469,0,0,469,5585,0,0,5585,186.1667
SAN DIEGO,Sep 2015,CACF,2015,CA RELIABLE MEDICAL SYSTEMS INC ,ADULT_LUNCH,30,469,0,0,469,5585,0,0,5585,186.1667
SAN DIEGO,Sep 2015,CACF,2015,CA RELIABLE MEDICAL SYSTEMS INC ,ADULT_SNACK_AM,30,469,0,0,469,5585,0,0,5585,186.1667
SAN DIEGO,Oct 2014,CACF,2015,CASA DE AMPARO,CHILD_BREAKFAST,23,19,8,3,30,261,110,41,412,17.913
SAN DIEGO,Oct 2014,CACF,2015,CASA DE AMPARO,CHILD_LUNCH,23,19,8,3,30,315,133,50,498,21.6522
SAN DIEGO,Oct 2014,CACF,2015,CASA DE AMPARO,CHILD_SNACK_PM,23,19,8,3,30,241,102,38,381,16.5652
SAN DIEGO,Nov 2014,CACF,2015,CASA DE AMPARO,CHILD_BREAKFAST,18,25,4,2,31,252,40,21,313,17.3889
SAN DIEGO,Nov 2014,CACF,2015,CASA DE AMPARO,CHILD_LUNCH,18,25,4,2,31,327,52,27,406,22.5556
SAN DIEGO,Nov 2014,CACF,2015,CASA DE AMPARO,CHILD_SNACK_PM,18,25,4,2,31,237,38,19,294,16.3333
SAN DIEGO,Dec 2014,CACF,2015,CASA DE AMPARO,CHILD_BREAKFAST,19,25,4,2,31,256,41,20,317,16.6842
SAN DIEGO,Dec 2014,CACF,2015,CASA DE AMPARO,CHILD_LUNCH,19,25,4,2,31,341,55,27,423,22.2632
SAN DIEGO,Dec 2014,CACF,2015,CASA DE AMPARO,CHILD_SNACK_PM,19,25,4,2,31,223,36,18,277,14.5789
SAN DIEGO,Jan 2015,CACF,2015,CASA DE AMPARO,CHILD_BREAKFAST,19,4,3,1,8,35,26,9,70,3.6842
SAN DIEGO,Jan 2015,CACF,2015,CASA DE AMPARO,CHILD_LUNCH,19,4,3,1,8,63,47,15,125,6.5789
SAN DIEGO,Jan 2015,CACF,2015,CASA DE AMPARO,CHILD_SNACK_PM,19,4,3,1,8,33,24,8,65,3.4211
SAN DIEGO,Jan 2015,CACF,2015,CASA DE AMPARO,HS_CHILD_BREAKFAST,19,22,0,0,22,257,0,0,257,13.5263
SAN DIEGO,Jan 2015,CACF,2015,CASA DE AMPARO,HS_CHILD_LUNCH,19,22,0,0,22,309,0,0,309,16.2632
SAN DIEGO,Jan 2015,CACF,2015,CASA DE AMPARO,HS_CHILD_SNACK_PM,19,22,0,0,22,240,0,0,240,12.6316
SAN DIEGO,Feb 2015,CACF,2015,CASA DE AMPARO,CHILD_BREAKFAST,19,3,1,0,4,16,5,0,21,1.1053
SAN DIEGO,Feb 2015,CACF,2015,CASA DE AMPARO,CHILD_LUNCH,19,3,1,0,4,34,12,0,46,2.4211
SAN DIEGO,Feb 2015,CACF,2015,CASA DE AMPARO,CHILD_SNACK_PM,19,3,1,0,4,12,4,0,16,0.8421
SAN DIEGO,Feb 2015,CACF,2015,CASA DE AMPARO,HS_CHILD_BREAKFAST,19,26,0,0,26,294,0,0,294,15.4737
SAN DIEGO,Feb 2015,CACF,2015,CASA DE AMPARO,HS_CHILD_LUNCH,19,26,0,0,26,378,0,0,378,19.8947
SAN DIEGO,Feb 2015,CACF,2015,CASA DE AMPARO,HS_CHILD_SNACK_PM,19,26,0,0,26,304,0,0,304,16
SAN DIEGO,Mar 2015,CACF,2015,CASA DE AMPARO,CHILD_BREAKFAST,22,3,1,0,4,10,3,0,13,0.5909
SAN DIEGO,Mar 2015,CACF,2015,CASA DE AMPARO,CHILD_LUNCH,22,3,1,0,4,39,13,0,52,2.3636
SAN DIEGO,Mar 2015,CACF,2015,CASA DE AMPARO,CHILD_SNACK_PM,22,3,1,0,4,9,3,0,12,0.5455
SAN DIEGO,Mar 2015,CACF,2015,CASA DE AMPARO,HS_CHILD_BREAKFAST,22,26,0,0,26,383,0,0,383,17.4091
SAN DIEGO,Mar 2015,CACF,2015,CASA DE AMPARO,HS_CHILD_LUNCH,22,26,0,0,26,493,0,0,493,22.4091
SAN DIEGO,Mar 2015,CACF,2015,CASA DE AMPARO,HS_CHILD_SNACK_PM,22,26,0,0,26,365,0,0,365,16.5909
SAN DIEGO,Apr 2015,CACF,2015,CASA DE AMPARO,CHILD_BREAKFAST,22,3,1,0,4,8,3,0,11,0.5
SAN DIEGO,Apr 2015,CACF,2015,CASA DE AMPARO,CHILD_LUNCH,22,3,1,0,4,33,11,0,44,2
SAN DIEGO,Apr 2015,CACF,2015,CASA DE AMPARO,CHILD_SNACK_PM,22,3,1,0,4,9,3,0,12,0.5455
SAN DIEGO,Apr 2015,CACF,2015,CASA DE AMPARO,HS_CHILD_BREAKFAST,22,26,0,0,26,332,0,0,332,15.0909
SAN DIEGO,Apr 2015,CACF,2015,CASA DE AMPARO,HS_CHILD_LUNCH,22,26,0,0,26,460,0,0,460,20.9091
SAN DIEGO,Apr 2015,CACF,2015,CASA DE AMPARO,HS_CHILD_SNACK_PM,22,26,0,0,26,331,0,0,331,15.0455
SAN DIEGO,May 2015,CACF,2015,CASA DE AMPARO,CHILD_BREAKFAST,20,3,1,0,4,25,9,0,34,1.7
SAN DIEGO,May 2015,CACF,2015,CASA DE AMPARO,CHILD_LUNCH,20,3,1,0,4,48,16,0,64,3.2
SAN DIEGO,May 2015,CACF,2015,CASA DE AMPARO,CHILD_SNACK_PM,20,3,1,0,4,28,10,0,38,1.9
SAN DIEGO,May 2015,CACF,2015,CASA DE AMPARO,HS_CHILD_BREAKFAST,20,23,0,0,23,261,0,0,261,13.05
SAN DIEGO,May 2015,CACF,2015,CASA DE AMPARO,HS_CHILD_LUNCH,20,23,0,0,23,368,0,0,368,18.4
SAN DIEGO,May 2015,CACF,2015,CASA DE AMPARO,HS_CHILD_SNACK_PM,20,23,0,0,23,282,0,0,282,14.1
SAN DIEGO,Jun 2015,CACF,2015,CASA DE AMPARO,CHILD_BREAKFAST,22,6,1,0,7,73,12,0,85,3.8636
SAN DIEGO,Jun 2015,CACF,2015,CASA DE AMPARO,CHILD_LUNCH,22,6,1,0,7,117,20,0,137,6.2273
SAN DIEGO,Jun 2015,CACF,2015,CASA DE AMPARO,CHILD_SNACK_PM,22,6,1,0,7,77,13,0,90,4.0909
SAN DIEGO,Jun 2015,CACF,2015,CASA DE AMPARO,HS_CHILD_BREAKFAST,22,21,0,0,21,273,0,0,273,12.4091
SAN DIEGO,Jun 2015,CACF,2015,CASA DE AMPARO,HS_CHILD_LUNCH,22,21,0,0,21,370,0,0,370,16.8182
SAN DIEGO,Jun 2015,CACF,2015,CASA DE AMPARO,HS_CHILD_SNACK_PM,22,21,0,0,21,267,0,0,267,12.1364
SAN DIEGO,Jul 2015,CACF,2015,CASA DE AMPARO,CHILD_BREAKFAST,22,6,1,0,7,76,13,0,89,4.0455
SAN DIEGO,Jul 2015,CACF,2015,CASA DE AMPARO,CHILD_LUNCH,22,6,1,0,7,98,16,0,114,5.1818
SAN DIEGO,Jul 2015,CACF,2015,CASA DE AMPARO,CHILD_SNACK_PM,22,6,1,0,7,70,12,0,82,3.7273
SAN DIEGO,Jul 2015,CACF,2015,CASA DE AMPARO,HS_CHILD_BREAKFAST,22,23,0,0,23,182,0,0,182,8.2727
SAN DIEGO,Jul 2015,CACF,2015,CASA DE AMPARO,HS_CHILD_LUNCH,22,23,0,0,23,318,0,0,318,14.4545
SAN DIEGO,Jul 2015,CACF,2015,CASA DE AMPARO,HS_CHILD_SNACK_PM,22,23,0,0,23,242,0,0,242,11
SAN DIEGO,Aug 2015,CACF,2015,CASA DE AMPARO,CHILD_BREAKFAST,20,6,1,0,7,69,12,0,81,4.05
SAN DIEGO,Aug 2015,CACF,2015,CASA DE AMPARO,CHILD_LUNCH,20,6,1,0,7,95,16,0,111,5.55
SAN DIEGO,Aug 2015,CACF,2015,CASA DE AMPARO,CHILD_SNACK_PM,20,6,1,0,7,56,9,0,65,3.25
SAN DIEGO,Aug 2015,CACF,2015,CASA DE AMPARO,HS_CHILD_BREAKFAST,20,26,0,0,26,169,0,0,169,8.45
SAN DIEGO,Aug 2015,CACF,2015,CASA DE AMPARO,HS_CHILD_LUNCH,20,26,0,0,26,236,0,0,236,11.8
SAN DIEGO,Aug 2015,CACF,2015,CASA DE AMPARO,HS_CHILD_SNACK_PM,20,26,0,0,26,158,0,0,158,7.9
SAN DIEGO,Sep 2015,CACF,2015,CASA DE AMPARO,HS_CHILD_BREAKFAST,21,27,0,0,27,349,0,0,349,16.619
SAN DIEGO,Sep 2015,CACF,2015,CASA DE AMPARO,HS_CHILD_LUNCH,21,27,0,0,27,391,0,0,391,18.619
SAN DIEGO,Sep 2015,CACF,2015,CASA DE AMPARO,HS_CHILD_SNACK_PM,21,27,0,0,27,239,0,0,239,11.381
SAN DIEGO,Jan 2015,CACF,2015,CENTRO DE SALUD DE LA,ADULT_BREAKFAST,21,189,0,2,191,1961,0,21,1982,94.381
SAN DIEGO,Jan 2015,CACF,2015,CENTRO DE SALUD DE LA,ADULT_LUNCH,21,189,0,2,191,2203,0,23,2226,106
SAN DIEGO,Feb 2015,CACF,2015,CENTRO DE SALUD DE LA,ADULT_BREAKFAST,20,189,0,2,191,1969,0,21,1990,99.5
SAN DIEGO,Feb 2015,CACF,2015,CENTRO DE SALUD DE LA,ADULT_LUNCH,20,189,0,2,191,2178,0,23,2201,110.05
SAN DIEGO,Mar 2015,CACF,2015,CENTRO DE SALUD DE LA,ADULT_BREAKFAST,22,189,0,2,191,2383,0,25,2408,109.4545
SAN DIEGO,Mar 2015,CACF,2015,CENTRO DE SALUD DE LA,ADULT_LUNCH,22,189,0,2,191,2545,0,27,2572,116.9091
SAN DIEGO,Apr 2015,CACF,2015,CENTRO DE SALUD DE LA,ADULT_BREAKFAST,22,189,0,2,191,2473,0,26,2499,113.5909
SAN DIEGO,Apr 2015,CACF,2015,CENTRO DE SALUD DE LA,ADULT_LUNCH,22,189,0,2,191,2635,0,28,2663,121.0455
SAN DIEGO,May 2015,CACF,2015,CENTRO DE SALUD DE LA,ADULT_BREAKFAST,20,189,0,2,191,2226,0,24,2250,112.5
SAN DIEGO,May 2015,CACF,2015,CENTRO DE SALUD DE LA,ADULT_LUNCH,20,189,0,2,191,2326,0,25,2351,117.55
SAN DIEGO,Jun 2015,CACF,2015,CENTRO DE SALUD DE LA,ADULT_BREAKFAST,22,189,0,2,191,2536,0,27,2563,116.5
SAN DIEGO,Jun 2015,CACF,2015,CENTRO DE SALUD DE LA,ADULT_LUNCH,22,189,0,2,191,2632,0,28,2660,120.9091
SAN DIEGO,Jul 2015,CACF,2015,CENTRO DE SALUD DE LA,ADULT_BREAKFAST,23,189,0,2,191,2680,0,28,2708,117.7391
SAN DIEGO,Jul 2015,CACF,2015,CENTRO DE SALUD DE LA,ADULT_LUNCH,23,189,0,2,191,2777,0,29,2806,122
SAN DIEGO,Aug 2015,CACF,2015,CENTRO DE SALUD DE LA,ADULT_BREAKFAST,21,189,0,2,191,2520,0,27,2547,121.2857
SAN DIEGO,Aug 2015,CACF,2015,CENTRO DE SALUD DE LA,ADULT_LUNCH,21,189,0,2,191,2572,0,27,2599,123.7619
SAN DIEGO,Sep 2015,CACF,2015,CENTRO DE SALUD DE LA,ADULT_BREAKFAST,21,189,0,2,191,2612,0,28,2640,125.7143
SAN DIEGO,Sep 2015,CACF,2015,CENTRO DE SALUD DE LA,ADULT_LUNCH,21,189,0,2,191,2645,0,28,2673,127.2857
SAN DIEGO,Oct 2014,DCH,2015,CHICANO FEDERATION OF SAN DIEGO COUNTY INC,DCH_BREAKFAST,31,0,0,0,0,62120,0,0,62120,2003.871
SAN DIEGO,Oct 2014,DCH,2015,CHICANO FEDERATION OF SAN DIEGO COUNTY INC,DCH_BREAKFAST,,0,0,0,0,0,666,1255,1921,0
SAN DIEGO,Oct 2014,DCH,2015,CHICANO FEDERATION OF SAN DIEGO COUNTY INC,DCH_BREAKFAST,25,0,0,0,0,0,0,0,0,0
SAN DIEGO,Oct 2014,DCH,2015,CHICANO FEDERATION OF SAN DIEGO COUNTY INC,DCH_BREAKFAST,25,0,0,0,0,0,0,0,0,0
SAN DIEGO,Oct 2014,DCH,2015,CHICANO FEDERATION OF SAN DIEGO COUNTY INC,DCH_BREAKFAST,23,0,0,0,0,0,0,0,0,0
SAN DIEGO,Oct 2014,DCH,2015,CHICANO FEDERATION OF SAN DIEGO COUNTY INC,DCH_LUNCH,31,0,0,0,0,83502,0,0,83502,2693.6129
SAN DIEGO,Oct 2014,DCH,2015,CHICANO FEDERATION OF SAN DIEGO COUNTY INC,DCH_LUNCH,,0,0,0,0,0,935,2583,3518,0
SAN DIEGO,Oct 2014,DCH,2015,CHICANO FEDERATION OF SAN DIEGO COUNTY INC,DCH_LUNCH,25,0,0,0,0,0,0,0,0,0
SAN DIEGO,Oct 2014,DCH,2015,CHICANO FEDERATION OF SAN DIEGO COUNTY INC,DCH_LUNCH,25,0,0,0,0,0,0,0,0,0
SAN DIEGO,Oct 2014,DCH,2015,CHICANO FEDERATION OF SAN DIEGO COUNTY INC,DCH_LUNCH,23,0,0,0,0,0,0,0,0,0
SAN DIEGO,Oct 2014,DCH,2015,CHICANO FEDERATION OF SAN DIEGO COUNTY INC,DCH_SNACK_AM,31,0,0,0,0,37512,0,0,37512,1210.0645
SAN DIEGO,Oct 2014,DCH,2015,CHICANO FEDERATION OF SAN DIEGO COUNTY INC,DCH_SNACK_AM,,0,0,0,0,0,431,1009,1440,0
SAN DIEGO,Oct 2014,DCH,2015,CHICANO FEDERATION OF SAN DIEGO COUNTY INC,DCH_SNACK_AM,25,0,0,0,0,0,0,0,0,0
SAN DIEGO,Oct 2014,DCH,2015,CHICANO FEDERATION OF SAN DIEGO COUNTY INC,DCH_SNACK_AM,25,0,0,0,0,0,0,0,0,0
SAN DIEGO,Oct 2014,DCH,2015,CHICANO FEDERATION OF SAN DIEGO COUNTY INC,DCH_SNACK_AM,23,0,0,0,0,0,0,0,0,0
SAN DIEGO,Oct 2014,DCH,2015,CHICANO FEDERATION OF SAN DIEGO COUNTY INC,DCH_SNACK_NT,31,0,0,0,0,12529,0,0,12529,404.1613
SAN DIEGO,Oct 2014,DCH,2015,CHICANO FEDERATION OF SAN DIEGO COUNTY INC,DCH_SNACK_NT,,0,0,0,0,0,74,49,123,0
SAN DIEGO,Oct 2014,DCH,2015,CHICANO FEDERATION OF SAN DIEGO COUNTY INC,DCH_SNACK_NT,25,0,0,0,0,0,0,0,0,0
SAN DIEGO,Oct 2014,DCH,2015,CHICANO FEDERATION OF SAN DIEGO COUNTY INC,DCH_SNACK_NT,25,0,0,0,0,0,0,0,0,0
SAN DIEGO,Oct 2014,DCH,2015,CHICANO FEDERATION OF SAN DIEGO COUNTY INC,DCH_SNACK_NT,23,0,0,0,0,0,0,0,0,0
SAN DIEGO,Oct 2014,DCH,2015,CHICANO FEDERATION OF SAN DIEGO COUNTY INC,DCH_SNACK_PM,31,0,0,0,0,81097,0,0,81097,2616.0323
SAN DIEGO,Oct 2014,DCH,2015,CHICANO FEDERATION OF SAN DIEGO COUNTY INC,DCH_SNACK_PM,,0,0,0,0,0,748,1979,2727,0
SAN DIEGO,Oct 2014,DCH,2015,CHICANO FEDERATION OF SAN DIEGO COUNTY INC,DCH_SNACK_PM,25,0,0,0,0,0,0,0,0,0
SAN DIEGO,Oct 2014,DCH,2015,CHICANO FEDERATION OF SAN DIEGO COUNTY INC,DCH_SNACK_PM,25,0,0,0,0,0,0,0,0,0
SAN DIEGO,Oct 2014,DCH,2015,CHICANO FEDERATION OF SAN DIEGO COUNTY INC,DCH_SNACK_PM,23,0,0,0,0,0,0,0,0,0
SAN DIEGO,Oct 2014,DCH,2015,CHICANO FEDERATION OF SAN DIEGO COUNTY INC,DCH_SUPPER,31,0,0,0,0,98520,0,0,98520,3178.0645
SAN DIEGO,Oct 2014,DCH,2015,CHICANO FEDERATION OF SAN DIEGO COUNTY INC,DCH_SUPPER,,0,0,0,0,0,1083,1706,2789,0
SAN DIEGO,Oct 2014,DCH,2015,CHICANO FEDERATION OF SAN DIEGO COUNTY INC,DCH_SUPPER,25,0,0,0,0,0,0,0,0,0
SAN DIEGO,Oct 2014,DCH,2015,CHICANO FEDERATION OF SAN DIEGO COUNTY INC,DCH_SUPPER,25,0,0,0,0,0,0,0,0,0
SAN DIEGO,Oct 2014,DCH,2015,CHICANO FEDERATION OF SAN DIEGO COUNTY INC,DCH_SUPPER,23,0,0,0,0,0,0,0,0,0
SAN DIEGO,Nov 2014,DCH,2015,CHICANO FEDERATION OF SAN DIEGO COUNTY INC,DCH_BREAKFAST,28,0,0,0,0,45437,0,0,45437,1622.75
SAN DIEGO,Nov 2014,DCH,2015,CHICANO FEDERATION OF SAN DIEGO COUNTY INC,DCH_BREAKFAST,,0,0,0,0,0,549,960,1509,0
SAN DIEGO,Nov 2014,DCH,2015,CHICANO FEDERATION OF SAN DIEGO COUNTY INC,DCH_BREAKFAST,20,0,0,0,0,0,0,0,0,0
SAN DIEGO,Nov 2014,DCH,2015,CHICANO FEDERATION OF SAN DIEGO COUNTY INC,DCH_BREAKFAST,18,0,0,0,0,0,0,0,0,0
SAN DIEGO,Nov 2014,DCH,2015,CHICANO FEDERATION OF SAN DIEGO COUNTY INC,DCH_BREAKFAST,18,0,0,0,0,0,0,0,0,0
SAN DIEGO,Nov 2014,DCH,2015,CHICANO FEDERATION OF SAN DIEGO COUNTY INC,DCH_LUNCH,28,0,0,0,0,70226,0,0,70226,2508.0714
SAN DIEGO,Nov 2014,DCH,2015,CHICANO FEDERATION OF SAN DIEGO COUNTY INC,DCH_LUNCH,,0,0,0,0,0,809,2014,2823,0
SAN DIEGO,Nov 2014,DCH,2015,CHICANO FEDERATION OF SAN DIEGO COUNTY INC,DCH_LUNCH,20,0,0,0,0,0,0,0,0,0
SAN DIEGO,Nov 2014,DCH,2015,CHICANO FEDERATION OF SAN DIEGO COUNTY INC,DCH_LUNCH,18,0,0,0,0,0,0,0,0,0
SAN DIEGO,Nov 2014,DCH,2015,CHICANO FEDERATION OF SAN DIEGO COUNTY INC,DCH_LUNCH,18,0,0,0,0,0,0,0,0,0
SAN DIEGO,Nov 2014,DCH,2015,CHICANO FEDERATION OF SAN DIEGO COUNTY INC,DCH_SNACK_AM,28,0,0,0,0,30909,0,0,30909,1103.8929
SAN DIEGO,Nov 2014,DCH,2015,CHICANO FEDERATION OF SAN DIEGO COUNTY INC,DCH_SNACK_AM,,0,0,0,0,0,382,785,1167,0
SAN DIEGO,Nov 2014,DCH,2015,CHICANO FEDERATION OF SAN DIEGO COUNTY INC,DCH_SNACK_AM,20,0,0,0,0,0,0,0,0,0
SAN DIEGO,Nov 2014,DCH,2015,CHICANO FEDERATION OF SAN DIEGO COUNTY INC,DCH_SNACK_AM,18,0,0,0,0,0,0,0,0,0
SAN DIEGO,Nov 2014,DCH,2015,CHICANO FEDERATION OF SAN DIEGO COUNTY INC,DCH_SNACK_AM,18,0,0,0,0,0,0,0,0,0
SAN DIEGO,Nov 2014,DCH,2015,CHICANO FEDERATION OF SAN DIEGO COUNTY INC,DCH_SNACK_NT,28,0,0,0,0,9075,0,0,9075,324.1071
SAN DIEGO,Nov 2014,DCH,2015,CHICANO FEDERATION OF SAN DIEGO COUNTY INC,DCH_SNACK_NT,,0,0,0,0,0,43,32,75,0
SAN DIEGO,Nov 2014,DCH,2015,CHICANO FEDERATION OF SAN DIEGO COUNTY INC,DCH_SNACK_NT,20,0,0,0,0,0,0,0,0,0
SAN DIEGO,Nov 2014,DCH,2015,CHICANO FEDERATION OF SAN DIEGO COUNTY INC,DCH_SNACK_NT,18,0,0,0,0,0,0,0,0,0
SAN DIEGO,Nov 2014,DCH,2015,CHICANO FEDERATION OF SAN DIEGO COUNTY INC,DCH_SNACK_NT,18,0,0,0,0,0,0,0,0,0
SAN DIEGO,Nov 2014,DCH,2015,CHICANO FEDERATION OF SAN DIEGO COUNTY INC,DCH_SNACK_PM,28,0,0,0,0,63700,0,0,63700,2275
SAN DIEGO,Nov 2014,DCH,2015,CHICANO FEDERATION OF SAN DIEGO COUNTY INC,DCH_SNACK_PM,,0,0,0,0,0,679,1462,2141,0
SAN DIEGO,Nov 2014,DCH,2015,CHICANO FEDERATION OF SAN DIEGO COUNTY INC,DCH_SNACK_PM,20,0,0,0,0,0,0,0,0,0
SAN DIEGO,Nov 2014,DCH,2015,CHICANO FEDERATION OF SAN DIEGO COUNTY INC,DCH_SNACK_PM,18,0,0,0,0,0,0,0,0,0
SAN DIEGO,Nov 2014,DCH,2015,CHICANO FEDERATION OF SAN DIEGO COUNTY INC,DCH_SNACK_PM,18,0,0,0,0,0,0,0,0,0
SAN DIEGO,Nov 2014,DCH,2015,CHICANO FEDERATION OF SAN DIEGO COUNTY INC,DCH_SUPPER,28,0,0,0,0,76990,0,0,76990,2749.6429
SAN DIEGO,Nov 2014,DCH,2015,CHICANO FEDERATION OF SAN DIEGO COUNTY INC,DCH_SUPPER,,0,0,0,0,0,927,1278,2205,0
SAN DIEGO,Nov 2014,DCH,2015,CHICANO FEDERATION OF SAN DIEGO COUNTY INC,DCH_SUPPER,20,0,0,0,0,0,0,0,0,0
SAN DIEGO,Nov 2014,DCH,2015,CHICANO FEDERATION OF SAN DIEGO COUNTY INC,DCH_SUPPER,18,0,0,0,0,0,0,0,0,0
SAN DIEGO,Nov 2014,DCH,2015,CHICANO FEDERATION OF SAN DIEGO COUNTY INC,DCH_SUPPER,18,0,0,0,0,0,0,0,0,0
SAN DIEGO,Dec 2014,DCH,2015,CHICANO FEDERATION OF SAN DIEGO COUNTY INC,DCH_BREAKFAST,30,0,0,0,0,52598,0,0,52598,1753.2667
SAN DIEGO,Dec 2014,DCH,2015,CHICANO FEDERATION OF SAN DIEGO COUNTY INC,DCH_BREAKFAST,,0,0,0,0,0,600,970,1570,0
SAN DIEGO,Dec 2014,DCH,2015,CHICANO FEDERATION OF SAN DIEGO COUNTY INC,DCH_BREAKFAST,24,0,0,0,0,0,0,0,0,0
SAN DIEGO,Dec 2014,DCH,2015,CHICANO FEDERATION OF SAN DIEGO COUNTY INC,DCH_BREAKFAST,22,0,0,0,0,0,0,0,0,0
SAN DIEGO,Dec 2014,DCH,2015,CHICANO FEDERATION OF SAN DIEGO COUNTY INC,DCH_BREAKFAST,26,0,0,0,0,0,0,0,0,0
SAN DIEGO,Dec 2014,DCH,2015,CHICANO FEDERATION OF SAN DIEGO COUNTY INC,DCH_LUNCH,30,0,0,0,0,83567,0,0,83567,2785.5667
SAN DIEGO,Dec 2014,DCH,2015,CHICANO FEDERATION OF SAN DIEGO COUNTY INC,DCH_LUNCH,,0,0,0,0,0,1056,2646,3702,0
SAN DIEGO,Dec 2014,DCH,2015,CHICANO FEDERATION OF SAN DIEGO COUNTY INC,DCH_LUNCH,24,0,0,0,0,0,0,0,0,0
SAN DIEGO,Dec 2014,DCH,2015,CHICANO FEDERATION OF SAN DIEGO COUNTY INC,DCH_LUNCH,22,0,0,0,0,0,0,0,0,0
SAN DIEGO,Dec 2014,DCH,2015,CHICANO FEDERATION OF SAN DIEGO COUNTY INC,DCH_LUNCH,26,0,0,0,0,0,0,0,0,0
SAN DIEGO,Dec 2014,DCH,2015,CHICANO FEDERATION OF SAN DIEGO COUNTY INC,DCH_SNACK_AM,30,0,0,0,0,37126,0,0,37126,1237.5333
SAN DIEGO,Dec 2014,DCH,2015,CHICANO FEDERATION OF SAN DIEGO COUNTY INC,DCH_SNACK_AM,,0,0,0,0,0,484,1031,1515,0
SAN DIEGO,Dec 2014,DCH,2015,CHICANO FEDERATION OF SAN DIEGO COUNTY INC,DCH_SNACK_AM,24,0,0,0,0,0,0,0,0,0
SAN DIEGO,Dec 2014,DCH,2015,CHICANO FEDERATION OF SAN DIEGO COUNTY INC,DCH_SNACK_AM,22,0,0,0,0,0,0,0,0,0
SAN DIEGO,Dec 2014,DCH,2015,CHICANO FEDERATION OF SAN DIEGO COUNTY INC,DCH_SNACK_AM,26,0,0,0,0,0,0,0,0,0
SAN DIEGO,Dec 2014,DCH,2015,CHICANO FEDERATION OF SAN DIEGO COUNTY INC,DCH_SNACK_NT,30,0,0,0,0,9990,0,0,9990,333
SAN DIEGO,Dec 2014,DCH,2015,CHICANO FEDERATION OF SAN DIEGO COUNTY INC,DCH_SNACK_NT,,0,0,0,0,0,43,4,47,0
SAN DIEGO,Dec 2014,DCH,2015,CHICANO FEDERATION OF SAN DIEGO COUNTY INC,DCH_SNACK_NT,24,0,0,0,0,0,0,0,0,0
SAN DIEGO,Dec 2014,DCH,2015,CHICANO FEDERATION OF SAN DIEGO COUNTY INC,DCH_SNACK_NT,22,0,0,0,0,0,0,0,0,0
SAN DIEGO,Dec 2014,DCH,2015,CHICANO FEDERATION OF SAN DIEGO COUNTY INC,DCH_SNACK_NT,26,0,0,0,0,0,0,0,0,0
SAN DIEGO,Dec 2014,DCH,2015,CHICANO FEDERATION OF SAN DIEGO COUNTY INC,DCH_SNACK_PM,30,0,0,0,0,73796,0,0,73796,2459.8667
SAN DIEGO,Dec 2014,DCH,2015,CHICANO FEDERATION OF SAN DIEGO COUNTY INC,DCH_SNACK_PM,,0,0,0,0,0,769,1846,2615,0
SAN DIEGO,Dec 2014,DCH,2015,CHICANO FEDERATION OF SAN DIEGO COUNTY INC,DCH_SNACK_PM,24,0,0,0,0,0,0,0,0,0
SAN DIEGO,Dec 2014,DCH,2015,CHICANO FEDERATION OF SAN DIEGO COUNTY INC,DCH_SNACK_PM,22,0,0,0,0,0,0,0,0,0
SAN DIEGO,Dec 2014,DCH,2015,CHICANO FEDERATION OF SAN DIEGO COUNTY INC,DCH_SNACK_PM,26,0,0,0,0,0,0,0,0,0
SAN DIEGO,Dec 2014,DCH,2015,CHICANO FEDERATION OF SAN DIEGO COUNTY INC,DCH_SUPPER,30,0,0,0,0,88692,0,0,88692,2956.4
SAN DIEGO,Dec 2014,DCH,2015,CHICANO FEDERATION OF SAN DIEGO COUNTY INC,DCH_SUPPER,,0,0,0,0,0,1096,1903,2999,0
SAN DIEGO,Dec 2014,DCH,2015,CHICANO FEDERATION OF SAN DIEGO COUNTY INC,DCH_SUPPER,24,0,0,0,0,0,0,0,0,0
SAN DIEGO,Dec 2014,DCH,2015,CHICANO FEDERATION OF SAN DIEGO COUNTY INC,DCH_SUPPER,22,0,0,0,0,0,0,0,0,0
SAN DIEGO,Dec 2014,DCH,2015,CHICANO FEDERATION OF SAN DIEGO COUNTY INC,DCH_SUPPER,26,0,0,0,0,0,0,0,0,0
SAN DIEGO,Jan 2015,DCH,2015,CHICANO FEDERATION OF SAN DIEGO COUNTY INC,DCH_BREAKFAST,29,0,0,0,0,49794,0,0,49794,1717.0345
SAN DIEGO,Jan 2015,DCH,2015,CHICANO FEDERATION OF SAN DIEGO COUNTY INC,DCH_BREAKFAST,,0,0,0,0,0,507,1008,1515,0
SAN DIEGO,Jan 2015,DCH,2015,CHICANO FEDERATION OF SAN DIEGO COUNTY INC,DCH_BREAKFAST,23,0,0,0,0,0,0,0,0,0
SAN DIEGO,Jan 2015,DCH,2015,CHICANO FEDERATION OF SAN DIEGO COUNTY INC,DCH_BREAKFAST,25,0,0,0,0,0,0,0,0,0
SAN DIEGO,Jan 2015,DCH,2015,CHICANO FEDERATION OF SAN DIEGO COUNTY INC,DCH_BREAKFAST,25,0,0,0,0,0,0,0,0,0
SAN DIEGO,Jan 2015,DCH,2015,CHICANO FEDERATION OF SAN DIEGO COUNTY INC,DCH_LUNCH,29,0,0,0,0,80169,0,0,80169,2764.4483
SAN DIEGO,Jan 2015,DCH,2015,CHICANO FEDERATION OF SAN DIEGO COUNTY INC,DCH_LUNCH,,0,0,0,0,0,969,2715,3684,0
SAN DIEGO,Jan 2015,DCH,2015,CHICANO FEDERATION OF SAN DIEGO COUNTY INC,DCH_LUNCH,23,0,0,0,0,0,0,0,0,0
SAN DIEGO,Jan 2015,DCH,2015,CHICANO FEDERATION OF SAN DIEGO COUNTY INC,DCH_LUNCH,25,0,0,0,0,0,0,0,0,0
SAN DIEGO,Jan 2015,DCH,2015,CHICANO FEDERATION OF SAN DIEGO COUNTY INC,DCH_LUNCH,25,0,0,0,0,0,0,0,0,0
SAN DIEGO,Jan 2015,DCH,2015,CHICANO FEDERATION OF SAN DIEGO COUNTY INC,DCH_SNACK_AM,29,0,0,0,0,35319,0,0,35319,1217.8966
SAN DIEGO,Jan 2015,DCH,2015,CHICANO FEDERATION OF SAN DIEGO COUNTY INC,DCH_SNACK_AM,,0,0,0,0,0,426,1058,1484,0
SAN DIEGO,Jan 2015,DCH,2015,CHICANO FEDERATION OF SAN DIEGO COUNTY INC,DCH_SNACK_AM,23,0,0,0,0,0,0,0,0,0
SAN DIEGO,Jan 2015,DCH,2015,CHICANO FEDERATION OF SAN DIEGO COUNTY INC,DCH_SNACK_AM,25,0,0,0,0,0,0,0,0,0
SAN DIEGO,Jan 2015,DCH,2015,CHICANO FEDERATION OF SAN DIEGO COUNTY INC,DCH_SNACK_AM,25,0,0,0,0,0,0,0,0,0
SAN DIEGO,Jan 2015,DCH,2015,CHICANO FEDERATION OF SAN DIEGO COUNTY INC,DCH_SNACK_NT,29,0,0,0,0,9692,0,0,9692,334.2069
SAN DIEGO,Jan 2015,DCH,2015,CHICANO FEDERATION OF SAN DIEGO COUNTY INC,DCH_SNACK_NT,,0,0,0,0,0,56,0,56,0
SAN DIEGO,Jan 2015,DCH,2015,CHICANO FEDERATION OF SAN DIEGO COUNTY INC,DCH_SNACK_NT,23,0,0,0,0,0,0,0,0,0
SAN DIEGO,Jan 2015,DCH,2015,CHICANO FEDERATION OF SAN DIEGO COUNTY INC,DCH_SNACK_NT,25,0,0,0,0,0,0,0,0,0
SAN DIEGO,Jan 2015,DCH,2015,CHICANO FEDERATION OF SAN DIEGO COUNTY INC,DCH_SNACK_NT,25,0,0,0,0,0,0,0,0,0
SAN DIEGO,Jan 2015,DCH,2015,CHICANO FEDERATION OF SAN DIEGO COUNTY INC,DCH_SNACK_PM,29,0,0,0,0,70484,0,0,70484,2430.4828
SAN DIEGO,Jan 2015,DCH,2015,CHICANO FEDERATION OF SAN DIEGO COUNTY INC,DCH_SNACK_PM,,0,0,0,0,0,742,1881,2623,0
SAN DIEGO,Jan 2015,DCH,2015,CHICANO FEDERATION OF SAN DIEGO COUNTY INC,DCH_SNACK_PM,23,0,0,0,0,0,0,0,0,0
SAN DIEGO,Jan 2015,DCH,2015,CHICANO FEDERATION OF SAN DIEGO COUNTY INC,DCH_SNACK_PM,25,0,0,0,0,0,0,0,0,0
SAN DIEGO,Jan 2015,DCH,2015,CHICANO FEDERATION OF SAN DIEGO COUNTY INC,DCH_SNACK_PM,25,0,0,0,0,0,0,0,0,0
SAN DIEGO,Jan 2015,DCH,2015,CHICANO FEDERATION OF SAN DIEGO COUNTY INC,DCH_SUPPER,29,0,0,0,0,84283,0,0,84283,2906.3103
SAN DIEGO,Jan 2015,DCH,2015,CHICANO FEDERATION OF SAN DIEGO COUNTY INC,DCH_SUPPER,,0,0,0,0,0,1044,1935,2979,0
SAN DIEGO,Jan 2015,DCH,2015,CHICANO FEDERATION OF SAN DIEGO COUNTY INC,DCH_SUPPER,23,0,0,0,0,0,0,0,0,0
SAN DIEGO,Jan 2015,DCH,2015,CHICANO FEDERATION OF SAN DIEGO COUNTY INC,DCH_SUPPER,25,0,0,0,0,0,0,0,0,0
SAN DIEGO,Jan 2015,DCH,2015,CHICANO FEDERATION OF SAN DIEGO COUNTY INC,DCH_SUPPER,25,0,0,0,0,0,0,0,0,0
SAN DIEGO,Feb 2015,DCH,2015,CHICANO FEDERATION OF SAN DIEGO COUNTY INC,DCH_BREAKFAST,27,0,0,0,0,53009,0,0,53009,1963.2963
SAN DIEGO,Feb 2015,DCH,2015,CHICANO FEDERATION OF SAN DIEGO COUNTY INC,DCH_BREAKFAST,,0,0,0,0,0,495,1079,1574,0
SAN DIEGO,Feb 2015,DCH,2015,CHICANO FEDERATION OF SAN DIEGO COUNTY INC,DCH_BREAKFAST,21,0,0,0,0,0,0,0,0,0
SAN DIEGO,Feb 2015,DCH,2015,CHICANO FEDERATION OF SAN DIEGO COUNTY INC,DCH_BREAKFAST,23,0,0,0,0,0,0,0,0,0
SAN DIEGO,Feb 2015,DCH,2015,CHICANO FEDERATION OF SAN DIEGO COUNTY INC,DCH_BREAKFAST,23,0,0,0,0,0,0,0,0,0
SAN DIEGO,Feb 2015,DCH,2015,CHICANO FEDERATION OF SAN DIEGO COUNTY INC,DCH_LUNCH,27,0,0,0,0,71676,0,0,71676,2654.6667
SAN DIEGO,Feb 2015,DCH,2015,CHICANO FEDERATION OF SAN DIEGO COUNTY INC,DCH_LUNCH,,0,0,0,0,0,775,2741,3516,0
SAN DIEGO,Feb 2015,DCH,2015,CHICANO FEDERATION OF SAN DIEGO COUNTY INC,DCH_LUNCH,21,0,0,0,0,0,0,0,0,0
SAN DIEGO,Feb 2015,DCH,2015,CHICANO FEDERATION OF SAN DIEGO COUNTY INC,DCH_LUNCH,23,0,0,0,0,0,0,0,0,0
SAN DIEGO,Feb 2015,DCH,2015,CHICANO FEDERATION OF SAN DIEGO COUNTY INC,DCH_LUNCH,23,0,0,0,0,0,0,0,0,0
SAN DIEGO,Feb 2015,DCH,2015,CHICANO FEDERATION OF SAN DIEGO COUNTY INC,DCH_SNACK_AM,27,0,0,0,0,33500,0,0,33500,1240.7407
SAN DIEGO,Feb 2015,DCH,2015,CHICANO FEDERATION OF SAN DIEGO COUNTY INC,DCH_SNACK_AM,,0,0,0,0,0,290,1081,1371,0
SAN DIEGO,Feb 2015,DCH,2015,CHICANO FEDERATION OF SAN DIEGO COUNTY INC,DCH_SNACK_AM,21,0,0,0,0,0,0,0,0,0
SAN DIEGO,Feb 2015,DCH,2015,CHICANO FEDERATION OF SAN DIEGO COUNTY INC,DCH_SNACK_AM,23,0,0,0,0,0,0,0,0,0
SAN DIEGO,Feb 2015,DCH,2015,CHICANO FEDERATION OF SAN DIEGO COUNTY INC,DCH_SNACK_AM,23,0,0,0,0,0,0,0,0,0
SAN DIEGO,Feb 2015,DCH,2015,CHICANO FEDERATION OF SAN DIEGO COUNTY INC,DCH_SNACK_NT,27,0,0,0,0,9533,0,0,9533,353.0741
SAN DIEGO,Feb 2015,DCH,2015,CHICANO FEDERATION OF SAN DIEGO COUNTY INC,DCH_SNACK_NT,,0,0,0,0,0,15,1,16,0
SAN DIEGO,Feb 2015,DCH,2015,CHICANO FEDERATION OF SAN DIEGO COUNTY INC,DCH_SNACK_NT,21,0,0,0,0,0,0,0,0,0
SAN DIEGO,Feb 2015,DCH,2015,CHICANO FEDERATION OF SAN DIEGO COUNTY INC,DCH_SNACK_NT,23,0,0,0,0,0,0,0,0,0
SAN DIEGO,Feb 2015,DCH,2015,CHICANO FEDERATION OF SAN DIEGO COUNTY INC,DCH_SNACK_NT,23,0,0,0,0,0,0,0,0,0
SAN DIEGO,Feb 2015,DCH,2015,CHICANO FEDERATION OF SAN DIEGO COUNTY INC,DCH_SNACK_PM,27,0,0,0,0,66520,0,0,66520,2463.7037
SAN DIEGO,Feb 2015,DCH,2015,CHICANO FEDERATION OF SAN DIEGO COUNTY INC,DCH_SNACK_PM,,0,0,0,0,0,698,2010,2708,0
SAN DIEGO,Feb 2015,DCH,2015,CHICANO FEDERATION OF SAN DIEGO COUNTY INC,DCH_SNACK_PM,21,0,0,0,0,0,0,0,0,0
SAN DIEGO,Feb 2015,DCH,2015,CHICANO FEDERATION OF SAN DIEGO COUNTY INC,DCH_SNACK_PM,23,0,0,0,0,0,0,0,0,0
SAN DIEGO,Feb 2015,DCH,2015,CHICANO FEDERATION OF SAN DIEGO COUNTY INC,DCH_SNACK_PM,23,0,0,0,0,0,0,0,0,0
SAN DIEGO,Feb 2015,DCH,2015,CHICANO FEDERATION OF SAN DIEGO COUNTY INC,DCH_SUPPER,27,0,0,0,0,81349,0,0,81349,3012.9259
SAN DIEGO,Feb 2015,DCH,2015,CHICANO FEDERATION OF SAN DIEGO COUNTY INC,DCH_SUPPER,,0,0,0,0,0,999,1994,2993,0
SAN DIEGO,Feb 2015,DCH,2015,CHICANO FEDERATION OF SAN DIEGO COUNTY INC,DCH_SUPPER,21,0,0,0,0,0,0,0,0,0
SAN DIEGO,Feb 2015,DCH,2015,CHICANO FEDERATION OF SAN DIEGO COUNTY INC,DCH_SUPPER,23,0,0,0,0,0,0,0,0,0
SAN DIEGO,Feb 2015,DCH,2015,CHICANO FEDERATION OF SAN DIEGO COUNTY INC,DCH_SUPPER,23,0,0,0,0,0,0,0,0,0
SAN DIEGO,Mar 2015,DCH,2015,CHICANO FEDERATION OF SAN DIEGO COUNTY INC,DCH_BREAKFAST,31,0,0,0,0,57618,0,0,57618,1858.6452
SAN DIEGO,Mar 2015,DCH,2015,CHICANO FEDERATION OF SAN DIEGO COUNTY INC,DCH_BREAKFAST,,0,0,0,0,0,474,1311,1785,0
SAN DIEGO,Mar 2015,DCH,2015,CHICANO FEDERATION OF SAN DIEGO COUNTY INC,DCH_BREAKFAST,24,0,0,0,0,0,0,0,0,0
SAN DIEGO,Mar 2015,DCH,2015,CHICANO FEDERATION OF SAN DIEGO COUNTY INC,DCH_BREAKFAST,26,0,0,0,0,0,0,0,0,0
SAN DIEGO,Mar 2015,DCH,2015,CHICANO FEDERATION OF SAN DIEGO COUNTY INC,DCH_BREAKFAST,26,0,0,0,0,0,0,0,0,0
SAN DIEGO,Mar 2015,DCH,2015,CHICANO FEDERATION OF SAN DIEGO COUNTY INC,DCH_LUNCH,31,0,0,0,0,88420,0,0,88420,2852.2581
SAN DIEGO,Mar 2015,DCH,2015,CHICANO FEDERATION OF SAN DIEGO COUNTY INC,DCH_LUNCH,,0,0,0,0,0,896,3398,4294,0
SAN DIEGO,Mar 2015,DCH,2015,CHICANO FEDERATION OF SAN DIEGO COUNTY INC,DCH_LUNCH,24,0,0,0,0,0,0,0,0,0
SAN DIEGO,Mar 2015,DCH,2015,CHICANO FEDERATION OF SAN DIEGO COUNTY INC,DCH_LUNCH,26,0,0,0,0,0,0,0,0,0
SAN DIEGO,Mar 2015,DCH,2015,CHICANO FEDERATION OF SAN DIEGO COUNTY INC,DCH_LUNCH,26,0,0,0,0,0,0,0,0,0
SAN DIEGO,Mar 2015,DCH,2015,CHICANO FEDERATION OF SAN DIEGO COUNTY INC,DCH_SNACK_AM,31,0,0,0,0,40450,0,0,40450,1304.8387
SAN DIEGO,Mar 2015,DCH,2015,CHICANO FEDERATION OF SAN DIEGO COUNTY INC,DCH_SNACK_AM,,0,0,0,0,0,326,1352,1678,0
SAN DIEGO,Mar 2015,DCH,2015,CHICANO FEDERATION OF SAN DIEGO COUNTY INC,DCH_SNACK_AM,24,0,0,0,0,0,0,0,0,0
SAN DIEGO,Mar 2015,DCH,2015,CHICANO FEDERATION OF SAN DIEGO COUNTY INC,DCH_SNACK_AM,26,0,0,0,0,0,0,0,0,0
SAN DIEGO,Mar 2015,DCH,2015,CHICANO FEDERATION OF SAN DIEGO COUNTY INC,DCH_SNACK_AM,26,0,0,0,0,0,0,0,0,0
SAN DIEGO,Mar 2015,DCH,2015,CHICANO FEDERATION OF SAN DIEGO COUNTY INC,DCH_SNACK_NT,31,0,0,0,0,10476,0,0,10476,337.9355
SAN DIEGO,Mar 2015,DCH,2015,CHICANO FEDERATION OF SAN DIEGO COUNTY INC,DCH_SNACK_NT,,0,0,0,0,0,17,1,18,0
SAN DIEGO,Mar 2015,DCH,2015,CHICANO FEDERATION OF SAN DIEGO COUNTY INC,DCH_SNACK_NT,24,0,0,0,0,0,0,0,0,0
SAN DIEGO,Mar 2015,DCH,2015,CHICANO FEDERATION OF SAN DIEGO COUNTY INC,DCH_SNACK_NT,26,0,0,0,0,0,0,0,0,0
SAN DIEGO,Mar 2015,DCH,2015,CHICANO FEDERATION OF SAN DIEGO COUNTY INC,DCH_SNACK_NT,26,0,0,0,0,0,0,0,0,0
SAN DIEGO,Mar 2015,DCH,2015,CHICANO FEDERATION OF SAN DIEGO COUNTY INC,DCH_SNACK_PM,31,0,0,0,0,77958,0,0,77958,2514.7742
SAN DIEGO,Mar 2015,DCH,2015,CHICANO FEDERATION OF SAN DIEGO COUNTY INC,DCH_SNACK_PM,,0,0,0,0,0,801,2307,3108,0
SAN DIEGO,Mar 2015,DCH,2015,CHICANO FEDERATION OF SAN DIEGO COUNTY INC,DCH_SNACK_PM,24,0,0,0,0,0,0,0,0,0
SAN DIEGO,Mar 2015,DCH,2015,CHICANO FEDERATION OF SAN DIEGO COUNTY INC,DCH_SNACK_PM,26,0,0,0,0,0,0,0,0,0
SAN DIEGO,Mar 2015,DCH,2015,CHICANO FEDERATION OF SAN DIEGO COUNTY INC,DCH_SNACK_PM,26,0,0,0,0,0,0,0,0,0
SAN DIEGO,Mar 2015,DCH,2015,CHICANO FEDERATION OF SAN DIEGO COUNTY INC,DCH_SUPPER,31,0,0,0,0,92600,0,0,92600,2987.0968
SAN DIEGO,Mar 2015,DCH,2015,CHICANO FEDERATION OF SAN DIEGO COUNTY INC,DCH_SUPPER,,0,0,0,0,0,1138,2389,3527,0
SAN DIEGO,Mar 2015,DCH,2015,CHICANO FEDERATION OF SAN DIEGO COUNTY INC,DCH_SUPPER,24,0,0,0,0,0,0,0,0,0
SAN DIEGO,Mar 2015,DCH,2015,CHICANO FEDERATION OF SAN DIEGO COUNTY INC,DCH_SUPPER,26,0,0,0,0,0,0,0,0,0
SAN DIEGO,Mar 2015,DCH,2015,CHICANO FEDERATION OF SAN DIEGO COUNTY INC,DCH_SUPPER,26,0,0,0,0,0,0,0,0,0
SAN DIEGO,Apr 2015,DCH,2015,CHICANO FEDERATION OF SAN DIEGO COUNTY INC,DCH_BREAKFAST,30,0,0,0,0,57804,0,0,57804,1926.8
SAN DIEGO,Apr 2015,DCH,2015,CHICANO FEDERATION OF SAN DIEGO COUNTY INC,DCH_BREAKFAST,,0,0,0,0,0,486,1199,1685,0
SAN DIEGO,Apr 2015,DCH,2015,CHICANO FEDERATION OF SAN DIEGO COUNTY INC,DCH_BREAKFAST,22,0,0,0,0,0,0,0,0,0
SAN DIEGO,Apr 2015,DCH,2015,CHICANO FEDERATION OF SAN DIEGO COUNTY INC,DCH_BREAKFAST,26,0,0,0,0,0,0,0,0,0
SAN DIEGO,Apr 2015,DCH,2015,CHICANO FEDERATION OF SAN DIEGO COUNTY INC,DCH_BREAKFAST,26,0,0,0,0,0,0,0,0,0
SAN DIEGO,Apr 2015,DCH,2015,CHICANO FEDERATION OF SAN DIEGO COUNTY INC,DCH_LUNCH,30,0,0,0,0,92322,0,0,92322,3077.4
SAN DIEGO,Apr 2015,DCH,2015,CHICANO FEDERATION OF SAN DIEGO COUNTY INC,DCH_LUNCH,,0,0,0,0,0,872,3371,4243,0
SAN DIEGO,Apr 2015,DCH,2015,CHICANO FEDERATION OF SAN DIEGO COUNTY INC,DCH_LUNCH,22,0,0,0,0,0,0,0,0,0
SAN DIEGO,Apr 2015,DCH,2015,CHICANO FEDERATION OF SAN DIEGO COUNTY INC,DCH_LUNCH,26,0,0,0,0,0,0,0,0,0
SAN DIEGO,Apr 2015,DCH,2015,CHICANO FEDERATION OF SAN DIEGO COUNTY INC,DCH_LUNCH,26,0,0,0,0,0,0,0,0,0
SAN DIEGO,Apr 2015,DCH,2015,CHICANO FEDERATION OF SAN DIEGO COUNTY INC,DCH_SNACK_AM,30,0,0,0,0,42203,0,0,42203,1406.7667
SAN DIEGO,Apr 2015,DCH,2015,CHICANO FEDERATION OF SAN DIEGO COUNTY INC,DCH_SNACK_AM,,0,0,0,0,0,296,1384,1680,0
SAN DIEGO,Apr 2015,DCH,2015,CHICANO FEDERATION OF SAN DIEGO COUNTY INC,DCH_SNACK_AM,22,0,0,0,0,0,0,0,0,0
SAN DIEGO,Apr 2015,DCH,2015,CHICANO FEDERATION OF SAN DIEGO COUNTY INC,DCH_SNACK_AM,26,0,0,0,0,0,0,0,0,0
SAN DIEGO,Apr 2015,DCH,2015,CHICANO FEDERATION OF SAN DIEGO COUNTY INC,DCH_SNACK_AM,26,0,0,0,0,0,0,0,0,0
SAN DIEGO,Apr 2015,DCH,2015,CHICANO FEDERATION OF SAN DIEGO COUNTY INC,DCH_SNACK_NT,30,0,0,0,0,9959,0,0,9959,331.9667
SAN DIEGO,Apr 2015,DCH,2015,CHICANO FEDERATION OF SAN DIEGO COUNTY INC,DCH_SNACK_NT,,0,0,0,0,0,6,6,12,0
SAN DIEGO,Apr 2015,DCH,2015,CHICANO FEDERATION OF SAN DIEGO COUNTY INC,DCH_SNACK_NT,22,0,0,0,0,0,0,0,0,0
SAN DIEGO,Apr 2015,DCH,2015,CHICANO FEDERATION OF SAN DIEGO COUNTY INC,DCH_SNACK_NT,26,0,0,0,0,0,0,0,0,0
SAN DIEGO,Apr 2015,DCH,2015,CHICANO FEDERATION OF SAN DIEGO COUNTY INC,DCH_SNACK_NT,26,0,0,0,0,0,0,0,0,0
SAN DIEGO,Apr 2015,DCH,2015,CHICANO FEDERATION OF SAN DIEGO COUNTY INC,DCH_SNACK_PM,30,0,0,0,0,77898,0,0,77898,2596.6
SAN DIEGO,Apr 2015,DCH,2015,CHICANO FEDERATION OF SAN DIEGO COUNTY INC,DCH_SNACK_PM,,0,0,0,0,0,819,2253,3072,0
SAN DIEGO,Apr 2015,DCH,2015,CHICANO FEDERATION OF SAN DIEGO COUNTY INC,DCH_SNACK_PM,22,0,0,0,0,0,0,0,0,0
SAN DIEGO,Apr 2015,DCH,2015,CHICANO FEDERATION OF SAN DIEGO COUNTY INC,DCH_SNACK_PM,26,0,0,0,0,0,0,0,0,0
SAN DIEGO,Apr 2015,DCH,2015,CHICANO FEDERATION OF SAN DIEGO COUNTY INC,DCH_SNACK_PM,26,0,0,0,0,0,0,0,0,0
SAN DIEGO,Apr 2015,DCH,2015,CHICANO FEDERATION OF SAN DIEGO COUNTY INC,DCH_SUPPER,30,0,0,0,0,92879,0,0,92879,3095.9667
SAN DIEGO,Apr 2015,DCH,2015,CHICANO FEDERATION OF SAN DIEGO COUNTY INC,DCH_SUPPER,,0,0,0,0,0,1132,2516,3648,0
SAN DIEGO,Apr 2015,DCH,2015,CHICANO FEDERATION OF SAN DIEGO COUNTY INC,DCH_SUPPER,22,0,0,0,0,0,0,0,0,0
SAN DIEGO,Apr 2015,DCH,2015,CHICANO FEDERATION OF SAN DIEGO COUNTY INC,DCH_SUPPER,26,0,0,0,0,0,0,0,0,0
SAN DIEGO,Apr 2015,DCH,2015,CHICANO FEDERATION OF SAN DIEGO COUNTY INC,DCH_SUPPER,26,0,0,0,0,0,0,0,0,0
SAN DIEGO,May 2015,DCH,2015,CHICANO FEDERATION OF SAN DIEGO COUNTY INC,DCH_BREAKFAST,30,0,0,0,0,58261,0,0,58261,1942.0333
SAN DIEGO,May 2015,DCH,2015,CHICANO FEDERATION OF SAN DIEGO COUNTY INC,DCH_BREAKFAST,,0,0,0,0,0,587,1079,1666,0
SAN DIEGO,May 2015,DCH,2015,CHICANO FEDERATION OF SAN DIEGO COUNTY INC,DCH_BREAKFAST,20,0,0,0,0,0,0,0,0,0
SAN DIEGO,May 2015,DCH,2015,CHICANO FEDERATION OF SAN DIEGO COUNTY INC,DCH_BREAKFAST,23,0,0,0,0,0,0,0,0,0
SAN DIEGO,May 2015,DCH,2015,CHICANO FEDERATION OF SAN DIEGO COUNTY INC,DCH_BREAKFAST,25,0,0,0,0,0,0,0,0,0
SAN DIEGO,May 2015,DCH,2015,CHICANO FEDERATION OF SAN DIEGO COUNTY INC,DCH_LUNCH,30,0,0,0,0,78748,0,0,78748,2624.9333
SAN DIEGO,May 2015,DCH,2015,CHICANO FEDERATION OF SAN DIEGO COUNTY INC,DCH_LUNCH,,0,0,0,0,0,1111,3130,4241,0
SAN DIEGO,May 2015,DCH,2015,CHICANO FEDERATION OF SAN DIEGO COUNTY INC,DCH_LUNCH,20,0,0,0,0,0,0,0,0,0
SAN DIEGO,May 2015,DCH,2015,CHICANO FEDERATION OF SAN DIEGO COUNTY INC,DCH_LUNCH,23,0,0,0,0,0,0,0,0,0
SAN DIEGO,May 2015,DCH,2015,CHICANO FEDERATION OF SAN DIEGO COUNTY INC,DCH_LUNCH,25,0,0,0,0,0,0,0,0,0
SAN DIEGO,May 2015,DCH,2015,CHICANO FEDERATION OF SAN DIEGO COUNTY INC,DCH_SNACK_AM,30,0,0,0,0,37778,0,0,37778,1259.2667
SAN DIEGO,May 2015,DCH,2015,CHICANO FEDERATION OF SAN DIEGO COUNTY INC,DCH_SNACK_AM,,0,0,0,0,0,437,1459,1896,0
SAN DIEGO,May 2015,DCH,2015,CHICANO FEDERATION OF SAN DIEGO COUNTY INC,DCH_SNACK_AM,20,0,0,0,0,0,0,0,0,0
SAN DIEGO,May 2015,DCH,2015,CHICANO FEDERATION OF SAN DIEGO COUNTY INC,DCH_SNACK_AM,23,0,0,0,0,0,0,0,0,0
SAN DIEGO,May 2015,DCH,2015,CHICANO FEDERATION OF SAN DIEGO COUNTY INC,DCH_SNACK_AM,25,0,0,0,0,0,0,0,0,0
SAN DIEGO,May 2015,DCH,2015,CHICANO FEDERATION OF SAN DIEGO COUNTY INC,DCH_SNACK_NT,30,0,0,0,0,10051,0,0,10051,335.0333
SAN DIEGO,May 2015,DCH,2015,CHICANO FEDERATION OF SAN DIEGO COUNTY INC,DCH_SNACK_NT,,0,0,0,0,0,17,38,55,0
SAN DIEGO,May 2015,DCH,2015,CHICANO FEDERATION OF SAN DIEGO COUNTY INC,DCH_SNACK_NT,20,0,0,0,0,0,0,0,0,0
SAN DIEGO,May 2015,DCH,2015,CHICANO FEDERATION OF SAN DIEGO COUNTY INC,DCH_SNACK_NT,23,0,0,0,0,0,0,0,0,0
SAN DIEGO,May 2015,DCH,2015,CHICANO FEDERATION OF SAN DIEGO COUNTY INC,DCH_SNACK_NT,25,0,0,0,0,0,0,0,0,0
SAN DIEGO,May 2015,DCH,2015,CHICANO FEDERATION OF SAN DIEGO COUNTY INC,DCH_SNACK_PM,30,0,0,0,0,71053,0,0,71053,2368.4333
SAN DIEGO,May 2015,DCH,2015,CHICANO FEDERATION OF SAN DIEGO COUNTY INC,DCH_SNACK_PM,,0,0,0,0,0,916,1911,2827,0
SAN DIEGO,May 2015,DCH,2015,CHICANO FEDERATION OF SAN DIEGO COUNTY INC,DCH_SNACK_PM,20,0,0,0,0,0,0,0,0,0
SAN DIEGO,May 2015,DCH,2015,CHICANO FEDERATION OF SAN DIEGO COUNTY INC,DCH_SNACK_PM,23,0,0,0,0,0,0,0,0,0
SAN DIEGO,May 2015,DCH,2015,CHICANO FEDERATION OF SAN DIEGO COUNTY INC,DCH_SNACK_PM,25,0,0,0,0,0,0,0,0,0
SAN DIEGO,May 2015,DCH,2015,CHICANO FEDERATION OF SAN DIEGO COUNTY INC,DCH_SUPPER,30,0,0,0,0,87317,0,0,87317,2910.5667
SAN DIEGO,May 2015,DCH,2015,CHICANO FEDERATION OF SAN DIEGO COUNTY INC,DCH_SUPPER,,0,0,0,0,0,1459,2390,3849,0
SAN DIEGO,May 2015,DCH,2015,CHICANO FEDERATION OF SAN DIEGO COUNTY INC,DCH_SUPPER,20,0,0,0,0,0,0,0,0,0
SAN DIEGO,May 2015,DCH,2015,CHICANO FEDERATION OF SAN DIEGO COUNTY INC,DCH_SUPPER,23,0,0,0,0,0,0,0,0,0
SAN DIEGO,May 2015,DCH,2015,CHICANO FEDERATION OF SAN DIEGO COUNTY INC,DCH_SUPPER,25,0,0,0,0,0,0,0,0,0
SAN DIEGO,Jun 2015,DCH,2015,CHICANO FEDERATION OF SAN DIEGO COUNTY INC,DCH_BREAKFAST,30,0,0,0,0,50875,0,0,50875,1695.8333
SAN DIEGO,Jun 2015,DCH,2015,CHICANO FEDERATION OF SAN DIEGO COUNTY INC,DCH_BREAKFAST,,0,0,0,0,0,584,1291,1875,0
SAN DIEGO,Jun 2015,DCH,2015,CHICANO FEDERATION OF SAN DIEGO COUNTY INC,DCH_BREAKFAST,26,0,0,0,0,0,0,0,0,0
SAN DIEGO,Jun 2015,DCH,2015,CHICANO FEDERATION OF SAN DIEGO COUNTY INC,DCH_BREAKFAST,22,0,0,0,0,0,0,0,0,0
SAN DIEGO,Jun 2015,DCH,2015,CHICANO FEDERATION OF SAN DIEGO COUNTY INC,DCH_BREAKFAST,26,0,0,0,0,0,0,0,0,0
SAN DIEGO,Jun 2015,DCH,2015,CHICANO FEDERATION OF SAN DIEGO COUNTY INC,DCH_LUNCH,30,0,0,0,0,99787,0,0,99787,3326.2333
SAN DIEGO,Jun 2015,DCH,2015,CHICANO FEDERATION OF SAN DIEGO COUNTY INC,DCH_LUNCH,,0,0,0,0,0,1686,4275,5961,0
SAN DIEGO,Jun 2015,DCH,2015,CHICANO FEDERATION OF SAN DIEGO COUNTY INC,DCH_LUNCH,26,0,0,0,0,0,0,0,0,0
SAN DIEGO,Jun 2015,DCH,2015,CHICANO FEDERATION OF SAN DIEGO COUNTY INC,DCH_LUNCH,22,0,0,0,0,0,0,0,0,0
SAN DIEGO,Jun 2015,DCH,2015,CHICANO FEDERATION OF SAN DIEGO COUNTY INC,DCH_LUNCH,26,0,0,0,0,0,0,0,0,0
SAN DIEGO,Jun 2015,DCH,2015,CHICANO FEDERATION OF SAN DIEGO COUNTY INC,DCH_SNACK_AM,30,0,0,0,0,44796,0,0,44796,1493.2
SAN DIEGO,Jun 2015,DCH,2015,CHICANO FEDERATION OF SAN DIEGO COUNTY INC,DCH_SNACK_AM,,0,0,0,0,0,647,2187,2834,0
SAN DIEGO,Jun 2015,DCH,2015,CHICANO FEDERATION OF SAN DIEGO COUNTY INC,DCH_SNACK_AM,26,0,0,0,0,0,0,0,0,0
SAN DIEGO,Jun 2015,DCH,2015,CHICANO FEDERATION OF SAN DIEGO COUNTY INC,DCH_SNACK_AM,22,0,0,0,0,0,0,0,0,0
SAN DIEGO,Jun 2015,DCH,2015,CHICANO FEDERATION OF SAN DIEGO COUNTY INC,DCH_SNACK_AM,26,0,0,0,0,0,0,0,0,0
SAN DIEGO,Jun 2015,DCH,2015,CHICANO FEDERATION OF SAN DIEGO COUNTY INC,DCH_SNACK_NT,30,0,0,0,0,8411,0,0,8411,280.3667
SAN DIEGO,Jun 2015,DCH,2015,CHICANO FEDERATION OF SAN DIEGO COUNTY INC,DCH_SNACK_NT,,0,0,0,0,0,34,6,40,0
SAN DIEGO,Jun 2015,DCH,2015,CHICANO FEDERATION OF SAN DIEGO COUNTY INC,DCH_SNACK_NT,26,0,0,0,0,0,0,0,0,0
SAN DIEGO,Jun 2015,DCH,2015,CHICANO FEDERATION OF SAN DIEGO COUNTY INC,DCH_SNACK_NT,22,0,0,0,0,0,0,0,0,0
SAN DIEGO,Jun 2015,DCH,2015,CHICANO FEDERATION OF SAN DIEGO COUNTY INC,DCH_SNACK_NT,26,0,0,0,0,0,0,0,0,0
SAN DIEGO,Jun 2015,DCH,2015,CHICANO FEDERATION OF SAN DIEGO COUNTY INC,DCH_SNACK_PM,30,0,0,0,0,77074,0,0,77074,2569.1333
SAN DIEGO,Jun 2015,DCH,2015,CHICANO FEDERATION OF SAN DIEGO COUNTY INC,DCH_SNACK_PM,,0,0,0,0,0,1388,2292,3680,0
SAN DIEGO,Jun 2015,DCH,2015,CHICANO FEDERATION OF SAN DIEGO COUNTY INC,DCH_SNACK_PM,26,0,0,0,0,0,0,0,0,0
SAN DIEGO,Jun 2015,DCH,2015,CHICANO FEDERATION OF SAN DIEGO COUNTY INC,DCH_SNACK_PM,22,0,0,0,0,0,0,0,0,0
SAN DIEGO,Jun 2015,DCH,2015,CHICANO FEDERATION OF SAN DIEGO COUNTY INC,DCH_SNACK_PM,26,0,0,0,0,0,0,0,0,0
SAN DIEGO,Jun 2015,DCH,2015,CHICANO FEDERATION OF SAN DIEGO COUNTY INC,DCH_SUPPER,30,0,0,0,0,89888,0,0,89888,2996.2667
SAN DIEGO,Jun 2015,DCH,2015,CHICANO FEDERATION OF SAN DIEGO COUNTY INC,DCH_SUPPER,,0,0,0,0,0,1596,3098,4694,0
SAN DIEGO,Jun 2015,DCH,2015,CHICANO FEDERATION OF SAN DIEGO COUNTY INC,DCH_SUPPER,26,0,0,0,0,0,0,0,0,0
SAN DIEGO,Jun 2015,DCH,2015,CHICANO FEDERATION OF SAN DIEGO COUNTY INC,DCH_SUPPER,22,0,0,0,0,0,0,0,0,0
SAN DIEGO,Jun 2015,DCH,2015,CHICANO FEDERATION OF SAN DIEGO COUNTY INC,DCH_SUPPER,26,0,0,0,0,0,0,0,0,0
SAN DIEGO,Jul 2015,DCH,2015,CHICANO FEDERATION OF SAN DIEGO COUNTY INC,DCH_BREAKFAST,30,0,0,0,0,45394,0,0,45394,1513.1333
SAN DIEGO,Jul 2015,DCH,2015,CHICANO FEDERATION OF SAN DIEGO COUNTY INC,DCH_BREAKFAST,,0,0,0,0,0,104,2483,2587,0
SAN DIEGO,Jul 2015,DCH,2015,CHICANO FEDERATION OF SAN DIEGO COUNTY INC,DCH_BREAKFAST,23,0,0,0,0,0,0,0,0,0
SAN DIEGO,Jul 2015,DCH,2015,CHICANO FEDERATION OF SAN DIEGO COUNTY INC,DCH_BREAKFAST,26,0,0,0,0,0,0,0,0,0
SAN DIEGO,Jul 2015,DCH,2015,CHICANO FEDERATION OF SAN DIEGO COUNTY INC,DCH_BREAKFAST,26,0,0,0,0,0,0,0,0,0
SAN DIEGO,Jul 2015,DCH,2015,CHICANO FEDERATION OF SAN DIEGO COUNTY INC,DCH_LUNCH,30,0,0,0,0,106306,0,0,106306,3543.5333
SAN DIEGO,Jul 2015,DCH,2015,CHICANO FEDERATION OF SAN DIEGO COUNTY INC,DCH_LUNCH,,0,0,0,0,0,696,6601,7297,0
SAN DIEGO,Jul 2015,DCH,2015,CHICANO FEDERATION OF SAN DIEGO COUNTY INC,DCH_LUNCH,23,0,0,0,0,0,0,0,0,0
SAN DIEGO,Jul 2015,DCH,2015,CHICANO FEDERATION OF SAN DIEGO COUNTY INC,DCH_LUNCH,26,0,0,0,0,0,0,0,0,0
SAN DIEGO,Jul 2015,DCH,2015,CHICANO FEDERATION OF SAN DIEGO COUNTY INC,DCH_LUNCH,26,0,0,0,0,0,0,0,0,0
SAN DIEGO,Jul 2015,DCH,2015,CHICANO FEDERATION OF SAN DIEGO COUNTY INC,DCH_SNACK_AM,30,0,0,0,0,47453,0,0,47453,1581.7667
SAN DIEGO,Jul 2015,DCH,2015,CHICANO FEDERATION OF SAN DIEGO COUNTY INC,DCH_SNACK_AM,,0,0,0,0,0,470,2748,3218,0
SAN DIEGO,Jul 2015,DCH,2015,CHICANO FEDERATION OF SAN DIEGO COUNTY INC,DCH_SNACK_AM,23,0,0,0,0,0,0,0,0,0
SAN DIEGO,Jul 2015,DCH,2015,CHICANO FEDERATION OF SAN DIEGO COUNTY INC,DCH_SNACK_AM,26,0,0,0,0,0,0,0,0,0
SAN DIEGO,Jul 2015,DCH,2015,CHICANO FEDERATION OF SAN DIEGO COUNTY INC,DCH_SNACK_AM,26,0,0,0,0,0,0,0,0,0
SAN DIEGO,Jul 2015,DCH,2015,CHICANO FEDERATION OF SAN DIEGO COUNTY INC,DCH_SNACK_NT,30,0,0,0,0,7761,0,0,7761,258.7
SAN DIEGO,Jul 2015,DCH,2015,CHICANO FEDERATION OF SAN DIEGO COUNTY INC,DCH_SNACK_NT,,0,0,0,0,0,0,156,156,0
SAN DIEGO,Jul 2015,DCH,2015,CHICANO FEDERATION OF SAN DIEGO COUNTY INC,DCH_SNACK_NT,23,0,0,0,0,0,0,0,0,0
SAN DIEGO,Jul 2015,DCH,2015,CHICANO FEDERATION OF SAN DIEGO COUNTY INC,DCH_SNACK_NT,26,0,0,0,0,0,0,0,0,0
SAN DIEGO,Jul 2015,DCH,2015,CHICANO FEDERATION OF SAN DIEGO COUNTY INC,DCH_SNACK_NT,26,0,0,0,0,0,0,0,0,0
SAN DIEGO,Jul 2015,DCH,2015,CHICANO FEDERATION OF SAN DIEGO COUNTY INC,DCH_SNACK_PM,30,0,0,0,0,75571,0,0,75571,2519.0333
SAN DIEGO,Jul 2015,DCH,2015,CHICANO FEDERATION OF SAN DIEGO COUNTY INC,DCH_SNACK_PM,,0,0,0,0,0,294,4204,4498,0
SAN DIEGO,Jul 2015,DCH,2015,CHICANO FEDERATION OF SAN DIEGO COUNTY INC,DCH_SNACK_PM,23,0,0,0,0,0,0,0,0,0
SAN DIEGO,Jul 2015,DCH,2015,CHICANO FEDERATION OF SAN DIEGO COUNTY INC,DCH_SNACK_PM,26,0,0,0,0,0,0,0,0,0
SAN DIEGO,Jul 2015,DCH,2015,CHICANO FEDERATION OF SAN DIEGO COUNTY INC,DCH_SNACK_PM,26,0,0,0,0,0,0,0,0,0
SAN DIEGO,Jul 2015,DCH,2015,CHICANO FEDERATION OF SAN DIEGO COUNTY INC,DCH_SUPPER,30,0,0,0,0,86889,0,0,86889,2896.3
SAN DIEGO,Jul 2015,DCH,2015,CHICANO FEDERATION OF SAN DIEGO COUNTY INC,DCH_SUPPER,,0,0,0,0,0,726,4507,5233,0
SAN DIEGO,Jul 2015,DCH,2015,CHICANO FEDERATION OF SAN DIEGO COUNTY INC,DCH_SUPPER,23,0,0,0,0,0,0,0,0,0
SAN DIEGO,Jul 2015,DCH,2015,CHICANO FEDERATION OF SAN DIEGO COUNTY INC,DCH_SUPPER,26,0,0,0,0,0,0,0,0,0
SAN DIEGO,Jul 2015,DCH,2015,CHICANO FEDERATION OF SAN DIEGO COUNTY INC,DCH_SUPPER,26,0,0,0,0,0,0,0,0,0
SAN DIEGO,Aug 2015,CACF,2015,CHICANO FEDERATION OF SAN DIEGO COUNTY INC,CHILD_BREAKFAST,21,52,11,0,63,603,127,0,730,34.7619
SAN DIEGO,Aug 2015,CACF,2015,CHICANO FEDERATION OF SAN DIEGO COUNTY INC,CHILD_LUNCH,21,52,11,0,63,720,152,0,872,41.5238
SAN DIEGO,Aug 2015,CACF,2015,CHICANO FEDERATION OF SAN DIEGO COUNTY INC,CHILD_SNACK_PM,21,52,11,0,63,594,126,0,720,34.2857
SAN DIEGO,Aug 2015,DCH,2015,CHICANO FEDERATION OF SAN DIEGO COUNTY INC,DCH_BREAKFAST,31,0,0,0,0,49117,0,0,49117,1584.4194
SAN DIEGO,Aug 2015,DCH,2015,CHICANO FEDERATION OF SAN DIEGO COUNTY INC,DCH_BREAKFAST,,0,0,0,0,0,473,2120,2593,0
SAN DIEGO,Aug 2015,DCH,2015,CHICANO FEDERATION OF SAN DIEGO COUNTY INC,DCH_BREAKFAST,23,0,0,0,0,0,0,0,0,0
SAN DIEGO,Aug 2015,DCH,2015,CHICANO FEDERATION OF SAN DIEGO COUNTY INC,DCH_BREAKFAST,26,0,0,0,0,0,0,0,0,0
SAN DIEGO,Aug 2015,DCH,2015,CHICANO FEDERATION OF SAN DIEGO COUNTY INC,DCH_BREAKFAST,26,0,0,0,0,0,0,0,0,0
SAN DIEGO,Aug 2015,DCH,2015,CHICANO FEDERATION OF SAN DIEGO COUNTY INC,DCH_LUNCH,31,0,0,0,0,89881,0,0,89881,2899.3871
SAN DIEGO,Aug 2015,DCH,2015,CHICANO FEDERATION OF SAN DIEGO COUNTY INC,DCH_LUNCH,,0,0,0,0,0,1020,4608,5628,0
SAN DIEGO,Aug 2015,DCH,2015,CHICANO FEDERATION OF SAN DIEGO COUNTY INC,DCH_LUNCH,23,0,0,0,0,0,0,0,0,0
SAN DIEGO,Aug 2015,DCH,2015,CHICANO FEDERATION OF SAN DIEGO COUNTY INC,DCH_LUNCH,26,0,0,0,0,0,0,0,0,0
SAN DIEGO,Aug 2015,DCH,2015,CHICANO FEDERATION OF SAN DIEGO COUNTY INC,DCH_LUNCH,26,0,0,0,0,0,0,0,0,0
SAN DIEGO,Aug 2015,DCH,2015,CHICANO FEDERATION OF SAN DIEGO COUNTY INC,DCH_SNACK_AM,31,0,0,0,0,41499,0,0,41499,1338.6774
SAN DIEGO,Aug 2015,DCH,2015,CHICANO FEDERATION OF SAN DIEGO COUNTY INC,DCH_SNACK_AM,,0,0,0,0,0,678,1661,2339,0
SAN DIEGO,Aug 2015,DCH,2015,CHICANO FEDERATION OF SAN DIEGO COUNTY INC,DCH_SNACK_AM,23,0,0,0,0,0,0,0,0,0
SAN DIEGO,Aug 2015,DCH,2015,CHICANO FEDERATION OF SAN DIEGO COUNTY INC,DCH_SNACK_AM,26,0,0,0,0,0,0,0,0,0
SAN DIEGO,Aug 2015,DCH,2015,CHICANO FEDERATION OF SAN DIEGO COUNTY INC,DCH_SNACK_AM,26,0,0,0,0,0,0,0,0,0
SAN DIEGO,Aug 2015,DCH,2015,CHICANO FEDERATION OF SAN DIEGO COUNTY INC,DCH_SNACK_NT,31,0,0,0,0,8790,0,0,8790,283.5484
SAN DIEGO,Aug 2015,DCH,2015,CHICANO FEDERATION OF SAN DIEGO COUNTY INC,DCH_SNACK_NT,,0,0,0,0,0,0,87,87,0
SAN DIEGO,Aug 2015,DCH,2015,CHICANO FEDERATION OF SAN DIEGO COUNTY INC,DCH_SNACK_NT,23,0,0,0,0,0,0,0,0,0
SAN DIEGO,Aug 2015,DCH,2015,CHICANO FEDERATION OF SAN DIEGO COUNTY INC,DCH_SNACK_NT,26,0,0,0,0,0,0,0,0,0
SAN DIEGO,Aug 2015,DCH,2015,CHICANO FEDERATION OF SAN DIEGO COUNTY INC,DCH_SNACK_NT,26,0,0,0,0,0,0,0,0,0
SAN DIEGO,Aug 2015,DCH,2015,CHICANO FEDERATION OF SAN DIEGO COUNTY INC,DCH_SNACK_PM,31,0,0,0,0,69596,0,0,69596,2245.0323
SAN DIEGO,Aug 2015,DCH,2015,CHICANO FEDERATION OF SAN DIEGO COUNTY INC,DCH_SNACK_PM,,0,0,0,0,0,407,3525,3932,0
SAN DIEGO,Aug 2015,DCH,2015,CHICANO FEDERATION OF SAN DIEGO COUNTY INC,DCH_SNACK_PM,23,0,0,0,0,0,0,0,0,0
SAN DIEGO,Aug 2015,DCH,2015,CHICANO FEDERATION OF SAN DIEGO COUNTY INC,DCH_SNACK_PM,26,0,0,0,0,0,0,0,0,0
SAN DIEGO,Aug 2015,DCH,2015,CHICANO FEDERATION OF SAN DIEGO COUNTY INC,DCH_SNACK_PM,26,0,0,0,0,0,0,0,0,0
SAN DIEGO,Aug 2015,DCH,2015,CHICANO FEDERATION OF SAN DIEGO COUNTY INC,DCH_SUPPER,31,0,0,0,0,84150,0,0,84150,2714.5161
SAN DIEGO,Aug 2015,DCH,2015,CHICANO FEDERATION OF SAN DIEGO COUNTY INC,DCH_SUPPER,,0,0,0,0,0,876,3799,4675,0
SAN DIEGO,Aug 2015,DCH,2015,CHICANO FEDERATION OF SAN DIEGO COUNTY INC,DCH_SUPPER,23,0,0,0,0,0,0,0,0,0
SAN DIEGO,Aug 2015,DCH,2015,CHICANO FEDERATION OF SAN DIEGO COUNTY INC,DCH_SUPPER,26,0,0,0,0,0,0,0,0,0
SAN DIEGO,Aug 2015,DCH,2015,CHICANO FEDERATION OF SAN DIEGO COUNTY INC,DCH_SUPPER,26,0,0,0,0,0,0,0,0,0
SAN DIEGO,Sep 2015,CACF,2015,CHICANO FEDERATION OF SAN DIEGO COUNTY INC,CHILD_BREAKFAST,21,52,11,0,63,587,124,0,711,33.8571
SAN DIEGO,Sep 2015,CACF,2015,CHICANO FEDERATION OF SAN DIEGO COUNTY INC,CHILD_LUNCH,21,52,11,0,63,710,150,0,860,40.9524
SAN DIEGO,Sep 2015,CACF,2015,CHICANO FEDERATION OF SAN DIEGO COUNTY INC,CHILD_SNACK_PM,21,52,11,0,63,575,122,0,697,33.1905
SAN DIEGO,Sep 2015,DCH,2015,CHICANO FEDERATION OF SAN DIEGO COUNTY INC,DCH_BREAKFAST,29,0,0,0,0,52204,0,0,52204,1800.1379
SAN DIEGO,Sep 2015,DCH,2015,CHICANO FEDERATION OF SAN DIEGO COUNTY INC,DCH_BREAKFAST,,0,0,0,0,0,473,1900,2373,0
SAN DIEGO,Sep 2015,DCH,2015,CHICANO FEDERATION OF SAN DIEGO COUNTY INC,DCH_BREAKFAST,22,0,0,0,0,0,0,0,0,0
SAN DIEGO,Sep 2015,DCH,2015,CHICANO FEDERATION OF SAN DIEGO COUNTY INC,DCH_BREAKFAST,25,0,0,0,0,0,0,0,0,0
SAN DIEGO,Sep 2015,DCH,2015,CHICANO FEDERATION OF SAN DIEGO COUNTY INC,DCH_BREAKFAST,21,0,0,0,0,0,0,0,0,0
SAN DIEGO,Sep 2015,DCH,2015,CHICANO FEDERATION OF SAN DIEGO COUNTY INC,DCH_LUNCH,29,0,0,0,0,77442,0,0,77442,2670.4138
SAN DIEGO,Sep 2015,DCH,2015,CHICANO FEDERATION OF SAN DIEGO COUNTY INC,DCH_LUNCH,,0,0,0,0,0,1082,4408,5490,0
SAN DIEGO,Sep 2015,DCH,2015,CHICANO FEDERATION OF SAN DIEGO COUNTY INC,DCH_LUNCH,22,0,0,0,0,0,0,0,0,0
SAN DIEGO,Sep 2015,DCH,2015,CHICANO FEDERATION OF SAN DIEGO COUNTY INC,DCH_LUNCH,25,0,0,0,0,0,0,0,0,0
SAN DIEGO,Sep 2015,DCH,2015,CHICANO FEDERATION OF SAN DIEGO COUNTY INC,DCH_LUNCH,21,0,0,0,0,0,0,0,0,0
SAN DIEGO,Sep 2015,DCH,2015,CHICANO FEDERATION OF SAN DIEGO COUNTY INC,DCH_SNACK_AM,29,0,0,0,0,36394,0,0,36394,1254.9655
SAN DIEGO,Sep 2015,DCH,2015,CHICANO FEDERATION OF SAN DIEGO COUNTY INC,DCH_SNACK_AM,,0,0,0,0,0,707,1600,2307,0
SAN DIEGO,Sep 2015,DCH,2015,CHICANO FEDERATION OF SAN DIEGO COUNTY INC,DCH_SNACK_AM,22,0,0,0,0,0,0,0,0,0
SAN DIEGO,Sep 2015,DCH,2015,CHICANO FEDERATION OF SAN DIEGO COUNTY INC,DCH_SNACK_AM,25,0,0,0,0,0,0,0,0,0
SAN DIEGO,Sep 2015,DCH,2015,CHICANO FEDERATION OF SAN DIEGO COUNTY INC,DCH_SNACK_AM,21,0,0,0,0,0,0,0,0,0
SAN DIEGO,Sep 2015,DCH,2015,CHICANO FEDERATION OF SAN DIEGO COUNTY INC,DCH_SNACK_NT,29,0,0,0,0,10227,0,0,10227,352.6552
SAN DIEGO,Sep 2015,DCH,2015,CHICANO FEDERATION OF SAN DIEGO COUNTY INC,DCH_SNACK_NT,,0,0,0,0,0,0,42,42,0
SAN DIEGO,Sep 2015,DCH,2015,CHICANO FEDERATION OF SAN DIEGO COUNTY INC,DCH_SNACK_NT,22,0,0,0,0,0,0,0,0,0
SAN DIEGO,Sep 2015,DCH,2015,CHICANO FEDERATION OF SAN DIEGO COUNTY INC,DCH_SNACK_NT,25,0,0,0,0,0,0,0,0,0
SAN DIEGO,Sep 2015,DCH,2015,CHICANO FEDERATION OF SAN DIEGO COUNTY INC,DCH_SNACK_NT,21,0,0,0,0,0,0,0,0,0
SAN DIEGO,Sep 2015,DCH,2015,CHICANO FEDERATION OF SAN DIEGO COUNTY INC,DCH_SNACK_PM,29,0,0,0,0,69822,0,0,69822,2407.6552
SAN DIEGO,Sep 2015,DCH,2015,CHICANO FEDERATION OF SAN DIEGO COUNTY INC,DCH_SNACK_PM,,0,0,0,0,0,418,3420,3838,0
SAN DIEGO,Sep 2015,DCH,2015,CHICANO FEDERATION OF SAN DIEGO COUNTY INC,DCH_SNACK_PM,22,0,0,0,0,0,0,0,0,0
SAN DIEGO,Sep 2015,DCH,2015,CHICANO FEDERATION OF SAN DIEGO COUNTY INC,DCH_SNACK_PM,25,0,0,0,0,0,0,0,0,0
SAN DIEGO,Sep 2015,DCH,2015,CHICANO FEDERATION OF SAN DIEGO COUNTY INC,DCH_SNACK_PM,21,0,0,0,0,0,0,0,0,0
SAN DIEGO,Sep 2015,DCH,2015,CHICANO FEDERATION OF SAN DIEGO COUNTY INC,DCH_SUPPER,29,0,0,0,0,85301,0,0,85301,2941.4138
SAN DIEGO,Sep 2015,DCH,2015,CHICANO FEDERATION OF SAN DIEGO COUNTY INC,DCH_SUPPER,,0,0,0,0,0,987,3673,4660,0
SAN DIEGO,Sep 2015,DCH,2015,CHICANO FEDERATION OF SAN DIEGO COUNTY INC,DCH_SUPPER,22,0,0,0,0,0,0,0,0,0
SAN DIEGO,Sep 2015,DCH,2015,CHICANO FEDERATION OF SAN DIEGO COUNTY INC,DCH_SUPPER,25,0,0,0,0,0,0,0,0,0
SAN DIEGO,Sep 2015,DCH,2015,CHICANO FEDERATION OF SAN DIEGO COUNTY INC,DCH_SUPPER,21,0,0,0,0,0,0,0,0,0
SAN DIEGO,Oct 2014,CACF,2015,CHILD DEVELOPMENT ASSOC INC ,CHILD_BREAKFAST,23,286,90,57,433,3301,1039,657,4997,217.2609
SAN DIEGO,Oct 2014,CACF,2015,CHILD DEVELOPMENT ASSOC INC ,CHILD_LUNCH,23,286,90,57,433,4546,1431,906,6883,299.2609
SAN DIEGO,Oct 2014,CACF,2015,CHILD DEVELOPMENT ASSOC INC ,CHILD_SNACK_AM,23,286,90,57,433,177,56,35,268,11.6522
SAN DIEGO,Oct 2014,CACF,2015,CHILD DEVELOPMENT ASSOC INC ,CHILD_SNACK_PM,23,286,90,57,433,3709,1168,739,5616,244.1739
SAN DIEGO,Oct 2014,DCH,2015,CHILD DEVELOPMENT ASSOC INC ,DCH_BREAKFAST,27,0,0,0,0,112052,0,0,112052,4150.0741
SAN DIEGO,Oct 2014,DCH,2015,CHILD DEVELOPMENT ASSOC INC ,DCH_BREAKFAST,,0,0,0,0,0,362,7698,8060,0
SAN DIEGO,Oct 2014,DCH,2015,CHILD DEVELOPMENT ASSOC INC ,DCH_BREAKFAST,27,0,0,0,0,0,0,0,0,0
SAN DIEGO,Oct 2014,DCH,2015,CHILD DEVELOPMENT ASSOC INC ,DCH_BREAKFAST,24,0,0,0,0,0,0,0,0,0
SAN DIEGO,Oct 2014,DCH,2015,CHILD DEVELOPMENT ASSOC INC ,DCH_LUNCH,27,0,0,0,0,124274,0,0,124274,4602.7407
SAN DIEGO,Oct 2014,DCH,2015,CHILD DEVELOPMENT ASSOC INC ,DCH_LUNCH,,0,0,0,0,0,253,12800,13053,0
SAN DIEGO,Oct 2014,DCH,2015,CHILD DEVELOPMENT ASSOC INC ,DCH_LUNCH,27,0,0,0,0,0,0,0,0,0
SAN DIEGO,Oct 2014,DCH,2015,CHILD DEVELOPMENT ASSOC INC ,DCH_LUNCH,24,0,0,0,0,0,0,0,0,0
SAN DIEGO,Oct 2014,DCH,2015,CHILD DEVELOPMENT ASSOC INC ,DCH_SNACK_AM,27,0,0,0,0,55695,0,0,55695,2062.7778
SAN DIEGO,Oct 2014,DCH,2015,CHILD DEVELOPMENT ASSOC INC ,DCH_SNACK_AM,,0,0,0,0,0,235,7147,7382,0
SAN DIEGO,Oct 2014,DCH,2015,CHILD DEVELOPMENT ASSOC INC ,DCH_SNACK_AM,27,0,0,0,0,0,0,0,0,0
SAN DIEGO,Oct 2014,DCH,2015,CHILD DEVELOPMENT ASSOC INC ,DCH_SNACK_AM,24,0,0,0,0,0,0,0,0,0
SAN DIEGO,Oct 2014,DCH,2015,CHILD DEVELOPMENT ASSOC INC ,DCH_SNACK_NT,27,0,0,0,0,13313,0,0,13313,493.0741
SAN DIEGO,Oct 2014,DCH,2015,CHILD DEVELOPMENT ASSOC INC ,DCH_SNACK_NT,,0,0,0,0,0,2,181,183,0
SAN DIEGO,Oct 2014,DCH,2015,CHILD DEVELOPMENT ASSOC INC ,DCH_SNACK_NT,27,0,0,0,0,0,0,0,0,0
SAN DIEGO,Oct 2014,DCH,2015,CHILD DEVELOPMENT ASSOC INC ,DCH_SNACK_NT,24,0,0,0,0,0,0,0,0,0
SAN DIEGO,Oct 2014,DCH,2015,CHILD DEVELOPMENT ASSOC INC ,DCH_SNACK_PM,27,0,0,0,0,125664,0,0,125664,4654.2222
SAN DIEGO,Oct 2014,DCH,2015,CHILD DEVELOPMENT ASSOC INC ,DCH_SNACK_PM,,0,0,0,0,0,285,9053,9338,0
SAN DIEGO,Oct 2014,DCH,2015,CHILD DEVELOPMENT ASSOC INC ,DCH_SNACK_PM,27,0,0,0,0,0,0,0,0,0
SAN DIEGO,Oct 2014,DCH,2015,CHILD DEVELOPMENT ASSOC INC ,DCH_SNACK_PM,24,0,0,0,0,0,0,0,0,0
SAN DIEGO,Oct 2014,DCH,2015,CHILD DEVELOPMENT ASSOC INC ,DCH_SUPPER,27,0,0,0,0,93653,0,0,93653,3468.6296
SAN DIEGO,Oct 2014,DCH,2015,CHILD DEVELOPMENT ASSOC INC ,DCH_SUPPER,,0,0,0,0,0,223,5253,5476,0
SAN DIEGO,Oct 2014,DCH,2015,CHILD DEVELOPMENT ASSOC INC ,DCH_SUPPER,27,0,0,0,0,0,0,0,0,0
SAN DIEGO,Oct 2014,DCH,2015,CHILD DEVELOPMENT ASSOC INC ,DCH_SUPPER,24,0,0,0,0,0,0,0,0,0
SAN DIEGO,Nov 2014,CACF,2015,CHILD DEVELOPMENT ASSOC INC ,CHILD_BREAKFAST,18,286,90,57,433,2548,802,508,3858,214.3333
SAN DIEGO,Nov 2014,CACF,2015,CHILD DEVELOPMENT ASSOC INC ,CHILD_LUNCH,18,286,90,57,433,3413,1074,680,5167,287.0556
SAN DIEGO,Nov 2014,CACF,2015,CHILD DEVELOPMENT ASSOC INC ,CHILD_SNACK_AM,18,286,90,57,433,133,42,26,201,11.1667
SAN DIEGO,Nov 2014,CACF,2015,CHILD DEVELOPMENT ASSOC INC ,CHILD_SNACK_PM,18,286,90,57,433,2914,917,581,4412,245.1111
SAN DIEGO,Nov 2014,DCH,2015,CHILD DEVELOPMENT ASSOC INC ,DCH_BREAKFAST,24,0,0,0,0,85365,0,0,85365,3556.875
SAN DIEGO,Nov 2014,DCH,2015,CHILD DEVELOPMENT ASSOC INC ,DCH_BREAKFAST,,0,0,0,0,0,249,5730,5979,0
SAN DIEGO,Nov 2014,DCH,2015,CHILD DEVELOPMENT ASSOC INC ,DCH_BREAKFAST,24,0,0,0,0,0,0,0,0,0
SAN DIEGO,Nov 2014,DCH,2015,CHILD DEVELOPMENT ASSOC INC ,DCH_BREAKFAST,18,0,0,0,0,0,0,0,0,0
SAN DIEGO,Nov 2014,DCH,2015,CHILD DEVELOPMENT ASSOC INC ,DCH_LUNCH,24,0,0,0,0,105883,0,0,105883,4411.7917
SAN DIEGO,Nov 2014,DCH,2015,CHILD DEVELOPMENT ASSOC INC ,DCH_LUNCH,,0,0,0,0,0,206,9940,10146,0
SAN DIEGO,Nov 2014,DCH,2015,CHILD DEVELOPMENT ASSOC INC ,DCH_LUNCH,24,0,0,0,0,0,0,0,0,0
SAN DIEGO,Nov 2014,DCH,2015,CHILD DEVELOPMENT ASSOC INC ,DCH_LUNCH,18,0,0,0,0,0,0,0,0,0
SAN DIEGO,Nov 2014,DCH,2015,CHILD DEVELOPMENT ASSOC INC ,DCH_SNACK_AM,24,0,0,0,0,46323,0,0,46323,1930.125
SAN DIEGO,Nov 2014,DCH,2015,CHILD DEVELOPMENT ASSOC INC ,DCH_SNACK_AM,,0,0,0,0,0,158,5584,5742,0
SAN DIEGO,Nov 2014,DCH,2015,CHILD DEVELOPMENT ASSOC INC ,DCH_SNACK_AM,24,0,0,0,0,0,0,0,0,0
SAN DIEGO,Nov 2014,DCH,2015,CHILD DEVELOPMENT ASSOC INC ,DCH_SNACK_AM,18,0,0,0,0,0,0,0,0,0
SAN DIEGO,Nov 2014,DCH,2015,CHILD DEVELOPMENT ASSOC INC ,DCH_SNACK_NT,24,0,0,0,0,9813,0,0,9813,408.875
SAN DIEGO,Nov 2014,DCH,2015,CHILD DEVELOPMENT ASSOC INC ,DCH_SNACK_NT,,0,0,0,0,0,5,79,84,0
SAN DIEGO,Nov 2014,DCH,2015,CHILD DEVELOPMENT ASSOC INC ,DCH_SNACK_NT,24,0,0,0,0,0,0,0,0,0
SAN DIEGO,Nov 2014,DCH,2015,CHILD DEVELOPMENT ASSOC INC ,DCH_SNACK_NT,18,0,0,0,0,0,0,0,0,0
SAN DIEGO,Nov 2014,DCH,2015,CHILD DEVELOPMENT ASSOC INC ,DCH_SNACK_PM,24,0,0,0,0,97802,0,0,97802,4075.0833
SAN DIEGO,Nov 2014,DCH,2015,CHILD DEVELOPMENT ASSOC INC ,DCH_SNACK_PM,,0,0,0,0,0,185,6644,6829,0
SAN DIEGO,Nov 2014,DCH,2015,CHILD DEVELOPMENT ASSOC INC ,DCH_SNACK_PM,24,0,0,0,0,0,0,0,0,0
SAN DIEGO,Nov 2014,DCH,2015,CHILD DEVELOPMENT ASSOC INC ,DCH_SNACK_PM,18,0,0,0,0,0,0,0,0,0
SAN DIEGO,Nov 2014,DCH,2015,CHILD DEVELOPMENT ASSOC INC ,DCH_SUPPER,24,0,0,0,0,74078,0,0,74078,3086.5833
SAN DIEGO,Nov 2014,DCH,2015,CHILD DEVELOPMENT ASSOC INC ,DCH_SUPPER,,0,0,0,0,0,144,3969,4113,0
SAN DIEGO,Nov 2014,DCH,2015,CHILD DEVELOPMENT ASSOC INC ,DCH_SUPPER,24,0,0,0,0,0,0,0,0,0
SAN DIEGO,Nov 2014,DCH,2015,CHILD DEVELOPMENT ASSOC INC ,DCH_SUPPER,18,0,0,0,0,0,0,0,0,0
SAN DIEGO,Dec 2014,CACF,2015,CHILD DEVELOPMENT ASSOC INC ,CHILD_BREAKFAST,18,286,90,57,433,2433,766,484,3683,204.6111
SAN DIEGO,Dec 2014,CACF,2015,CHILD DEVELOPMENT ASSOC INC ,CHILD_LUNCH,18,286,90,57,433,3207,1009,639,4855,269.7222
SAN DIEGO,Dec 2014,CACF,2015,CHILD DEVELOPMENT ASSOC INC ,CHILD_SNACK_AM,18,286,90,57,433,113,36,22,171,9.5
SAN DIEGO,Dec 2014,CACF,2015,CHILD DEVELOPMENT ASSOC INC ,CHILD_SNACK_PM,18,286,90,57,433,2852,898,568,4318,239.8889
SAN DIEGO,Dec 2014,DCH,2015,CHILD DEVELOPMENT ASSOC INC ,DCH_BREAKFAST,26,0,0,0,0,94355,0,0,94355,3629.0385
SAN DIEGO,Dec 2014,DCH,2015,CHILD DEVELOPMENT ASSOC INC ,DCH_BREAKFAST,,0,0,0,0,0,171,6176,6347,0
SAN DIEGO,Dec 2014,DCH,2015,CHILD DEVELOPMENT ASSOC INC ,DCH_BREAKFAST,26,0,0,0,0,0,0,0,0,0
SAN DIEGO,Dec 2014,DCH,2015,CHILD DEVELOPMENT ASSOC INC ,DCH_BREAKFAST,24,0,0,0,0,0,0,0,0,0
SAN DIEGO,Dec 2014,DCH,2015,CHILD DEVELOPMENT ASSOC INC ,DCH_LUNCH,26,0,0,0,0,120321,0,0,120321,4627.7308
SAN DIEGO,Dec 2014,DCH,2015,CHILD DEVELOPMENT ASSOC INC ,DCH_LUNCH,,0,0,0,0,0,220,10492,10712,0
SAN DIEGO,Dec 2014,DCH,2015,CHILD DEVELOPMENT ASSOC INC ,DCH_LUNCH,26,0,0,0,0,0,0,0,0,0
SAN DIEGO,Dec 2014,DCH,2015,CHILD DEVELOPMENT ASSOC INC ,DCH_LUNCH,24,0,0,0,0,0,0,0,0,0
SAN DIEGO,Dec 2014,DCH,2015,CHILD DEVELOPMENT ASSOC INC ,DCH_SNACK_AM,26,0,0,0,0,52621,0,0,52621,2023.8846
SAN DIEGO,Dec 2014,DCH,2015,CHILD DEVELOPMENT ASSOC INC ,DCH_SNACK_AM,,0,0,0,0,0,154,5793,5947,0
SAN DIEGO,Dec 2014,DCH,2015,CHILD DEVELOPMENT ASSOC INC ,DCH_SNACK_AM,26,0,0,0,0,0,0,0,0,0
SAN DIEGO,Dec 2014,DCH,2015,CHILD DEVELOPMENT ASSOC INC ,DCH_SNACK_AM,24,0,0,0,0,0,0,0,0,0
SAN DIEGO,Dec 2014,DCH,2015,CHILD DEVELOPMENT ASSOC INC ,DCH_SNACK_NT,26,0,0,0,0,10344,0,0,10344,397.8462
SAN DIEGO,Dec 2014,DCH,2015,CHILD DEVELOPMENT ASSOC INC ,DCH_SNACK_NT,,0,0,0,0,0,3,100,103,0
SAN DIEGO,Dec 2014,DCH,2015,CHILD DEVELOPMENT ASSOC INC ,DCH_SNACK_NT,26,0,0,0,0,0,0,0,0,0
SAN DIEGO,Dec 2014,DCH,2015,CHILD DEVELOPMENT ASSOC INC ,DCH_SNACK_NT,24,0,0,0,0,0,0,0,0,0
SAN DIEGO,Dec 2014,DCH,2015,CHILD DEVELOPMENT ASSOC INC ,DCH_SNACK_PM,26,0,0,0,0,108362,0,0,108362,4167.7692
SAN DIEGO,Dec 2014,DCH,2015,CHILD DEVELOPMENT ASSOC INC ,DCH_SNACK_PM,,0,0,0,0,0,220,7033,7253,0
SAN DIEGO,Dec 2014,DCH,2015,CHILD DEVELOPMENT ASSOC INC ,DCH_SNACK_PM,26,0,0,0,0,0,0,0,0,0
SAN DIEGO,Dec 2014,DCH,2015,CHILD DEVELOPMENT ASSOC INC ,DCH_SNACK_PM,24,0,0,0,0,0,0,0,0,0
SAN DIEGO,Dec 2014,DCH,2015,CHILD DEVELOPMENT ASSOC INC ,DCH_SUPPER,26,0,0,0,0,83248,0,0,83248,3201.8462
SAN DIEGO,Dec 2014,DCH,2015,CHILD DEVELOPMENT ASSOC INC ,DCH_SUPPER,,0,0,0,0,0,211,4158,4369,0
SAN DIEGO,Dec 2014,DCH,2015,CHILD DEVELOPMENT ASSOC INC ,DCH_SUPPER,26,0,0,0,0,0,0,0,0,0
SAN DIEGO,Dec 2014,DCH,2015,CHILD DEVELOPMENT ASSOC INC ,DCH_SUPPER,24,0,0,0,0,0,0,0,0,0
SAN DIEGO,Jan 2015,CACF,2015,CHILD DEVELOPMENT ASSOC INC ,CHILD_BREAKFAST,20,286,90,57,433,2577,811,513,3901,195.05
SAN DIEGO,Jan 2015,CACF,2015,CHILD DEVELOPMENT ASSOC INC ,CHILD_LUNCH,20,286,90,57,433,3515,1106,701,5322,266.1
SAN DIEGO,Jan 2015,CACF,2015,CHILD DEVELOPMENT ASSOC INC ,CHILD_SNACK_AM,20,286,90,57,433,152,48,30,230,11.5
SAN DIEGO,Jan 2015,CACF,2015,CHILD DEVELOPMENT ASSOC INC ,CHILD_SNACK_PM,20,286,90,57,433,3127,984,624,4735,236.75
SAN DIEGO,Jan 2015,DCH,2015,CHILD DEVELOPMENT ASSOC INC ,DCH_BREAKFAST,26,0,0,0,0,97242,0,0,97242,3740.0769
SAN DIEGO,Jan 2015,DCH,2015,CHILD DEVELOPMENT ASSOC INC ,DCH_BREAKFAST,,0,0,0,0,0,230,6495,6725,0
SAN DIEGO,Jan 2015,DCH,2015,CHILD DEVELOPMENT ASSOC INC ,DCH_BREAKFAST,26,0,0,0,0,0,0,0,0,0
SAN DIEGO,Jan 2015,DCH,2015,CHILD DEVELOPMENT ASSOC INC ,DCH_BREAKFAST,24,0,0,0,0,0,0,0,0,0
SAN DIEGO,Jan 2015,DCH,2015,CHILD DEVELOPMENT ASSOC INC ,DCH_LUNCH,26,0,0,0,0,119822,0,0,119822,4608.5385
SAN DIEGO,Jan 2015,DCH,2015,CHILD DEVELOPMENT ASSOC INC ,DCH_LUNCH,,0,0,0,0,0,238,11216,11454,0
SAN DIEGO,Jan 2015,DCH,2015,CHILD DEVELOPMENT ASSOC INC ,DCH_LUNCH,26,0,0,0,0,0,0,0,0,0
SAN DIEGO,Jan 2015,DCH,2015,CHILD DEVELOPMENT ASSOC INC ,DCH_LUNCH,24,0,0,0,0,0,0,0,0,0
SAN DIEGO,Jan 2015,DCH,2015,CHILD DEVELOPMENT ASSOC INC ,DCH_SNACK_AM,26,0,0,0,0,53798,0,0,53798,2069.1538
SAN DIEGO,Jan 2015,DCH,2015,CHILD DEVELOPMENT ASSOC INC ,DCH_SNACK_AM,,0,0,0,0,0,175,5888,6063,0
SAN DIEGO,Jan 2015,DCH,2015,CHILD DEVELOPMENT ASSOC INC ,DCH_SNACK_AM,26,0,0,0,0,0,0,0,0,0
SAN DIEGO,Jan 2015,DCH,2015,CHILD DEVELOPMENT ASSOC INC ,DCH_SNACK_AM,24,0,0,0,0,0,0,0,0,0
SAN DIEGO,Jan 2015,DCH,2015,CHILD DEVELOPMENT ASSOC INC ,DCH_SNACK_NT,26,0,0,0,0,10516,0,0,10516,404.4615
SAN DIEGO,Jan 2015,DCH,2015,CHILD DEVELOPMENT ASSOC INC ,DCH_SNACK_NT,,0,0,0,0,0,10,189,199,0
SAN DIEGO,Jan 2015,DCH,2015,CHILD DEVELOPMENT ASSOC INC ,DCH_SNACK_NT,26,0,0,0,0,0,0,0,0,0
SAN DIEGO,Jan 2015,DCH,2015,CHILD DEVELOPMENT ASSOC INC ,DCH_SNACK_NT,24,0,0,0,0,0,0,0,0,0
SAN DIEGO,Jan 2015,DCH,2015,CHILD DEVELOPMENT ASSOC INC ,DCH_SNACK_PM,26,0,0,0,0,109609,0,0,109609,4215.7308
SAN DIEGO,Jan 2015,DCH,2015,CHILD DEVELOPMENT ASSOC INC ,DCH_SNACK_PM,,0,0,0,0,0,260,7753,8013,0
SAN DIEGO,Jan 2015,DCH,2015,CHILD DEVELOPMENT ASSOC INC ,DCH_SNACK_PM,26,0,0,0,0,0,0,0,0,0
SAN DIEGO,Jan 2015,DCH,2015,CHILD DEVELOPMENT ASSOC INC ,DCH_SNACK_PM,24,0,0,0,0,0,0,0,0,0
SAN DIEGO,Jan 2015,DCH,2015,CHILD DEVELOPMENT ASSOC INC ,DCH_SUPPER,26,0,0,0,0,82946,0,0,82946,3190.2308
SAN DIEGO,Jan 2015,DCH,2015,CHILD DEVELOPMENT ASSOC INC ,DCH_SUPPER,,0,0,0,0,0,243,4732,4975,0
SAN DIEGO,Jan 2015,DCH,2015,CHILD DEVELOPMENT ASSOC INC ,DCH_SUPPER,26,0,0,0,0,0,0,0,0,0
SAN DIEGO,Jan 2015,DCH,2015,CHILD DEVELOPMENT ASSOC INC ,DCH_SUPPER,24,0,0,0,0,0,0,0,0,0
SAN DIEGO,Feb 2015,CACF,2015,CHILD DEVELOPMENT ASSOC INC ,CHILD_BREAKFAST,19,286,90,57,433,2862,901,570,4333,228.0526
SAN DIEGO,Feb 2015,CACF,2015,CHILD DEVELOPMENT ASSOC INC ,CHILD_LUNCH,19,286,90,57,433,3783,1191,753,5727,301.4211
SAN DIEGO,Feb 2015,CACF,2015,CHILD DEVELOPMENT ASSOC INC ,CHILD_SNACK_AM,19,286,90,57,433,137,43,28,208,10.9474
SAN DIEGO,Feb 2015,CACF,2015,CHILD DEVELOPMENT ASSOC INC ,CHILD_SNACK_PM,19,286,90,57,433,3308,1041,659,5008,263.5789
SAN DIEGO,Feb 2015,DCH,2015,CHILD DEVELOPMENT ASSOC INC ,DCH_BREAKFAST,24,0,0,0,0,96107,0,0,96107,4004.4583
SAN DIEGO,Feb 2015,DCH,2015,CHILD DEVELOPMENT ASSOC INC ,DCH_BREAKFAST,,0,0,0,0,0,189,6211,6400,0
SAN DIEGO,Feb 2015,DCH,2015,CHILD DEVELOPMENT ASSOC INC ,DCH_BREAKFAST,24,0,0,0,0,0,0,0,0,0
SAN DIEGO,Feb 2015,DCH,2015,CHILD DEVELOPMENT ASSOC INC ,DCH_BREAKFAST,21,0,0,0,0,0,0,0,0,0
SAN DIEGO,Feb 2015,DCH,2015,CHILD DEVELOPMENT ASSOC INC ,DCH_LUNCH,24,0,0,0,0,112074,0,0,112074,4669.75
SAN DIEGO,Feb 2015,DCH,2015,CHILD DEVELOPMENT ASSOC INC ,DCH_LUNCH,,0,0,0,0,0,212,10796,11008,0
SAN DIEGO,Feb 2015,DCH,2015,CHILD DEVELOPMENT ASSOC INC ,DCH_LUNCH,24,0,0,0,0,0,0,0,0,0
SAN DIEGO,Feb 2015,DCH,2015,CHILD DEVELOPMENT ASSOC INC ,DCH_LUNCH,21,0,0,0,0,0,0,0,0,0
SAN DIEGO,Feb 2015,DCH,2015,CHILD DEVELOPMENT ASSOC INC ,DCH_SNACK_AM,24,0,0,0,0,50123,0,0,50123,2088.4583
SAN DIEGO,Feb 2015,DCH,2015,CHILD DEVELOPMENT ASSOC INC ,DCH_SNACK_AM,,0,0,0,0,0,136,5700,5836,0
SAN DIEGO,Feb 2015,DCH,2015,CHILD DEVELOPMENT ASSOC INC ,DCH_SNACK_AM,24,0,0,0,0,0,0,0,0,0
SAN DIEGO,Feb 2015,DCH,2015,CHILD DEVELOPMENT ASSOC INC ,DCH_SNACK_AM,21,0,0,0,0,0,0,0,0,0
SAN DIEGO,Feb 2015,DCH,2015,CHILD DEVELOPMENT ASSOC INC ,DCH_SNACK_NT,24,0,0,0,0,10226,0,0,10226,426.0833
SAN DIEGO,Feb 2015,DCH,2015,CHILD DEVELOPMENT ASSOC INC ,DCH_SNACK_NT,,0,0,0,0,0,0,169,169,0
SAN DIEGO,Feb 2015,DCH,2015,CHILD DEVELOPMENT ASSOC INC ,DCH_SNACK_NT,24,0,0,0,0,0,0,0,0,0
SAN DIEGO,Feb 2015,DCH,2015,CHILD DEVELOPMENT ASSOC INC ,DCH_SNACK_NT,21,0,0,0,0,0,0,0,0,0
SAN DIEGO,Feb 2015,DCH,2015,CHILD DEVELOPMENT ASSOC INC ,DCH_SNACK_PM,24,0,0,0,0,106942,0,0,106942,4455.9167
SAN DIEGO,Feb 2015,DCH,2015,CHILD DEVELOPMENT ASSOC INC ,DCH_SNACK_PM,,0,0,0,0,0,229,7643,7872,0
SAN DIEGO,Feb 2015,DCH,2015,CHILD DEVELOPMENT ASSOC INC ,DCH_SNACK_PM,24,0,0,0,0,0,0,0,0,0
SAN DIEGO,Feb 2015,DCH,2015,CHILD DEVELOPMENT ASSOC INC ,DCH_SNACK_PM,21,0,0,0,0,0,0,0,0,0
SAN DIEGO,Feb 2015,DCH,2015,CHILD DEVELOPMENT ASSOC INC ,DCH_SUPPER,24,0,0,0,0,79667,0,0,79667,3319.4583
SAN DIEGO,Feb 2015,DCH,2015,CHILD DEVELOPMENT ASSOC INC ,DCH_SUPPER,,0,0,0,0,0,195,4466,4661,0
SAN DIEGO,Feb 2015,DCH,2015,CHILD DEVELOPMENT ASSOC INC ,DCH_SUPPER,24,0,0,0,0,0,0,0,0,0
SAN DIEGO,Feb 2015,DCH,2015,CHILD DEVELOPMENT ASSOC INC ,DCH_SUPPER,21,0,0,0,0,0,0,0,0,0
SAN DIEGO,Mar 2015,CACF,2015,CHILD DEVELOPMENT ASSOC INC ,CHILD_BREAKFAST,22,286,90,57,433,3207,1009,639,4855,220.6818
SAN DIEGO,Mar 2015,CACF,2015,CHILD DEVELOPMENT ASSOC INC ,CHILD_LUNCH,22,286,90,57,433,4299,1353,856,6508,295.8182
SAN DIEGO,Mar 2015,CACF,2015,CHILD DEVELOPMENT ASSOC INC ,CHILD_SNACK_AM,22,286,90,57,433,155,49,30,234,10.6364
SAN DIEGO,Mar 2015,CACF,2015,CHILD DEVELOPMENT ASSOC INC ,CHILD_SNACK_PM,22,286,90,57,433,3751,1181,747,5679,258.1364
SAN DIEGO,Mar 2015,DCH,2015,CHILD DEVELOPMENT ASSOC INC ,DCH_BREAKFAST,26,0,0,0,0,108497,0,0,108497,4172.9615
SAN DIEGO,Mar 2015,DCH,2015,CHILD DEVELOPMENT ASSOC INC ,DCH_BREAKFAST,,0,0,0,0,0,191,7365,7556,0
SAN DIEGO,Mar 2015,DCH,2015,CHILD DEVELOPMENT ASSOC INC ,DCH_BREAKFAST,26,0,0,0,0,0,0,0,0,0
SAN DIEGO,Mar 2015,DCH,2015,CHILD DEVELOPMENT ASSOC INC ,DCH_BREAKFAST,25,0,0,0,0,0,0,0,0,0
SAN DIEGO,Mar 2015,DCH,2015,CHILD DEVELOPMENT ASSOC INC ,DCH_LUNCH,26,0,0,0,0,131028,0,0,131028,5039.5385
SAN DIEGO,Mar 2015,DCH,2015,CHILD DEVELOPMENT ASSOC INC ,DCH_LUNCH,,0,0,0,0,0,209,12889,13098,0
SAN DIEGO,Mar 2015,DCH,2015,CHILD DEVELOPMENT ASSOC INC ,DCH_LUNCH,26,0,0,0,0,0,0,0,0,0
SAN DIEGO,Mar 2015,DCH,2015,CHILD DEVELOPMENT ASSOC INC ,DCH_LUNCH,25,0,0,0,0,0,0,0,0,0
SAN DIEGO,Mar 2015,DCH,2015,CHILD DEVELOPMENT ASSOC INC ,DCH_SNACK_AM,26,0,0,0,0,58580,0,0,58580,2253.0769
SAN DIEGO,Mar 2015,DCH,2015,CHILD DEVELOPMENT ASSOC INC ,DCH_SNACK_AM,,0,0,0,0,0,142,7136,7278,0
SAN DIEGO,Mar 2015,DCH,2015,CHILD DEVELOPMENT ASSOC INC ,DCH_SNACK_AM,26,0,0,0,0,0,0,0,0,0
SAN DIEGO,Mar 2015,DCH,2015,CHILD DEVELOPMENT ASSOC INC ,DCH_SNACK_AM,25,0,0,0,0,0,0,0,0,0
SAN DIEGO,Mar 2015,DCH,2015,CHILD DEVELOPMENT ASSOC INC ,DCH_SNACK_NT,26,0,0,0,0,11163,0,0,11163,429.3462
SAN DIEGO,Mar 2015,DCH,2015,CHILD DEVELOPMENT ASSOC INC ,DCH_SNACK_NT,,0,0,0,0,0,8,252,260,0
SAN DIEGO,Mar 2015,DCH,2015,CHILD DEVELOPMENT ASSOC INC ,DCH_SNACK_NT,26,0,0,0,0,0,0,0,0,0
SAN DIEGO,Mar 2015,DCH,2015,CHILD DEVELOPMENT ASSOC INC ,DCH_SNACK_NT,25,0,0,0,0,0,0,0,0,0
SAN DIEGO,Mar 2015,DCH,2015,CHILD DEVELOPMENT ASSOC INC ,DCH_SNACK_PM,26,0,0,0,0,121308,0,0,121308,4665.6923
SAN DIEGO,Mar 2015,DCH,2015,CHILD DEVELOPMENT ASSOC INC ,DCH_SNACK_PM,,0,0,0,0,0,172,8561,8733,0
SAN DIEGO,Mar 2015,DCH,2015,CHILD DEVELOPMENT ASSOC INC ,DCH_SNACK_PM,26,0,0,0,0,0,0,0,0,0
SAN DIEGO,Mar 2015,DCH,2015,CHILD DEVELOPMENT ASSOC INC ,DCH_SNACK_PM,25,0,0,0,0,0,0,0,0,0
SAN DIEGO,Mar 2015,DCH,2015,CHILD DEVELOPMENT ASSOC INC ,DCH_SUPPER,26,0,0,0,0,88757,0,0,88757,3413.7308
SAN DIEGO,Mar 2015,DCH,2015,CHILD DEVELOPMENT ASSOC INC ,DCH_SUPPER,,0,0,0,0,0,187,5332,5519,0
SAN DIEGO,Mar 2015,DCH,2015,CHILD DEVELOPMENT ASSOC INC ,DCH_SUPPER,26,0,0,0,0,0,0,0,0,0
SAN DIEGO,Mar 2015,DCH,2015,CHILD DEVELOPMENT ASSOC INC ,DCH_SUPPER,25,0,0,0,0,0,0,0,0,0
SAN DIEGO,Apr 2015,CACF,2015,CHILD DEVELOPMENT ASSOC INC ,CHILD_BREAKFAST,22,286,90,57,433,3277,1032,653,4962,225.5455
SAN DIEGO,Apr 2015,CACF,2015,CHILD DEVELOPMENT ASSOC INC ,CHILD_LUNCH,22,286,90,57,433,4386,1380,874,6640,301.8182
SAN DIEGO,Apr 2015,CACF,2015,CHILD DEVELOPMENT ASSOC INC ,CHILD_SNACK_AM,22,286,90,57,433,147,46,29,222,10.0909
SAN DIEGO,Apr 2015,CACF,2015,CHILD DEVELOPMENT ASSOC INC ,CHILD_SNACK_PM,22,286,90,57,433,3800,1196,757,5753,261.5
SAN DIEGO,Apr 2015,DCH,2015,CHILD DEVELOPMENT ASSOC INC ,DCH_BREAKFAST,26,0,0,0,0,105015,0,0,105015,4039.0385
SAN DIEGO,Apr 2015,DCH,2015,CHILD DEVELOPMENT ASSOC INC ,DCH_BREAKFAST,,0,0,0,0,0,395,7224,7619,0
SAN DIEGO,Apr 2015,DCH,2015,CHILD DEVELOPMENT ASSOC INC ,DCH_BREAKFAST,26,0,0,0,0,0,0,0,0,0
SAN DIEGO,Apr 2015,DCH,2015,CHILD DEVELOPMENT ASSOC INC ,DCH_BREAKFAST,26,0,0,0,0,0,0,0,0,0
SAN DIEGO,Apr 2015,DCH,2015,CHILD DEVELOPMENT ASSOC INC ,DCH_BREAKFAST,24,0,0,0,0,0,0,0,0,0
SAN DIEGO,Apr 2015,DCH,2015,CHILD DEVELOPMENT ASSOC INC ,DCH_LUNCH,26,0,0,0,0,131516,0,0,131516,5058.3077
SAN DIEGO,Apr 2015,DCH,2015,CHILD DEVELOPMENT ASSOC INC ,DCH_LUNCH,,0,0,0,0,0,618,12838,13456,0
SAN DIEGO,Apr 2015,DCH,2015,CHILD DEVELOPMENT ASSOC INC ,DCH_LUNCH,26,0,0,0,0,0,0,0,0,0
SAN DIEGO,Apr 2015,DCH,2015,CHILD DEVELOPMENT ASSOC INC ,DCH_LUNCH,26,0,0,0,0,0,0,0,0,0
SAN DIEGO,Apr 2015,DCH,2015,CHILD DEVELOPMENT ASSOC INC ,DCH_LUNCH,24,0,0,0,0,0,0,0,0,0
SAN DIEGO,Apr 2015,DCH,2015,CHILD DEVELOPMENT ASSOC INC ,DCH_SNACK_AM,26,0,0,0,0,58488,0,0,58488,2249.5385
SAN DIEGO,Apr 2015,DCH,2015,CHILD DEVELOPMENT ASSOC INC ,DCH_SNACK_AM,,0,0,0,0,0,349,7042,7391,0
SAN DIEGO,Apr 2015,DCH,2015,CHILD DEVELOPMENT ASSOC INC ,DCH_SNACK_AM,26,0,0,0,0,0,0,0,0,0
SAN DIEGO,Apr 2015,DCH,2015,CHILD DEVELOPMENT ASSOC INC ,DCH_SNACK_AM,26,0,0,0,0,0,0,0,0,0
SAN DIEGO,Apr 2015,DCH,2015,CHILD DEVELOPMENT ASSOC INC ,DCH_SNACK_AM,24,0,0,0,0,0,0,0,0,0
SAN DIEGO,Apr 2015,DCH,2015,CHILD DEVELOPMENT ASSOC INC ,DCH_SNACK_NT,26,0,0,0,0,10606,0,0,10606,407.9231
SAN DIEGO,Apr 2015,DCH,2015,CHILD DEVELOPMENT ASSOC INC ,DCH_SNACK_NT,,0,0,0,0,0,209,209,418,0
SAN DIEGO,Apr 2015,DCH,2015,CHILD DEVELOPMENT ASSOC INC ,DCH_SNACK_NT,26,0,0,0,0,0,0,0,0,0
SAN DIEGO,Apr 2015,DCH,2015,CHILD DEVELOPMENT ASSOC INC ,DCH_SNACK_NT,26,0,0,0,0,0,0,0,0,0
SAN DIEGO,Apr 2015,DCH,2015,CHILD DEVELOPMENT ASSOC INC ,DCH_SNACK_NT,24,0,0,0,0,0,0,0,0,0
SAN DIEGO,Apr 2015,DCH,2015,CHILD DEVELOPMENT ASSOC INC ,DCH_SNACK_PM,26,0,0,0,0,117301,0,0,117301,4511.5769
SAN DIEGO,Apr 2015,DCH,2015,CHILD DEVELOPMENT ASSOC INC ,DCH_SNACK_PM,,0,0,0,0,0,676,8174,8850,0
SAN DIEGO,Apr 2015,DCH,2015,CHILD DEVELOPMENT ASSOC INC ,DCH_SNACK_PM,26,0,0,0,0,0,0,0,0,0
SAN DIEGO,Apr 2015,DCH,2015,CHILD DEVELOPMENT ASSOC INC ,DCH_SNACK_PM,26,0,0,0,0,0,0,0,0,0
SAN DIEGO,Apr 2015,DCH,2015,CHILD DEVELOPMENT ASSOC INC ,DCH_SNACK_PM,24,0,0,0,0,0,0,0,0,0
SAN DIEGO,Apr 2015,DCH,2015,CHILD DEVELOPMENT ASSOC INC ,DCH_SUPPER,26,0,0,0,0,86208,0,0,86208,3315.6923
SAN DIEGO,Apr 2015,DCH,2015,CHILD DEVELOPMENT ASSOC INC ,DCH_SUPPER,,0,0,0,0,0,626,5142,5768,0
SAN DIEGO,Apr 2015,DCH,2015,CHILD DEVELOPMENT ASSOC INC ,DCH_SUPPER,26,0,0,0,0,0,0,0,0,0
SAN DIEGO,Apr 2015,DCH,2015,CHILD DEVELOPMENT ASSOC INC ,DCH_SUPPER,26,0,0,0,0,0,0,0,0,0
SAN DIEGO,Apr 2015,DCH,2015,CHILD DEVELOPMENT ASSOC INC ,DCH_SUPPER,24,0,0,0,0,0,0,0,0,0
SAN DIEGO,May 2015,CACF,2015,CHILD DEVELOPMENT ASSOC INC ,CHILD_BREAKFAST,20,286,90,57,433,3110,979,619,4708,235.4
SAN DIEGO,May 2015,CACF,2015,CHILD DEVELOPMENT ASSOC INC ,CHILD_LUNCH,20,286,90,57,433,4173,1314,831,6318,315.9
SAN DIEGO,May 2015,CACF,2015,CHILD DEVELOPMENT ASSOC INC ,CHILD_SNACK_AM,20,286,90,57,433,141,44,29,214,10.7
SAN DIEGO,May 2015,CACF,2015,CHILD DEVELOPMENT ASSOC INC ,CHILD_SNACK_PM,20,286,90,57,433,3628,1142,723,5493,274.65
SAN DIEGO,May 2015,DCH,2015,CHILD DEVELOPMENT ASSOC INC ,DCH_BREAKFAST,25,0,0,0,0,97838,0,0,97838,3913.52
SAN DIEGO,May 2015,DCH,2015,CHILD DEVELOPMENT ASSOC INC ,DCH_BREAKFAST,,0,0,0,0,0,1442,6711,8153,0
SAN DIEGO,May 2015,DCH,2015,CHILD DEVELOPMENT ASSOC INC ,DCH_BREAKFAST,25,0,0,0,0,0,0,0,0,0
SAN DIEGO,May 2015,DCH,2015,CHILD DEVELOPMENT ASSOC INC ,DCH_BREAKFAST,25,0,0,0,0,0,0,0,0,0
SAN DIEGO,May 2015,DCH,2015,CHILD DEVELOPMENT ASSOC INC ,DCH_BREAKFAST,22,0,0,0,0,0,0,0,0,0
SAN DIEGO,May 2015,DCH,2015,CHILD DEVELOPMENT ASSOC INC ,DCH_LUNCH,25,0,0,0,0,115116,0,0,115116,4604.64
SAN DIEGO,May 2015,DCH,2015,CHILD DEVELOPMENT ASSOC INC ,DCH_LUNCH,,0,0,0,0,0,2212,11924,14136,0
SAN DIEGO,May 2015,DCH,2015,CHILD DEVELOPMENT ASSOC INC ,DCH_LUNCH,25,0,0,0,0,0,0,0,0,0
SAN DIEGO,May 2015,DCH,2015,CHILD DEVELOPMENT ASSOC INC ,DCH_LUNCH,25,0,0,0,0,0,0,0,0,0
SAN DIEGO,May 2015,DCH,2015,CHILD DEVELOPMENT ASSOC INC ,DCH_LUNCH,22,0,0,0,0,0,0,0,0,0
SAN DIEGO,May 2015,DCH,2015,CHILD DEVELOPMENT ASSOC INC ,DCH_SNACK_AM,25,0,0,0,0,51407,0,0,51407,2056.28
SAN DIEGO,May 2015,DCH,2015,CHILD DEVELOPMENT ASSOC INC ,DCH_SNACK_AM,,0,0,0,0,0,1052,6763,7815,0
SAN DIEGO,May 2015,DCH,2015,CHILD DEVELOPMENT ASSOC INC ,DCH_SNACK_AM,25,0,0,0,0,0,0,0,0,0
SAN DIEGO,May 2015,DCH,2015,CHILD DEVELOPMENT ASSOC INC ,DCH_SNACK_AM,25,0,0,0,0,0,0,0,0,0
SAN DIEGO,May 2015,DCH,2015,CHILD DEVELOPMENT ASSOC INC ,DCH_SNACK_AM,22,0,0,0,0,0,0,0,0,0
SAN DIEGO,May 2015,DCH,2015,CHILD DEVELOPMENT ASSOC INC ,DCH_SNACK_NT,25,0,0,0,0,10652,0,0,10652,426.08
SAN DIEGO,May 2015,DCH,2015,CHILD DEVELOPMENT ASSOC INC ,DCH_SNACK_NT,,0,0,0,0,0,260,207,467,0
SAN DIEGO,May 2015,DCH,2015,CHILD DEVELOPMENT ASSOC INC ,DCH_SNACK_NT,25,0,0,0,0,0,0,0,0,0
SAN DIEGO,May 2015,DCH,2015,CHILD DEVELOPMENT ASSOC INC ,DCH_SNACK_NT,25,0,0,0,0,0,0,0,0,0
SAN DIEGO,May 2015,DCH,2015,CHILD DEVELOPMENT ASSOC INC ,DCH_SNACK_NT,22,0,0,0,0,0,0,0,0,0
SAN DIEGO,May 2015,DCH,2015,CHILD DEVELOPMENT ASSOC INC ,DCH_SNACK_PM,25,0,0,0,0,109728,0,0,109728,4389.12
SAN DIEGO,May 2015,DCH,2015,CHILD DEVELOPMENT ASSOC INC ,DCH_SNACK_PM,,0,0,0,0,0,1769,7402,9171,0
SAN DIEGO,May 2015,DCH,2015,CHILD DEVELOPMENT ASSOC INC ,DCH_SNACK_PM,25,0,0,0,0,0,0,0,0,0
SAN DIEGO,May 2015,DCH,2015,CHILD DEVELOPMENT ASSOC INC ,DCH_SNACK_PM,25,0,0,0,0,0,0,0,0,0
SAN DIEGO,May 2015,DCH,2015,CHILD DEVELOPMENT ASSOC INC ,DCH_SNACK_PM,22,0,0,0,0,0,0,0,0,0
SAN DIEGO,May 2015,DCH,2015,CHILD DEVELOPMENT ASSOC INC ,DCH_SUPPER,25,0,0,0,0,79647,0,0,79647,3185.88
SAN DIEGO,May 2015,DCH,2015,CHILD DEVELOPMENT ASSOC INC ,DCH_SUPPER,,0,0,0,0,0,2262,4800,7062,0
SAN DIEGO,May 2015,DCH,2015,CHILD DEVELOPMENT ASSOC INC ,DCH_SUPPER,25,0,0,0,0,0,0,0,0,0
SAN DIEGO,May 2015,DCH,2015,CHILD DEVELOPMENT ASSOC INC ,DCH_SUPPER,25,0,0,0,0,0,0,0,0,0
SAN DIEGO,May 2015,DCH,2015,CHILD DEVELOPMENT ASSOC INC ,DCH_SUPPER,22,0,0,0,0,0,0,0,0,0
SAN DIEGO,Jun 2015,CACF,2015,CHILD DEVELOPMENT ASSOC INC ,CHILD_BREAKFAST,22,286,90,57,433,2962,932,590,4484,203.8182
SAN DIEGO,Jun 2015,CACF,2015,CHILD DEVELOPMENT ASSOC INC ,CHILD_LUNCH,22,286,90,57,433,4048,1274,807,6129,278.5909
SAN DIEGO,Jun 2015,CACF,2015,CHILD DEVELOPMENT ASSOC INC ,CHILD_SNACK_AM,22,286,90,57,433,130,41,26,197,8.9545
SAN DIEGO,Jun 2015,CACF,2015,CHILD DEVELOPMENT ASSOC INC ,CHILD_SNACK_PM,22,286,90,57,433,3574,1125,712,5411,245.9545
SAN DIEGO,Jun 2015,DCH,2015,CHILD DEVELOPMENT ASSOC INC ,DCH_BREAKFAST,26,0,0,0,0,98689,0,0,98689,3795.7308
SAN DIEGO,Jun 2015,DCH,2015,CHILD DEVELOPMENT ASSOC INC ,DCH_BREAKFAST,,0,0,0,0,0,2727,7240,9967,0
SAN DIEGO,Jun 2015,DCH,2015,CHILD DEVELOPMENT ASSOC INC ,DCH_BREAKFAST,26,0,0,0,0,0,0,0,0,0
SAN DIEGO,Jun 2015,DCH,2015,CHILD DEVELOPMENT ASSOC INC ,DCH_BREAKFAST,26,0,0,0,0,0,0,0,0,0
SAN DIEGO,Jun 2015,DCH,2015,CHILD DEVELOPMENT ASSOC INC ,DCH_BREAKFAST,23,0,0,0,0,0,0,0,0,0
SAN DIEGO,Jun 2015,DCH,2015,CHILD DEVELOPMENT ASSOC INC ,DCH_LUNCH,26,0,0,0,0,145203,0,0,145203,5584.7308
SAN DIEGO,Jun 2015,DCH,2015,CHILD DEVELOPMENT ASSOC INC ,DCH_LUNCH,,0,0,0,0,0,4029,13161,17190,0
SAN DIEGO,Jun 2015,DCH,2015,CHILD DEVELOPMENT ASSOC INC ,DCH_LUNCH,26,0,0,0,0,0,0,0,0,0
SAN DIEGO,Jun 2015,DCH,2015,CHILD DEVELOPMENT ASSOC INC ,DCH_LUNCH,26,0,0,0,0,0,0,0,0,0
SAN DIEGO,Jun 2015,DCH,2015,CHILD DEVELOPMENT ASSOC INC ,DCH_LUNCH,23,0,0,0,0,0,0,0,0,0
SAN DIEGO,Jun 2015,DCH,2015,CHILD DEVELOPMENT ASSOC INC ,DCH_SNACK_AM,26,0,0,0,0,62847,0,0,62847,2417.1923
SAN DIEGO,Jun 2015,DCH,2015,CHILD DEVELOPMENT ASSOC INC ,DCH_SNACK_AM,,0,0,0,0,0,2328,7303,9631,0
SAN DIEGO,Jun 2015,DCH,2015,CHILD DEVELOPMENT ASSOC INC ,DCH_SNACK_AM,26,0,0,0,0,0,0,0,0,0
SAN DIEGO,Jun 2015,DCH,2015,CHILD DEVELOPMENT ASSOC INC ,DCH_SNACK_AM,26,0,0,0,0,0,0,0,0,0
SAN DIEGO,Jun 2015,DCH,2015,CHILD DEVELOPMENT ASSOC INC ,DCH_SNACK_AM,23,0,0,0,0,0,0,0,0,0
SAN DIEGO,Jun 2015,DCH,2015,CHILD DEVELOPMENT ASSOC INC ,DCH_SNACK_NT,26,0,0,0,0,9533,0,0,9533,366.6538
SAN DIEGO,Jun 2015,DCH,2015,CHILD DEVELOPMENT ASSOC INC ,DCH_SNACK_NT,,0,0,0,0,0,168,85,253,0
SAN DIEGO,Jun 2015,DCH,2015,CHILD DEVELOPMENT ASSOC INC ,DCH_SNACK_NT,26,0,0,0,0,0,0,0,0,0
SAN DIEGO,Jun 2015,DCH,2015,CHILD DEVELOPMENT ASSOC INC ,DCH_SNACK_NT,26,0,0,0,0,0,0,0,0,0
SAN DIEGO,Jun 2015,DCH,2015,CHILD DEVELOPMENT ASSOC INC ,DCH_SNACK_NT,23,0,0,0,0,0,0,0,0,0
SAN DIEGO,Jun 2015,DCH,2015,CHILD DEVELOPMENT ASSOC INC ,DCH_SNACK_PM,26,0,0,0,0,112079,0,0,112079,4310.7308
SAN DIEGO,Jun 2015,DCH,2015,CHILD DEVELOPMENT ASSOC INC ,DCH_SNACK_PM,,0,0,0,0,0,2510,7709,10219,0
SAN DIEGO,Jun 2015,DCH,2015,CHILD DEVELOPMENT ASSOC INC ,DCH_SNACK_PM,26,0,0,0,0,0,0,0,0,0
SAN DIEGO,Jun 2015,DCH,2015,CHILD DEVELOPMENT ASSOC INC ,DCH_SNACK_PM,26,0,0,0,0,0,0,0,0,0
SAN DIEGO,Jun 2015,DCH,2015,CHILD DEVELOPMENT ASSOC INC ,DCH_SNACK_PM,23,0,0,0,0,0,0,0,0,0
SAN DIEGO,Jun 2015,DCH,2015,CHILD DEVELOPMENT ASSOC INC ,DCH_SUPPER,26,0,0,0,0,81285,0,0,81285,3126.3462
SAN DIEGO,Jun 2015,DCH,2015,CHILD DEVELOPMENT ASSOC INC ,DCH_SUPPER,,0,0,0,0,0,2217,4931,7148,0
SAN DIEGO,Jun 2015,DCH,2015,CHILD DEVELOPMENT ASSOC INC ,DCH_SUPPER,26,0,0,0,0,0,0,0,0,0
SAN DIEGO,Jun 2015,DCH,2015,CHILD DEVELOPMENT ASSOC INC ,DCH_SUPPER,26,0,0,0,0,0,0,0,0,0
SAN DIEGO,Jun 2015,DCH,2015,CHILD DEVELOPMENT ASSOC INC ,DCH_SUPPER,23,0,0,0,0,0,0,0,0,0
SAN DIEGO,Jul 2015,CACF,2015,CHILD DEVELOPMENT ASSOC INC ,CHILD_BREAKFAST,22,286,90,57,433,1621,510,323,2454,111.5455
SAN DIEGO,Jul 2015,CACF,2015,CHILD DEVELOPMENT ASSOC INC ,CHILD_LUNCH,22,286,90,57,433,2144,675,427,3246,147.5455
SAN DIEGO,Jul 2015,CACF,2015,CHILD DEVELOPMENT ASSOC INC ,CHILD_SNACK_PM,22,286,90,57,433,1798,566,358,2722,123.7273
SAN DIEGO,Jul 2015,DCH,2015,CHILD DEVELOPMENT ASSOC INC ,DCH_BREAKFAST,26,0,0,0,0,94955,0,0,94955,3652.1154
SAN DIEGO,Jul 2015,DCH,2015,CHILD DEVELOPMENT ASSOC INC ,DCH_BREAKFAST,,0,0,0,0,0,394,5964,6358,0
SAN DIEGO,Jul 2015,DCH,2015,CHILD DEVELOPMENT ASSOC INC ,DCH_BREAKFAST,23,0,0,0,0,0,0,0,0,0
SAN DIEGO,Jul 2015,DCH,2015,CHILD DEVELOPMENT ASSOC INC ,DCH_BREAKFAST,26,0,0,0,0,0,0,0,0,0
SAN DIEGO,Jul 2015,DCH,2015,CHILD DEVELOPMENT ASSOC INC ,DCH_BREAKFAST,23,0,0,0,0,0,0,0,0,0
SAN DIEGO,Jul 2015,DCH,2015,CHILD DEVELOPMENT ASSOC INC ,DCH_LUNCH,26,0,0,0,0,157675,0,0,157675,6064.4231
SAN DIEGO,Jul 2015,DCH,2015,CHILD DEVELOPMENT ASSOC INC ,DCH_LUNCH,,0,0,0,0,0,465,11509,11974,0
SAN DIEGO,Jul 2015,DCH,2015,CHILD DEVELOPMENT ASSOC INC ,DCH_LUNCH,23,0,0,0,0,0,0,0,0,0
SAN DIEGO,Jul 2015,DCH,2015,CHILD DEVELOPMENT ASSOC INC ,DCH_LUNCH,26,0,0,0,0,0,0,0,0,0
SAN DIEGO,Jul 2015,DCH,2015,CHILD DEVELOPMENT ASSOC INC ,DCH_LUNCH,23,0,0,0,0,0,0,0,0,0
SAN DIEGO,Jul 2015,DCH,2015,CHILD DEVELOPMENT ASSOC INC ,DCH_SNACK_AM,26,0,0,0,0,68736,0,0,68736,2643.6923
SAN DIEGO,Jul 2015,DCH,2015,CHILD DEVELOPMENT ASSOC INC ,DCH_SNACK_AM,,0,0,0,0,0,466,6231,6697,0
SAN DIEGO,Jul 2015,DCH,2015,CHILD DEVELOPMENT ASSOC INC ,DCH_SNACK_AM,23,0,0,0,0,0,0,0,0,0
SAN DIEGO,Jul 2015,DCH,2015,CHILD DEVELOPMENT ASSOC INC ,DCH_SNACK_AM,26,0,0,0,0,0,0,0,0,0
SAN DIEGO,Jul 2015,DCH,2015,CHILD DEVELOPMENT ASSOC INC ,DCH_SNACK_AM,23,0,0,0,0,0,0,0,0,0
SAN DIEGO,Jul 2015,DCH,2015,CHILD DEVELOPMENT ASSOC INC ,DCH_SNACK_NT,26,0,0,0,0,8601,0,0,8601,330.8077
SAN DIEGO,Jul 2015,DCH,2015,CHILD DEVELOPMENT ASSOC INC ,DCH_SNACK_NT,,0,0,0,0,0,0,87,87,0
SAN DIEGO,Jul 2015,DCH,2015,CHILD DEVELOPMENT ASSOC INC ,DCH_SNACK_NT,23,0,0,0,0,0,0,0,0,0
SAN DIEGO,Jul 2015,DCH,2015,CHILD DEVELOPMENT ASSOC INC ,DCH_SNACK_NT,26,0,0,0,0,0,0,0,0,0
SAN DIEGO,Jul 2015,DCH,2015,CHILD DEVELOPMENT ASSOC INC ,DCH_SNACK_NT,23,0,0,0,0,0,0,0,0,0
SAN DIEGO,Jul 2015,DCH,2015,CHILD DEVELOPMENT ASSOC INC ,DCH_SNACK_PM,26,0,0,0,0,110200,0,0,110200,4238.4615
SAN DIEGO,Jul 2015,DCH,2015,CHILD DEVELOPMENT ASSOC INC ,DCH_SNACK_PM,,0,0,0,0,0,206,6640,6846,0
SAN DIEGO,Jul 2015,DCH,2015,CHILD DEVELOPMENT ASSOC INC ,DCH_SNACK_PM,23,0,0,0,0,0,0,0,0,0
SAN DIEGO,Jul 2015,DCH,2015,CHILD DEVELOPMENT ASSOC INC ,DCH_SNACK_PM,26,0,0,0,0,0,0,0,0,0
SAN DIEGO,Jul 2015,DCH,2015,CHILD DEVELOPMENT ASSOC INC ,DCH_SNACK_PM,23,0,0,0,0,0,0,0,0,0
SAN DIEGO,Jul 2015,DCH,2015,CHILD DEVELOPMENT ASSOC INC ,DCH_SUPPER,26,0,0,0,0,81668,0,0,81668,3141.0769
SAN DIEGO,Jul 2015,DCH,2015,CHILD DEVELOPMENT ASSOC INC ,DCH_SUPPER,,0,0,0,0,0,165,4277,4442,0
SAN DIEGO,Jul 2015,DCH,2015,CHILD DEVELOPMENT ASSOC INC ,DCH_SUPPER,23,0,0,0,0,0,0,0,0,0
SAN DIEGO,Jul 2015,DCH,2015,CHILD DEVELOPMENT ASSOC INC ,DCH_SUPPER,26,0,0,0,0,0,0,0,0,0
SAN DIEGO,Jul 2015,DCH,2015,CHILD DEVELOPMENT ASSOC INC ,DCH_SUPPER,23,0,0,0,0,0,0,0,0,0
SAN DIEGO,Aug 2015,CACF,2015,CHILD DEVELOPMENT ASSOC INC ,CHILD_BREAKFAST,21,286,90,57,433,1784,562,355,2701,128.619
SAN DIEGO,Aug 2015,CACF,2015,CHILD DEVELOPMENT ASSOC INC ,CHILD_LUNCH,21,286,90,57,433,2311,727,461,3499,166.619
SAN DIEGO,Aug 2015,CACF,2015,CHILD DEVELOPMENT ASSOC INC ,CHILD_SNACK_PM,21,286,90,57,433,1938,610,386,2934,139.7143
SAN DIEGO,Aug 2015,DCH,2015,CHILD DEVELOPMENT ASSOC INC ,DCH_BREAKFAST,26,0,0,0,0,94120,0,0,94120,3620
SAN DIEGO,Aug 2015,DCH,2015,CHILD DEVELOPMENT ASSOC INC ,DCH_BREAKFAST,,0,0,0,0,0,101,6371,6472,0
SAN DIEGO,Aug 2015,DCH,2015,CHILD DEVELOPMENT ASSOC INC ,DCH_BREAKFAST,26,0,0,0,0,0,0,0,0,0
SAN DIEGO,Aug 2015,DCH,2015,CHILD DEVELOPMENT ASSOC INC ,DCH_BREAKFAST,21,0,0,0,0,0,0,0,0,0
SAN DIEGO,Aug 2015,DCH,2015,CHILD DEVELOPMENT ASSOC INC ,DCH_LUNCH,26,0,0,0,0,132592,0,0,132592,5099.6923
SAN DIEGO,Aug 2015,DCH,2015,CHILD DEVELOPMENT ASSOC INC ,DCH_LUNCH,,0,0,0,0,0,83,11818,11901,0
SAN DIEGO,Aug 2015,DCH,2015,CHILD DEVELOPMENT ASSOC INC ,DCH_LUNCH,26,0,0,0,0,0,0,0,0,0
SAN DIEGO,Aug 2015,DCH,2015,CHILD DEVELOPMENT ASSOC INC ,DCH_LUNCH,21,0,0,0,0,0,0,0,0,0
SAN DIEGO,Aug 2015,DCH,2015,CHILD DEVELOPMENT ASSOC INC ,DCH_SNACK_AM,26,0,0,0,0,58257,0,0,58257,2240.6538
SAN DIEGO,Aug 2015,DCH,2015,CHILD DEVELOPMENT ASSOC INC ,DCH_SNACK_AM,,0,0,0,0,0,79,6286,6365,0
SAN DIEGO,Aug 2015,DCH,2015,CHILD DEVELOPMENT ASSOC INC ,DCH_SNACK_AM,26,0,0,0,0,0,0,0,0,0
SAN DIEGO,Aug 2015,DCH,2015,CHILD DEVELOPMENT ASSOC INC ,DCH_SNACK_AM,21,0,0,0,0,0,0,0,0,0
SAN DIEGO,Aug 2015,DCH,2015,CHILD DEVELOPMENT ASSOC INC ,DCH_SNACK_NT,26,0,0,0,0,9148,0,0,9148,351.8462
SAN DIEGO,Aug 2015,DCH,2015,CHILD DEVELOPMENT ASSOC INC ,DCH_SNACK_NT,,0,0,0,0,0,0,36,36,0
SAN DIEGO,Aug 2015,DCH,2015,CHILD DEVELOPMENT ASSOC INC ,DCH_SNACK_NT,26,0,0,0,0,0,0,0,0,0
SAN DIEGO,Aug 2015,DCH,2015,CHILD DEVELOPMENT ASSOC INC ,DCH_SNACK_NT,21,0,0,0,0,0,0,0,0,0
SAN DIEGO,Aug 2015,DCH,2015,CHILD DEVELOPMENT ASSOC INC ,DCH_SNACK_PM,26,0,0,0,0,106829,0,0,106829,4108.8077
SAN DIEGO,Aug 2015,DCH,2015,CHILD DEVELOPMENT ASSOC INC ,DCH_SNACK_PM,,0,0,0,0,0,140,7534,7674,0
SAN DIEGO,Aug 2015,DCH,2015,CHILD DEVELOPMENT ASSOC INC ,DCH_SNACK_PM,26,0,0,0,0,0,0,0,0,0
SAN DIEGO,Aug 2015,DCH,2015,CHILD DEVELOPMENT ASSOC INC ,DCH_SNACK_PM,21,0,0,0,0,0,0,0,0,0
SAN DIEGO,Aug 2015,DCH,2015,CHILD DEVELOPMENT ASSOC INC ,DCH_SUPPER,26,0,0,0,0,79477,0,0,79477,3056.8077
SAN DIEGO,Aug 2015,DCH,2015,CHILD DEVELOPMENT ASSOC INC ,DCH_SUPPER,,0,0,0,0,0,126,4644,4770,0
SAN DIEGO,Aug 2015,DCH,2015,CHILD DEVELOPMENT ASSOC INC ,DCH_SUPPER,26,0,0,0,0,0,0,0,0,0
SAN DIEGO,Aug 2015,DCH,2015,CHILD DEVELOPMENT ASSOC INC ,DCH_SUPPER,21,0,0,0,0,0,0,0,0,0
SAN DIEGO,Sep 2015,CACF,2015,CHILD DEVELOPMENT ASSOC INC ,CHILD_BREAKFAST,21,286,90,57,433,1930,607,385,2922,139.1429
SAN DIEGO,Sep 2015,CACF,2015,CHILD DEVELOPMENT ASSOC INC ,CHILD_LUNCH,21,286,90,57,433,2405,757,479,3641,173.381
SAN DIEGO,Sep 2015,CACF,2015,CHILD DEVELOPMENT ASSOC INC ,CHILD_SNACK_PM,21,286,90,57,433,2006,631,400,3037,144.619
SAN DIEGO,Sep 2015,DCH,2015,CHILD DEVELOPMENT ASSOC INC ,DCH_BREAKFAST,25,0,0,0,0,98826,0,0,98826,3953.04
SAN DIEGO,Sep 2015,DCH,2015,CHILD DEVELOPMENT ASSOC INC ,DCH_BREAKFAST,,0,0,0,0,0,134,6580,6714,0
SAN DIEGO,Sep 2015,DCH,2015,CHILD DEVELOPMENT ASSOC INC ,DCH_BREAKFAST,25,0,0,0,0,0,0,0,0,0
SAN DIEGO,Sep 2015,DCH,2015,CHILD DEVELOPMENT ASSOC INC ,DCH_BREAKFAST,21,0,0,0,0,0,0,0,0,0
SAN DIEGO,Sep 2015,DCH,2015,CHILD DEVELOPMENT ASSOC INC ,DCH_LUNCH,25,0,0,0,0,112307,0,0,112307,4492.28
SAN DIEGO,Sep 2015,DCH,2015,CHILD DEVELOPMENT ASSOC INC ,DCH_LUNCH,,0,0,0,0,0,106,11348,11454,0
SAN DIEGO,Sep 2015,DCH,2015,CHILD DEVELOPMENT ASSOC INC ,DCH_LUNCH,25,0,0,0,0,0,0,0,0,0
SAN DIEGO,Sep 2015,DCH,2015,CHILD DEVELOPMENT ASSOC INC ,DCH_LUNCH,21,0,0,0,0,0,0,0,0,0
SAN DIEGO,Sep 2015,DCH,2015,CHILD DEVELOPMENT ASSOC INC ,DCH_SNACK_AM,25,0,0,0,0,49031,0,0,49031,1961.24
SAN DIEGO,Sep 2015,DCH,2015,CHILD DEVELOPMENT ASSOC INC ,DCH_SNACK_AM,,0,0,0,0,0,78,5912,5990,0
SAN DIEGO,Sep 2015,DCH,2015,CHILD DEVELOPMENT ASSOC INC ,DCH_SNACK_AM,25,0,0,0,0,0,0,0,0,0
SAN DIEGO,Sep 2015,DCH,2015,CHILD DEVELOPMENT ASSOC INC ,DCH_SNACK_AM,21,0,0,0,0,0,0,0,0,0
SAN DIEGO,Sep 2015,DCH,2015,CHILD DEVELOPMENT ASSOC INC ,DCH_SNACK_NT,25,0,0,0,0,11344,0,0,11344,453.76
SAN DIEGO,Sep 2015,DCH,2015,CHILD DEVELOPMENT ASSOC INC ,DCH_SNACK_NT,,0,0,0,0,0,0,296,296,0
SAN DIEGO,Sep 2015,DCH,2015,CHILD DEVELOPMENT ASSOC INC ,DCH_SNACK_NT,25,0,0,0,0,0,0,0,0,0
SAN DIEGO,Sep 2015,DCH,2015,CHILD DEVELOPMENT ASSOC INC ,DCH_SNACK_NT,21,0,0,0,0,0,0,0,0,0
SAN DIEGO,Sep 2015,DCH,2015,CHILD DEVELOPMENT ASSOC INC ,DCH_SNACK_PM,25,0,0,0,0,111605,0,0,111605,4464.2
SAN DIEGO,Sep 2015,DCH,2015,CHILD DEVELOPMENT ASSOC INC ,DCH_SNACK_PM,,0,0,0,0,0,166,8160,8326,0
SAN DIEGO,Sep 2015,DCH,2015,CHILD DEVELOPMENT ASSOC INC ,DCH_SNACK_PM,25,0,0,0,0,0,0,0,0,0
SAN DIEGO,Sep 2015,DCH,2015,CHILD DEVELOPMENT ASSOC INC ,DCH_SNACK_PM,21,0,0,0,0,0,0,0,0,0
SAN DIEGO,Sep 2015,DCH,2015,CHILD DEVELOPMENT ASSOC INC ,DCH_SUPPER,25,0,0,0,0,84292,0,0,84292,3371.68
SAN DIEGO,Sep 2015,DCH,2015,CHILD DEVELOPMENT ASSOC INC ,DCH_SUPPER,,0,0,0,0,0,123,4834,4957,0
SAN DIEGO,Sep 2015,DCH,2015,CHILD DEVELOPMENT ASSOC INC ,DCH_SUPPER,25,0,0,0,0,0,0,0,0,0
SAN DIEGO,Sep 2015,DCH,2015,CHILD DEVELOPMENT ASSOC INC ,DCH_SUPPER,21,0,0,0,0,0,0,0,0,0
SAN DIEGO,Oct 2014,DCH,2015,CHILD NUTRITION PROGRAM OF SOUTHERN CALIFORNIA INC ,DCH_BREAKFAST,23,0,0,0,0,79386,0,0,79386,3451.5652
SAN DIEGO,Oct 2014,DCH,2015,CHILD NUTRITION PROGRAM OF SOUTHERN CALIFORNIA INC ,DCH_BREAKFAST,,0,0,0,0,0,456,17505,17961,0
SAN DIEGO,Oct 2014,DCH,2015,CHILD NUTRITION PROGRAM OF SOUTHERN CALIFORNIA INC ,DCH_BREAKFAST,23,0,0,0,0,0,0,0,0,0
SAN DIEGO,Oct 2014,DCH,2015,CHILD NUTRITION PROGRAM OF SOUTHERN CALIFORNIA INC ,DCH_BREAKFAST,23,0,0,0,0,0,0,0,0,0
SAN DIEGO,Oct 2014,DCH,2015,CHILD NUTRITION PROGRAM OF SOUTHERN CALIFORNIA INC ,DCH_LUNCH,23,0,0,0,0,81795,0,0,81795,3556.3043
SAN DIEGO,Oct 2014,DCH,2015,CHILD NUTRITION PROGRAM OF SOUTHERN CALIFORNIA INC ,DCH_LUNCH,,0,0,0,0,0,597,21858,22455,0
SAN DIEGO,Oct 2014,DCH,2015,CHILD NUTRITION PROGRAM OF SOUTHERN CALIFORNIA INC ,DCH_LUNCH,23,0,0,0,0,0,0,0,0,0
SAN DIEGO,Oct 2014,DCH,2015,CHILD NUTRITION PROGRAM OF SOUTHERN CALIFORNIA INC ,DCH_LUNCH,23,0,0,0,0,0,0,0,0,0
SAN DIEGO,Oct 2014,DCH,2015,CHILD NUTRITION PROGRAM OF SOUTHERN CALIFORNIA INC ,DCH_SNACK_AM,23,0,0,0,0,33586,0,0,33586,1460.2609
SAN DIEGO,Oct 2014,DCH,2015,CHILD NUTRITION PROGRAM OF SOUTHERN CALIFORNIA INC ,DCH_SNACK_AM,,0,0,0,0,0,215,9926,10141,0
SAN DIEGO,Oct 2014,DCH,2015,CHILD NUTRITION PROGRAM OF SOUTHERN CALIFORNIA INC ,DCH_SNACK_AM,23,0,0,0,0,0,0,0,0,0
SAN DIEGO,Oct 2014,DCH,2015,CHILD NUTRITION PROGRAM OF SOUTHERN CALIFORNIA INC ,DCH_SNACK_AM,23,0,0,0,0,0,0,0,0,0
SAN DIEGO,Oct 2014,DCH,2015,CHILD NUTRITION PROGRAM OF SOUTHERN CALIFORNIA INC ,DCH_SNACK_NT,23,0,0,0,0,2757,0,0,2757,119.8696
SAN DIEGO,Oct 2014,DCH,2015,CHILD NUTRITION PROGRAM OF SOUTHERN CALIFORNIA INC ,DCH_SNACK_NT,,0,0,0,0,0,37,58,95,0
SAN DIEGO,Oct 2014,DCH,2015,CHILD NUTRITION PROGRAM OF SOUTHERN CALIFORNIA INC ,DCH_SNACK_NT,23,0,0,0,0,0,0,0,0,0
SAN DIEGO,Oct 2014,DCH,2015,CHILD NUTRITION PROGRAM OF SOUTHERN CALIFORNIA INC ,DCH_SNACK_NT,23,0,0,0,0,0,0,0,0,0
SAN DIEGO,Oct 2014,DCH,2015,CHILD NUTRITION PROGRAM OF SOUTHERN CALIFORNIA INC ,DCH_SNACK_PM,23,0,0,0,0,82792,0,0,82792,3599.6522
SAN DIEGO,Oct 2014,DCH,2015,CHILD NUTRITION PROGRAM OF SOUTHERN CALIFORNIA INC ,DCH_SNACK_PM,,0,0,0,0,0,423,16563,16986,0
SAN DIEGO,Oct 2014,DCH,2015,CHILD NUTRITION PROGRAM OF SOUTHERN CALIFORNIA INC ,DCH_SNACK_PM,23,0,0,0,0,0,0,0,0,0
SAN DIEGO,Oct 2014,DCH,2015,CHILD NUTRITION PROGRAM OF SOUTHERN CALIFORNIA INC ,DCH_SNACK_PM,23,0,0,0,0,0,0,0,0,0
SAN DIEGO,Oct 2014,DCH,2015,CHILD NUTRITION PROGRAM OF SOUTHERN CALIFORNIA INC ,DCH_SUPPER,23,0,0,0,0,36010,0,0,36010,1565.6522
SAN DIEGO,Oct 2014,DCH,2015,CHILD NUTRITION PROGRAM OF SOUTHERN CALIFORNIA INC ,DCH_SUPPER,,0,0,0,0,0,412,5408,5820,0
SAN DIEGO,Oct 2014,DCH,2015,CHILD NUTRITION PROGRAM OF SOUTHERN CALIFORNIA INC ,DCH_SUPPER,23,0,0,0,0,0,0,0,0,0
SAN DIEGO,Oct 2014,DCH,2015,CHILD NUTRITION PROGRAM OF SOUTHERN CALIFORNIA INC ,DCH_SUPPER,23,0,0,0,0,0,0,0,0,0
SAN DIEGO,Nov 2014,DCH,2015,CHILD NUTRITION PROGRAM OF SOUTHERN CALIFORNIA INC ,DCH_BREAKFAST,19,0,0,0,0,58565,0,0,58565,3082.3684
SAN DIEGO,Nov 2014,DCH,2015,CHILD NUTRITION PROGRAM OF SOUTHERN CALIFORNIA INC ,DCH_BREAKFAST,,0,0,0,0,0,346,12857,13203,0
SAN DIEGO,Nov 2014,DCH,2015,CHILD NUTRITION PROGRAM OF SOUTHERN CALIFORNIA INC ,DCH_BREAKFAST,19,0,0,0,0,0,0,0,0,0
SAN DIEGO,Nov 2014,DCH,2015,CHILD NUTRITION PROGRAM OF SOUTHERN CALIFORNIA INC ,DCH_BREAKFAST,19,0,0,0,0,0,0,0,0,0
SAN DIEGO,Nov 2014,DCH,2015,CHILD NUTRITION PROGRAM OF SOUTHERN CALIFORNIA INC ,DCH_LUNCH,19,0,0,0,0,65107,0,0,65107,3426.6842
SAN DIEGO,Nov 2014,DCH,2015,CHILD NUTRITION PROGRAM OF SOUTHERN CALIFORNIA INC ,DCH_LUNCH,,0,0,0,0,0,475,16088,16563,0
SAN DIEGO,Nov 2014,DCH,2015,CHILD NUTRITION PROGRAM OF SOUTHERN CALIFORNIA INC ,DCH_LUNCH,19,0,0,0,0,0,0,0,0,0
SAN DIEGO,Nov 2014,DCH,2015,CHILD NUTRITION PROGRAM OF SOUTHERN CALIFORNIA INC ,DCH_LUNCH,19,0,0,0,0,0,0,0,0,0
SAN DIEGO,Nov 2014,DCH,2015,CHILD NUTRITION PROGRAM OF SOUTHERN CALIFORNIA INC ,DCH_SNACK_AM,19,0,0,0,0,26941,0,0,26941,1417.9474
SAN DIEGO,Nov 2014,DCH,2015,CHILD NUTRITION PROGRAM OF SOUTHERN CALIFORNIA INC ,DCH_SNACK_AM,,0,0,0,0,0,180,7484,7664,0
SAN DIEGO,Nov 2014,DCH,2015,CHILD NUTRITION PROGRAM OF SOUTHERN CALIFORNIA INC ,DCH_SNACK_AM,19,0,0,0,0,0,0,0,0,0
SAN DIEGO,Nov 2014,DCH,2015,CHILD NUTRITION PROGRAM OF SOUTHERN CALIFORNIA INC ,DCH_SNACK_AM,19,0,0,0,0,0,0,0,0,0
SAN DIEGO,Nov 2014,DCH,2015,CHILD NUTRITION PROGRAM OF SOUTHERN CALIFORNIA INC ,DCH_SNACK_NT,19,0,0,0,0,1937,0,0,1937,101.9474
SAN DIEGO,Nov 2014,DCH,2015,CHILD NUTRITION PROGRAM OF SOUTHERN CALIFORNIA INC ,DCH_SNACK_NT,,0,0,0,0,0,28,34,62,0
SAN DIEGO,Nov 2014,DCH,2015,CHILD NUTRITION PROGRAM OF SOUTHERN CALIFORNIA INC ,DCH_SNACK_NT,19,0,0,0,0,0,0,0,0,0
SAN DIEGO,Nov 2014,DCH,2015,CHILD NUTRITION PROGRAM OF SOUTHERN CALIFORNIA INC ,DCH_SNACK_NT,19,0,0,0,0,0,0,0,0,0
SAN DIEGO,Nov 2014,DCH,2015,CHILD NUTRITION PROGRAM OF SOUTHERN CALIFORNIA INC ,DCH_SNACK_PM,19,0,0,0,0,59439,0,0,59439,3128.3684
SAN DIEGO,Nov 2014,DCH,2015,CHILD NUTRITION PROGRAM OF SOUTHERN CALIFORNIA INC ,DCH_SNACK_PM,,0,0,0,0,0,357,11613,11970,0
SAN DIEGO,Nov 2014,DCH,2015,CHILD NUTRITION PROGRAM OF SOUTHERN CALIFORNIA INC ,DCH_SNACK_PM,19,0,0,0,0,0,0,0,0,0
SAN DIEGO,Nov 2014,DCH,2015,CHILD NUTRITION PROGRAM OF SOUTHERN CALIFORNIA INC ,DCH_SNACK_PM,19,0,0,0,0,0,0,0,0,0
SAN DIEGO,Nov 2014,DCH,2015,CHILD NUTRITION PROGRAM OF SOUTHERN CALIFORNIA INC ,DCH_SUPPER,19,0,0,0,0,26995,0,0,26995,1420.7895
SAN DIEGO,Nov 2014,DCH,2015,CHILD NUTRITION PROGRAM OF SOUTHERN CALIFORNIA INC ,DCH_SUPPER,,0,0,0,0,0,342,3762,4104,0
SAN DIEGO,Nov 2014,DCH,2015,CHILD NUTRITION PROGRAM OF SOUTHERN CALIFORNIA INC ,DCH_SUPPER,19,0,0,0,0,0,0,0,0,0
SAN DIEGO,Nov 2014,DCH,2015,CHILD NUTRITION PROGRAM OF SOUTHERN CALIFORNIA INC ,DCH_SUPPER,19,0,0,0,0,0,0,0,0,0
SAN DIEGO,Dec 2014,DCH,2015,CHILD NUTRITION PROGRAM OF SOUTHERN CALIFORNIA INC ,DCH_BREAKFAST,22,0,0,0,0,65567,0,0,65567,2980.3182
SAN DIEGO,Dec 2014,DCH,2015,CHILD NUTRITION PROGRAM OF SOUTHERN CALIFORNIA INC ,DCH_BREAKFAST,,0,0,0,0,0,391,13959,14350,0
SAN DIEGO,Dec 2014,DCH,2015,CHILD NUTRITION PROGRAM OF SOUTHERN CALIFORNIA INC ,DCH_BREAKFAST,22,0,0,0,0,0,0,0,0,0
SAN DIEGO,Dec 2014,DCH,2015,CHILD NUTRITION PROGRAM OF SOUTHERN CALIFORNIA INC ,DCH_BREAKFAST,22,0,0,0,0,0,0,0,0,0
SAN DIEGO,Dec 2014,DCH,2015,CHILD NUTRITION PROGRAM OF SOUTHERN CALIFORNIA INC ,DCH_LUNCH,22,0,0,0,0,72845,0,0,72845,3311.1364
SAN DIEGO,Dec 2014,DCH,2015,CHILD NUTRITION PROGRAM OF SOUTHERN CALIFORNIA INC ,DCH_LUNCH,,0,0,0,0,0,599,17636,18235,0
SAN DIEGO,Dec 2014,DCH,2015,CHILD NUTRITION PROGRAM OF SOUTHERN CALIFORNIA INC ,DCH_LUNCH,22,0,0,0,0,0,0,0,0,0
SAN DIEGO,Dec 2014,DCH,2015,CHILD NUTRITION PROGRAM OF SOUTHERN CALIFORNIA INC ,DCH_LUNCH,22,0,0,0,0,0,0,0,0,0
SAN DIEGO,Dec 2014,DCH,2015,CHILD NUTRITION PROGRAM OF SOUTHERN CALIFORNIA INC ,DCH_SNACK_AM,22,0,0,0,0,30271,0,0,30271,1375.9545
SAN DIEGO,Dec 2014,DCH,2015,CHILD NUTRITION PROGRAM OF SOUTHERN CALIFORNIA INC ,DCH_SNACK_AM,,0,0,0,0,0,262,8169,8431,0
SAN DIEGO,Dec 2014,DCH,2015,CHILD NUTRITION PROGRAM OF SOUTHERN CALIFORNIA INC ,DCH_SNACK_AM,22,0,0,0,0,0,0,0,0,0
SAN DIEGO,Dec 2014,DCH,2015,CHILD NUTRITION PROGRAM OF SOUTHERN CALIFORNIA INC ,DCH_SNACK_AM,22,0,0,0,0,0,0,0,0,0
SAN DIEGO,Dec 2014,DCH,2015,CHILD NUTRITION PROGRAM OF SOUTHERN CALIFORNIA INC ,DCH_SNACK_NT,22,0,0,0,0,2346,0,0,2346,106.6364
SAN DIEGO,Dec 2014,DCH,2015,CHILD NUTRITION PROGRAM OF SOUTHERN CALIFORNIA INC ,DCH_SNACK_NT,,0,0,0,0,0,27,31,58,0
SAN DIEGO,Dec 2014,DCH,2015,CHILD NUTRITION PROGRAM OF SOUTHERN CALIFORNIA INC ,DCH_SNACK_NT,22,0,0,0,0,0,0,0,0,0
SAN DIEGO,Dec 2014,DCH,2015,CHILD NUTRITION PROGRAM OF SOUTHERN CALIFORNIA INC ,DCH_SNACK_NT,22,0,0,0,0,0,0,0,0,0
SAN DIEGO,Dec 2014,DCH,2015,CHILD NUTRITION PROGRAM OF SOUTHERN CALIFORNIA INC ,DCH_SNACK_PM,22,0,0,0,0,66565,0,0,66565,3025.6818
SAN DIEGO,Dec 2014,DCH,2015,CHILD NUTRITION PROGRAM OF SOUTHERN CALIFORNIA INC ,DCH_SNACK_PM,,0,0,0,0,0,438,12529,12967,0
SAN DIEGO,Dec 2014,DCH,2015,CHILD NUTRITION PROGRAM OF SOUTHERN CALIFORNIA INC ,DCH_SNACK_PM,22,0,0,0,0,0,0,0,0,0
SAN DIEGO,Dec 2014,DCH,2015,CHILD NUTRITION PROGRAM OF SOUTHERN CALIFORNIA INC ,DCH_SNACK_PM,22,0,0,0,0,0,0,0,0,0
SAN DIEGO,Dec 2014,DCH,2015,CHILD NUTRITION PROGRAM OF SOUTHERN CALIFORNIA INC ,DCH_SUPPER,22,0,0,0,0,30591,0,0,30591,1390.5
SAN DIEGO,Dec 2014,DCH,2015,CHILD NUTRITION PROGRAM OF SOUTHERN CALIFORNIA INC ,DCH_SUPPER,,0,0,0,0,0,449,4244,4693,0
SAN DIEGO,Dec 2014,DCH,2015,CHILD NUTRITION PROGRAM OF SOUTHERN CALIFORNIA INC ,DCH_SUPPER,22,0,0,0,0,0,0,0,0,0
SAN DIEGO,Dec 2014,DCH,2015,CHILD NUTRITION PROGRAM OF SOUTHERN CALIFORNIA INC ,DCH_SUPPER,22,0,0,0,0,0,0,0,0,0
SAN DIEGO,Jan 2015,DCH,2015,CHILD NUTRITION PROGRAM OF SOUTHERN CALIFORNIA INC ,DCH_BREAKFAST,21,0,0,0,0,68656,0,0,68656,3269.3333
SAN DIEGO,Jan 2015,DCH,2015,CHILD NUTRITION PROGRAM OF SOUTHERN CALIFORNIA INC ,DCH_BREAKFAST,,0,0,0,0,0,421,15298,15719,0
SAN DIEGO,Jan 2015,DCH,2015,CHILD NUTRITION PROGRAM OF SOUTHERN CALIFORNIA INC ,DCH_BREAKFAST,21,0,0,0,0,0,0,0,0,0
SAN DIEGO,Jan 2015,DCH,2015,CHILD NUTRITION PROGRAM OF SOUTHERN CALIFORNIA INC ,DCH_BREAKFAST,21,0,0,0,0,0,0,0,0,0
SAN DIEGO,Jan 2015,DCH,2015,CHILD NUTRITION PROGRAM OF SOUTHERN CALIFORNIA INC ,DCH_LUNCH,21,0,0,0,0,74018,0,0,74018,3524.6667
SAN DIEGO,Jan 2015,DCH,2015,CHILD NUTRITION PROGRAM OF SOUTHERN CALIFORNIA INC ,DCH_LUNCH,,0,0,0,0,0,550,19177,19727,0
SAN DIEGO,Jan 2015,DCH,2015,CHILD NUTRITION PROGRAM OF SOUTHERN CALIFORNIA INC ,DCH_LUNCH,21,0,0,0,0,0,0,0,0,0
SAN DIEGO,Jan 2015,DCH,2015,CHILD NUTRITION PROGRAM OF SOUTHERN CALIFORNIA INC ,DCH_LUNCH,21,0,0,0,0,0,0,0,0,0
SAN DIEGO,Jan 2015,DCH,2015,CHILD NUTRITION PROGRAM OF SOUTHERN CALIFORNIA INC ,DCH_SNACK_AM,21,0,0,0,0,31043,0,0,31043,1478.2381
SAN DIEGO,Jan 2015,DCH,2015,CHILD NUTRITION PROGRAM OF SOUTHERN CALIFORNIA INC ,DCH_SNACK_AM,,0,0,0,0,0,264,8958,9222,0
SAN DIEGO,Jan 2015,DCH,2015,CHILD NUTRITION PROGRAM OF SOUTHERN CALIFORNIA INC ,DCH_SNACK_AM,21,0,0,0,0,0,0,0,0,0
SAN DIEGO,Jan 2015,DCH,2015,CHILD NUTRITION PROGRAM OF SOUTHERN CALIFORNIA INC ,DCH_SNACK_AM,21,0,0,0,0,0,0,0,0,0
SAN DIEGO,Jan 2015,DCH,2015,CHILD NUTRITION PROGRAM OF SOUTHERN CALIFORNIA INC ,DCH_SNACK_NT,21,0,0,0,0,2239,0,0,2239,106.619
SAN DIEGO,Jan 2015,DCH,2015,CHILD NUTRITION PROGRAM OF SOUTHERN CALIFORNIA INC ,DCH_SNACK_NT,,0,0,0,0,0,40,56,96,0
SAN DIEGO,Jan 2015,DCH,2015,CHILD NUTRITION PROGRAM OF SOUTHERN CALIFORNIA INC ,DCH_SNACK_NT,21,0,0,0,0,0,0,0,0,0
SAN DIEGO,Jan 2015,DCH,2015,CHILD NUTRITION PROGRAM OF SOUTHERN CALIFORNIA INC ,DCH_SNACK_NT,21,0,0,0,0,0,0,0,0,0
SAN DIEGO,Jan 2015,DCH,2015,CHILD NUTRITION PROGRAM OF SOUTHERN CALIFORNIA INC ,DCH_SNACK_PM,21,0,0,0,0,68885,0,0,68885,3280.2381
SAN DIEGO,Jan 2015,DCH,2015,CHILD NUTRITION PROGRAM OF SOUTHERN CALIFORNIA INC ,DCH_SNACK_PM,,0,0,0,0,0,436,13665,14101,0
SAN DIEGO,Jan 2015,DCH,2015,CHILD NUTRITION PROGRAM OF SOUTHERN CALIFORNIA INC ,DCH_SNACK_PM,21,0,0,0,0,0,0,0,0,0
SAN DIEGO,Jan 2015,DCH,2015,CHILD NUTRITION PROGRAM OF SOUTHERN CALIFORNIA INC ,DCH_SNACK_PM,21,0,0,0,0,0,0,0,0,0
SAN DIEGO,Jan 2015,DCH,2015,CHILD NUTRITION PROGRAM OF SOUTHERN CALIFORNIA INC ,DCH_SUPPER,21,0,0,0,0,30867,0,0,30867,1469.8571
SAN DIEGO,Jan 2015,DCH,2015,CHILD NUTRITION PROGRAM OF SOUTHERN CALIFORNIA INC ,DCH_SUPPER,,0,0,0,0,0,392,4279,4671,0
SAN DIEGO,Jan 2015,DCH,2015,CHILD NUTRITION PROGRAM OF SOUTHERN CALIFORNIA INC ,DCH_SUPPER,21,0,0,0,0,0,0,0,0,0
SAN DIEGO,Jan 2015,DCH,2015,CHILD NUTRITION PROGRAM OF SOUTHERN CALIFORNIA INC ,DCH_SUPPER,21,0,0,0,0,0,0,0,0,0
SAN DIEGO,Feb 2015,DCH,2015,CHILD NUTRITION PROGRAM OF SOUTHERN CALIFORNIA INC ,DCH_BREAKFAST,20,0,0,0,0,68647,0,0,68647,3432.35
SAN DIEGO,Feb 2015,DCH,2015,CHILD NUTRITION PROGRAM OF SOUTHERN CALIFORNIA INC ,DCH_BREAKFAST,,0,0,0,0,0,397,13534,13931,0
SAN DIEGO,Feb 2015,DCH,2015,CHILD NUTRITION PROGRAM OF SOUTHERN CALIFORNIA INC ,DCH_BREAKFAST,6,0,0,0,0,0,0,0,0,0
SAN DIEGO,Feb 2015,DCH,2015,CHILD NUTRITION PROGRAM OF SOUTHERN CALIFORNIA INC ,DCH_BREAKFAST,20,0,0,0,0,0,0,0,0,0
SAN DIEGO,Feb 2015,DCH,2015,CHILD NUTRITION PROGRAM OF SOUTHERN CALIFORNIA INC ,DCH_BREAKFAST,20,0,0,0,0,0,0,0,0,0
SAN DIEGO,Feb 2015,DCH,2015,CHILD NUTRITION PROGRAM OF SOUTHERN CALIFORNIA INC ,DCH_LUNCH,20,0,0,0,0,73103,0,0,73103,3655.15
SAN DIEGO,Feb 2015,DCH,2015,CHILD NUTRITION PROGRAM OF SOUTHERN CALIFORNIA INC ,DCH_LUNCH,,0,0,0,0,0,540,17313,17853,0
SAN DIEGO,Feb 2015,DCH,2015,CHILD NUTRITION PROGRAM OF SOUTHERN CALIFORNIA INC ,DCH_LUNCH,6,0,0,0,0,0,0,0,0,0
SAN DIEGO,Feb 2015,DCH,2015,CHILD NUTRITION PROGRAM OF SOUTHERN CALIFORNIA INC ,DCH_LUNCH,20,0,0,0,0,0,0,0,0,0
SAN DIEGO,Feb 2015,DCH,2015,CHILD NUTRITION PROGRAM OF SOUTHERN CALIFORNIA INC ,DCH_LUNCH,20,0,0,0,0,0,0,0,0,0
SAN DIEGO,Feb 2015,DCH,2015,CHILD NUTRITION PROGRAM OF SOUTHERN CALIFORNIA INC ,DCH_SNACK_AM,20,0,0,0,0,31278,0,0,31278,1563.9
SAN DIEGO,Feb 2015,DCH,2015,CHILD NUTRITION PROGRAM OF SOUTHERN CALIFORNIA INC ,DCH_SNACK_AM,,0,0,0,0,0,231,8242,8473,0
SAN DIEGO,Feb 2015,DCH,2015,CHILD NUTRITION PROGRAM OF SOUTHERN CALIFORNIA INC ,DCH_SNACK_AM,6,0,0,0,0,0,0,0,0,0
SAN DIEGO,Feb 2015,DCH,2015,CHILD NUTRITION PROGRAM OF SOUTHERN CALIFORNIA INC ,DCH_SNACK_AM,20,0,0,0,0,0,0,0,0,0
SAN DIEGO,Feb 2015,DCH,2015,CHILD NUTRITION PROGRAM OF SOUTHERN CALIFORNIA INC ,DCH_SNACK_AM,20,0,0,0,0,0,0,0,0,0
SAN DIEGO,Feb 2015,DCH,2015,CHILD NUTRITION PROGRAM OF SOUTHERN CALIFORNIA INC ,DCH_SNACK_NT,20,0,0,0,0,2278,0,0,2278,113.9
SAN DIEGO,Feb 2015,DCH,2015,CHILD NUTRITION PROGRAM OF SOUTHERN CALIFORNIA INC ,DCH_SNACK_NT,,0,0,0,0,0,43,53,96,0
SAN DIEGO,Feb 2015,DCH,2015,CHILD NUTRITION PROGRAM OF SOUTHERN CALIFORNIA INC ,DCH_SNACK_NT,6,0,0,0,0,0,0,0,0,0
SAN DIEGO,Feb 2015,DCH,2015,CHILD NUTRITION PROGRAM OF SOUTHERN CALIFORNIA INC ,DCH_SNACK_NT,20,0,0,0,0,0,0,0,0,0
SAN DIEGO,Feb 2015,DCH,2015,CHILD NUTRITION PROGRAM OF SOUTHERN CALIFORNIA INC ,DCH_SNACK_NT,20,0,0,0,0,0,0,0,0,0
SAN DIEGO,Feb 2015,DCH,2015,CHILD NUTRITION PROGRAM OF SOUTHERN CALIFORNIA INC ,DCH_SNACK_PM,20,0,0,0,0,69397,0,0,69397,3469.85
SAN DIEGO,Feb 2015,DCH,2015,CHILD NUTRITION PROGRAM OF SOUTHERN CALIFORNIA INC ,DCH_SNACK_PM,,0,0,0,0,0,384,12008,12392,0
SAN DIEGO,Feb 2015,DCH,2015,CHILD NUTRITION PROGRAM OF SOUTHERN CALIFORNIA INC ,DCH_SNACK_PM,6,0,0,0,0,0,0,0,0,0
SAN DIEGO,Feb 2015,DCH,2015,CHILD NUTRITION PROGRAM OF SOUTHERN CALIFORNIA INC ,DCH_SNACK_PM,20,0,0,0,0,0,0,0,0,0
SAN DIEGO,Feb 2015,DCH,2015,CHILD NUTRITION PROGRAM OF SOUTHERN CALIFORNIA INC ,DCH_SNACK_PM,20,0,0,0,0,0,0,0,0,0
SAN DIEGO,Feb 2015,DCH,2015,CHILD NUTRITION PROGRAM OF SOUTHERN CALIFORNIA INC ,DCH_SUPPER,20,0,0,0,0,30876,0,0,30876,1543.8
SAN DIEGO,Feb 2015,DCH,2015,CHILD NUTRITION PROGRAM OF SOUTHERN CALIFORNIA INC ,DCH_SUPPER,,0,0,0,0,0,354,4215,4569,0
SAN DIEGO,Feb 2015,DCH,2015,CHILD NUTRITION PROGRAM OF SOUTHERN CALIFORNIA INC ,DCH_SUPPER,6,0,0,0,0,0,0,0,0,0
SAN DIEGO,Feb 2015,DCH,2015,CHILD NUTRITION PROGRAM OF SOUTHERN CALIFORNIA INC ,DCH_SUPPER,20,0,0,0,0,0,0,0,0,0
SAN DIEGO,Feb 2015,DCH,2015,CHILD NUTRITION PROGRAM OF SOUTHERN CALIFORNIA INC ,DCH_SUPPER,20,0,0,0,0,0,0,0,0,0
SAN DIEGO,Mar 2015,DCH,2015,CHILD NUTRITION PROGRAM OF SOUTHERN CALIFORNIA INC ,DCH_BREAKFAST,22,0,0,0,0,78059,0,0,78059,3548.1364
SAN DIEGO,Mar 2015,DCH,2015,CHILD NUTRITION PROGRAM OF SOUTHERN CALIFORNIA INC ,DCH_BREAKFAST,,0,0,0,0,0,430,15134,15564,0
SAN DIEGO,Mar 2015,DCH,2015,CHILD NUTRITION PROGRAM OF SOUTHERN CALIFORNIA INC ,DCH_BREAKFAST,15,0,0,0,0,0,0,0,0,0
SAN DIEGO,Mar 2015,DCH,2015,CHILD NUTRITION PROGRAM OF SOUTHERN CALIFORNIA INC ,DCH_BREAKFAST,22,0,0,0,0,0,0,0,0,0
SAN DIEGO,Mar 2015,DCH,2015,CHILD NUTRITION PROGRAM OF SOUTHERN CALIFORNIA INC ,DCH_BREAKFAST,22,0,0,0,0,0,0,0,0,0
SAN DIEGO,Mar 2015,DCH,2015,CHILD NUTRITION PROGRAM OF SOUTHERN CALIFORNIA INC ,DCH_LUNCH,22,0,0,0,0,86695,0,0,86695,3940.6818
SAN DIEGO,Mar 2015,DCH,2015,CHILD NUTRITION PROGRAM OF SOUTHERN CALIFORNIA INC ,DCH_LUNCH,,0,0,0,0,0,544,19912,20456,0
SAN DIEGO,Mar 2015,DCH,2015,CHILD NUTRITION PROGRAM OF SOUTHERN CALIFORNIA INC ,DCH_LUNCH,15,0,0,0,0,0,0,0,0,0
SAN DIEGO,Mar 2015,DCH,2015,CHILD NUTRITION PROGRAM OF SOUTHERN CALIFORNIA INC ,DCH_LUNCH,22,0,0,0,0,0,0,0,0,0
SAN DIEGO,Mar 2015,DCH,2015,CHILD NUTRITION PROGRAM OF SOUTHERN CALIFORNIA INC ,DCH_LUNCH,22,0,0,0,0,0,0,0,0,0
SAN DIEGO,Mar 2015,DCH,2015,CHILD NUTRITION PROGRAM OF SOUTHERN CALIFORNIA INC ,DCH_SNACK_AM,22,0,0,0,0,36543,0,0,36543,1661.0455
SAN DIEGO,Mar 2015,DCH,2015,CHILD NUTRITION PROGRAM OF SOUTHERN CALIFORNIA INC ,DCH_SNACK_AM,,0,0,0,0,0,257,9302,9559,0
SAN DIEGO,Mar 2015,DCH,2015,CHILD NUTRITION PROGRAM OF SOUTHERN CALIFORNIA INC ,DCH_SNACK_AM,15,0,0,0,0,0,0,0,0,0
SAN DIEGO,Mar 2015,DCH,2015,CHILD NUTRITION PROGRAM OF SOUTHERN CALIFORNIA INC ,DCH_SNACK_AM,22,0,0,0,0,0,0,0,0,0
SAN DIEGO,Mar 2015,DCH,2015,CHILD NUTRITION PROGRAM OF SOUTHERN CALIFORNIA INC ,DCH_SNACK_AM,22,0,0,0,0,0,0,0,0,0
SAN DIEGO,Mar 2015,DCH,2015,CHILD NUTRITION PROGRAM OF SOUTHERN CALIFORNIA INC ,DCH_SNACK_NT,22,0,0,0,0,2341,0,0,2341,106.4091
SAN DIEGO,Mar 2015,DCH,2015,CHILD NUTRITION PROGRAM OF SOUTHERN CALIFORNIA INC ,DCH_SNACK_NT,,0,0,0,0,0,47,59,106,0
SAN DIEGO,Mar 2015,DCH,2015,CHILD NUTRITION PROGRAM OF SOUTHERN CALIFORNIA INC ,DCH_SNACK_NT,15,0,0,0,0,0,0,0,0,0
SAN DIEGO,Mar 2015,DCH,2015,CHILD NUTRITION PROGRAM OF SOUTHERN CALIFORNIA INC ,DCH_SNACK_NT,22,0,0,0,0,0,0,0,0,0
SAN DIEGO,Mar 2015,DCH,2015,CHILD NUTRITION PROGRAM OF SOUTHERN CALIFORNIA INC ,DCH_SNACK_NT,22,0,0,0,0,0,0,0,0,0
SAN DIEGO,Mar 2015,DCH,2015,CHILD NUTRITION PROGRAM OF SOUTHERN CALIFORNIA INC ,DCH_SNACK_PM,22,0,0,0,0,78907,0,0,78907,3586.6818
SAN DIEGO,Mar 2015,DCH,2015,CHILD NUTRITION PROGRAM OF SOUTHERN CALIFORNIA INC ,DCH_SNACK_PM,,0,0,0,0,0,460,13737,14197,0
SAN DIEGO,Mar 2015,DCH,2015,CHILD NUTRITION PROGRAM OF SOUTHERN CALIFORNIA INC ,DCH_SNACK_PM,15,0,0,0,0,0,0,0,0,0
SAN DIEGO,Mar 2015,DCH,2015,CHILD NUTRITION PROGRAM OF SOUTHERN CALIFORNIA INC ,DCH_SNACK_PM,22,0,0,0,0,0,0,0,0,0
SAN DIEGO,Mar 2015,DCH,2015,CHILD NUTRITION PROGRAM OF SOUTHERN CALIFORNIA INC ,DCH_SNACK_PM,22,0,0,0,0,0,0,0,0,0
SAN DIEGO,Mar 2015,DCH,2015,CHILD NUTRITION PROGRAM OF SOUTHERN CALIFORNIA INC ,DCH_SUPPER,22,0,0,0,0,34876,0,0,34876,1585.2727
SAN DIEGO,Mar 2015,DCH,2015,CHILD NUTRITION PROGRAM OF SOUTHERN CALIFORNIA INC ,DCH_SUPPER,,0,0,0,0,0,412,5014,5426,0
SAN DIEGO,Mar 2015,DCH,2015,CHILD NUTRITION PROGRAM OF SOUTHERN CALIFORNIA INC ,DCH_SUPPER,15,0,0,0,0,0,0,0,0,0
SAN DIEGO,Mar 2015,DCH,2015,CHILD NUTRITION PROGRAM OF SOUTHERN CALIFORNIA INC ,DCH_SUPPER,22,0,0,0,0,0,0,0,0,0
SAN DIEGO,Mar 2015,DCH,2015,CHILD NUTRITION PROGRAM OF SOUTHERN CALIFORNIA INC ,DCH_SUPPER,22,0,0,0,0,0,0,0,0,0
SAN DIEGO,Apr 2015,DCH,2015,CHILD NUTRITION PROGRAM OF SOUTHERN CALIFORNIA INC ,DCH_BREAKFAST,22,0,0,0,0,78480,0,0,78480,3567.2727
SAN DIEGO,Apr 2015,DCH,2015,CHILD NUTRITION PROGRAM OF SOUTHERN CALIFORNIA INC ,DCH_BREAKFAST,,0,0,0,0,0,411,14122,14533,0
SAN DIEGO,Apr 2015,DCH,2015,CHILD NUTRITION PROGRAM OF SOUTHERN CALIFORNIA INC ,DCH_BREAKFAST,20,0,0,0,0,0,0,0,0,0
SAN DIEGO,Apr 2015,DCH,2015,CHILD NUTRITION PROGRAM OF SOUTHERN CALIFORNIA INC ,DCH_BREAKFAST,22,0,0,0,0,0,0,0,0,0
SAN DIEGO,Apr 2015,DCH,2015,CHILD NUTRITION PROGRAM OF SOUTHERN CALIFORNIA INC ,DCH_BREAKFAST,22,0,0,0,0,0,0,0,0,0
SAN DIEGO,Apr 2015,DCH,2015,CHILD NUTRITION PROGRAM OF SOUTHERN CALIFORNIA INC ,DCH_LUNCH,22,0,0,0,0,88016,0,0,88016,4000.7273
SAN DIEGO,Apr 2015,DCH,2015,CHILD NUTRITION PROGRAM OF SOUTHERN CALIFORNIA INC ,DCH_LUNCH,,0,0,0,0,0,619,18695,19314,0
SAN DIEGO,Apr 2015,DCH,2015,CHILD NUTRITION PROGRAM OF SOUTHERN CALIFORNIA INC ,DCH_LUNCH,20,0,0,0,0,0,0,0,0,0
SAN DIEGO,Apr 2015,DCH,2015,CHILD NUTRITION PROGRAM OF SOUTHERN CALIFORNIA INC ,DCH_LUNCH,22,0,0,0,0,0,0,0,0,0
SAN DIEGO,Apr 2015,DCH,2015,CHILD NUTRITION PROGRAM OF SOUTHERN CALIFORNIA INC ,DCH_LUNCH,22,0,0,0,0,0,0,0,0,0
SAN DIEGO,Apr 2015,DCH,2015,CHILD NUTRITION PROGRAM OF SOUTHERN CALIFORNIA INC ,DCH_SNACK_AM,22,0,0,0,0,36799,0,0,36799,1672.6818
SAN DIEGO,Apr 2015,DCH,2015,CHILD NUTRITION PROGRAM OF SOUTHERN CALIFORNIA INC ,DCH_SNACK_AM,,0,0,0,0,0,251,9076,9327,0
SAN DIEGO,Apr 2015,DCH,2015,CHILD NUTRITION PROGRAM OF SOUTHERN CALIFORNIA INC ,DCH_SNACK_AM,20,0,0,0,0,0,0,0,0,0
SAN DIEGO,Apr 2015,DCH,2015,CHILD NUTRITION PROGRAM OF SOUTHERN CALIFORNIA INC ,DCH_SNACK_AM,22,0,0,0,0,0,0,0,0,0
SAN DIEGO,Apr 2015,DCH,2015,CHILD NUTRITION PROGRAM OF SOUTHERN CALIFORNIA INC ,DCH_SNACK_AM,22,0,0,0,0,0,0,0,0,0
SAN DIEGO,Apr 2015,DCH,2015,CHILD NUTRITION PROGRAM OF SOUTHERN CALIFORNIA INC ,DCH_SNACK_NT,22,0,0,0,0,2269,0,0,2269,103.1364
SAN DIEGO,Apr 2015,DCH,2015,CHILD NUTRITION PROGRAM OF SOUTHERN CALIFORNIA INC ,DCH_SNACK_NT,,0,0,0,0,0,93,66,159,0
SAN DIEGO,Apr 2015,DCH,2015,CHILD NUTRITION PROGRAM OF SOUTHERN CALIFORNIA INC ,DCH_SNACK_NT,20,0,0,0,0,0,0,0,0,0
SAN DIEGO,Apr 2015,DCH,2015,CHILD NUTRITION PROGRAM OF SOUTHERN CALIFORNIA INC ,DCH_SNACK_NT,22,0,0,0,0,0,0,0,0,0
SAN DIEGO,Apr 2015,DCH,2015,CHILD NUTRITION PROGRAM OF SOUTHERN CALIFORNIA INC ,DCH_SNACK_NT,22,0,0,0,0,0,0,0,0,0
SAN DIEGO,Apr 2015,DCH,2015,CHILD NUTRITION PROGRAM OF SOUTHERN CALIFORNIA INC ,DCH_SNACK_PM,22,0,0,0,0,79012,0,0,79012,3591.4545
SAN DIEGO,Apr 2015,DCH,2015,CHILD NUTRITION PROGRAM OF SOUTHERN CALIFORNIA INC ,DCH_SNACK_PM,,0,0,0,0,0,556,12332,12888,0
SAN DIEGO,Apr 2015,DCH,2015,CHILD NUTRITION PROGRAM OF SOUTHERN CALIFORNIA INC ,DCH_SNACK_PM,20,0,0,0,0,0,0,0,0,0
SAN DIEGO,Apr 2015,DCH,2015,CHILD NUTRITION PROGRAM OF SOUTHERN CALIFORNIA INC ,DCH_SNACK_PM,22,0,0,0,0,0,0,0,0,0
SAN DIEGO,Apr 2015,DCH,2015,CHILD NUTRITION PROGRAM OF SOUTHERN CALIFORNIA INC ,DCH_SNACK_PM,22,0,0,0,0,0,0,0,0,0
SAN DIEGO,Apr 2015,DCH,2015,CHILD NUTRITION PROGRAM OF SOUTHERN CALIFORNIA INC ,DCH_SUPPER,22,0,0,0,0,35139,0,0,35139,1597.2273
SAN DIEGO,Apr 2015,DCH,2015,CHILD NUTRITION PROGRAM OF SOUTHERN CALIFORNIA INC ,DCH_SUPPER,,0,0,0,0,0,511,4365,4876,0
SAN DIEGO,Apr 2015,DCH,2015,CHILD NUTRITION PROGRAM OF SOUTHERN CALIFORNIA INC ,DCH_SUPPER,20,0,0,0,0,0,0,0,0,0
SAN DIEGO,Apr 2015,DCH,2015,CHILD NUTRITION PROGRAM OF SOUTHERN CALIFORNIA INC ,DCH_SUPPER,22,0,0,0,0,0,0,0,0,0
SAN DIEGO,Apr 2015,DCH,2015,CHILD NUTRITION PROGRAM OF SOUTHERN CALIFORNIA INC ,DCH_SUPPER,22,0,0,0,0,0,0,0,0,0
SAN DIEGO,May 2015,DCH,2015,CHILD NUTRITION PROGRAM OF SOUTHERN CALIFORNIA INC ,DCH_BREAKFAST,20,0,0,0,0,72083,0,0,72083,3604.15
SAN DIEGO,May 2015,DCH,2015,CHILD NUTRITION PROGRAM OF SOUTHERN CALIFORNIA INC ,DCH_BREAKFAST,,0,0,0,0,0,388,13386,13774,0
SAN DIEGO,May 2015,DCH,2015,CHILD NUTRITION PROGRAM OF SOUTHERN CALIFORNIA INC ,DCH_BREAKFAST,20,0,0,0,0,0,0,0,0,0
SAN DIEGO,May 2015,DCH,2015,CHILD NUTRITION PROGRAM OF SOUTHERN CALIFORNIA INC ,DCH_BREAKFAST,20,0,0,0,0,0,0,0,0,0
SAN DIEGO,May 2015,DCH,2015,CHILD NUTRITION PROGRAM OF SOUTHERN CALIFORNIA INC ,DCH_LUNCH,20,0,0,0,0,77106,0,0,77106,3855.3
SAN DIEGO,May 2015,DCH,2015,CHILD NUTRITION PROGRAM OF SOUTHERN CALIFORNIA INC ,DCH_LUNCH,,0,0,0,0,0,462,17099,17561,0
SAN DIEGO,May 2015,DCH,2015,CHILD NUTRITION PROGRAM OF SOUTHERN CALIFORNIA INC ,DCH_LUNCH,20,0,0,0,0,0,0,0,0,0
SAN DIEGO,May 2015,DCH,2015,CHILD NUTRITION PROGRAM OF SOUTHERN CALIFORNIA INC ,DCH_LUNCH,20,0,0,0,0,0,0,0,0,0
SAN DIEGO,May 2015,DCH,2015,CHILD NUTRITION PROGRAM OF SOUTHERN CALIFORNIA INC ,DCH_SNACK_AM,20,0,0,0,0,32547,0,0,32547,1627.35
SAN DIEGO,May 2015,DCH,2015,CHILD NUTRITION PROGRAM OF SOUTHERN CALIFORNIA INC ,DCH_SNACK_AM,,0,0,0,0,0,216,8348,8564,0
SAN DIEGO,May 2015,DCH,2015,CHILD NUTRITION PROGRAM OF SOUTHERN CALIFORNIA INC ,DCH_SNACK_AM,20,0,0,0,0,0,0,0,0,0
SAN DIEGO,May 2015,DCH,2015,CHILD NUTRITION PROGRAM OF SOUTHERN CALIFORNIA INC ,DCH_SNACK_AM,20,0,0,0,0,0,0,0,0,0
SAN DIEGO,May 2015,DCH,2015,CHILD NUTRITION PROGRAM OF SOUTHERN CALIFORNIA INC ,DCH_SNACK_NT,20,0,0,0,0,2174,0,0,2174,108.7
SAN DIEGO,May 2015,DCH,2015,CHILD NUTRITION PROGRAM OF SOUTHERN CALIFORNIA INC ,DCH_SNACK_NT,,0,0,0,0,0,31,46,77,0
SAN DIEGO,May 2015,DCH,2015,CHILD NUTRITION PROGRAM OF SOUTHERN CALIFORNIA INC ,DCH_SNACK_NT,20,0,0,0,0,0,0,0,0,0
SAN DIEGO,May 2015,DCH,2015,CHILD NUTRITION PROGRAM OF SOUTHERN CALIFORNIA INC ,DCH_SNACK_NT,20,0,0,0,0,0,0,0,0,0
SAN DIEGO,May 2015,DCH,2015,CHILD NUTRITION PROGRAM OF SOUTHERN CALIFORNIA INC ,DCH_SNACK_PM,20,0,0,0,0,72498,0,0,72498,3624.9
SAN DIEGO,May 2015,DCH,2015,CHILD NUTRITION PROGRAM OF SOUTHERN CALIFORNIA INC ,DCH_SNACK_PM,,0,0,0,0,0,330,11580,11910,0
SAN DIEGO,May 2015,DCH,2015,CHILD NUTRITION PROGRAM OF SOUTHERN CALIFORNIA INC ,DCH_SNACK_PM,20,0,0,0,0,0,0,0,0,0
SAN DIEGO,May 2015,DCH,2015,CHILD NUTRITION PROGRAM OF SOUTHERN CALIFORNIA INC ,DCH_SNACK_PM,20,0,0,0,0,0,0,0,0,0
SAN DIEGO,May 2015,DCH,2015,CHILD NUTRITION PROGRAM OF SOUTHERN CALIFORNIA INC ,DCH_SUPPER,20,0,0,0,0,31909,0,0,31909,1595.45
SAN DIEGO,May 2015,DCH,2015,CHILD NUTRITION PROGRAM OF SOUTHERN CALIFORNIA INC ,DCH_SUPPER,,0,0,0,0,0,287,3943,4230,0
SAN DIEGO,May 2015,DCH,2015,CHILD NUTRITION PROGRAM OF SOUTHERN CALIFORNIA INC ,DCH_SUPPER,20,0,0,0,0,0,0,0,0,0
SAN DIEGO,May 2015,DCH,2015,CHILD NUTRITION PROGRAM OF SOUTHERN CALIFORNIA INC ,DCH_SUPPER,20,0,0,0,0,0,0,0,0,0
SAN DIEGO,Jun 2015,DCH,2015,CHILD NUTRITION PROGRAM OF SOUTHERN CALIFORNIA INC ,DCH_BREAKFAST,22,0,0,0,0,72293,0,0,72293,3286.0455
SAN DIEGO,Jun 2015,DCH,2015,CHILD NUTRITION PROGRAM OF SOUTHERN CALIFORNIA INC ,DCH_BREAKFAST,,0,0,0,0,0,375,13541,13916,0
SAN DIEGO,Jun 2015,DCH,2015,CHILD NUTRITION PROGRAM OF SOUTHERN CALIFORNIA INC ,DCH_BREAKFAST,22,0,0,0,0,0,0,0,0,0
SAN DIEGO,Jun 2015,DCH,2015,CHILD NUTRITION PROGRAM OF SOUTHERN CALIFORNIA INC ,DCH_BREAKFAST,22,0,0,0,0,0,0,0,0,0
SAN DIEGO,Jun 2015,DCH,2015,CHILD NUTRITION PROGRAM OF SOUTHERN CALIFORNIA INC ,DCH_LUNCH,22,0,0,0,0,94079,0,0,94079,4276.3182
SAN DIEGO,Jun 2015,DCH,2015,CHILD NUTRITION PROGRAM OF SOUTHERN CALIFORNIA INC ,DCH_LUNCH,,0,0,0,0,0,624,18104,18728,0
SAN DIEGO,Jun 2015,DCH,2015,CHILD NUTRITION PROGRAM OF SOUTHERN CALIFORNIA INC ,DCH_LUNCH,22,0,0,0,0,0,0,0,0,0
SAN DIEGO,Jun 2015,DCH,2015,CHILD NUTRITION PROGRAM OF SOUTHERN CALIFORNIA INC ,DCH_LUNCH,22,0,0,0,0,0,0,0,0,0
SAN DIEGO,Jun 2015,DCH,2015,CHILD NUTRITION PROGRAM OF SOUTHERN CALIFORNIA INC ,DCH_SNACK_AM,22,0,0,0,0,39593,0,0,39593,1799.6818
SAN DIEGO,Jun 2015,DCH,2015,CHILD NUTRITION PROGRAM OF SOUTHERN CALIFORNIA INC ,DCH_SNACK_AM,,0,0,0,0,0,307,8877,9184,0
SAN DIEGO,Jun 2015,DCH,2015,CHILD NUTRITION PROGRAM OF SOUTHERN CALIFORNIA INC ,DCH_SNACK_AM,22,0,0,0,0,0,0,0,0,0
SAN DIEGO,Jun 2015,DCH,2015,CHILD NUTRITION PROGRAM OF SOUTHERN CALIFORNIA INC ,DCH_SNACK_AM,22,0,0,0,0,0,0,0,0,0
SAN DIEGO,Jun 2015,DCH,2015,CHILD NUTRITION PROGRAM OF SOUTHERN CALIFORNIA INC ,DCH_SNACK_NT,22,0,0,0,0,2248,0,0,2248,102.1818
SAN DIEGO,Jun 2015,DCH,2015,CHILD NUTRITION PROGRAM OF SOUTHERN CALIFORNIA INC ,DCH_SNACK_NT,,0,0,0,0,0,9,26,35,0
SAN DIEGO,Jun 2015,DCH,2015,CHILD NUTRITION PROGRAM OF SOUTHERN CALIFORNIA INC ,DCH_SNACK_NT,22,0,0,0,0,0,0,0,0,0
SAN DIEGO,Jun 2015,DCH,2015,CHILD NUTRITION PROGRAM OF SOUTHERN CALIFORNIA INC ,DCH_SNACK_NT,22,0,0,0,0,0,0,0,0,0
SAN DIEGO,Jun 2015,DCH,2015,CHILD NUTRITION PROGRAM OF SOUTHERN CALIFORNIA INC ,DCH_SNACK_PM,22,0,0,0,0,70181,0,0,70181,3190.0455
SAN DIEGO,Jun 2015,DCH,2015,CHILD NUTRITION PROGRAM OF SOUTHERN CALIFORNIA INC ,DCH_SNACK_PM,,0,0,0,0,0,351,10680,11031,0
SAN DIEGO,Jun 2015,DCH,2015,CHILD NUTRITION PROGRAM OF SOUTHERN CALIFORNIA INC ,DCH_SNACK_PM,22,0,0,0,0,0,0,0,0,0
SAN DIEGO,Jun 2015,DCH,2015,CHILD NUTRITION PROGRAM OF SOUTHERN CALIFORNIA INC ,DCH_SNACK_PM,22,0,0,0,0,0,0,0,0,0
SAN DIEGO,Jun 2015,DCH,2015,CHILD NUTRITION PROGRAM OF SOUTHERN CALIFORNIA INC ,DCH_SUPPER,22,0,0,0,0,32787,0,0,32787,1490.3182
SAN DIEGO,Jun 2015,DCH,2015,CHILD NUTRITION PROGRAM OF SOUTHERN CALIFORNIA INC ,DCH_SUPPER,,0,0,0,0,0,313,4097,4410,0
SAN DIEGO,Jun 2015,DCH,2015,CHILD NUTRITION PROGRAM OF SOUTHERN CALIFORNIA INC ,DCH_SUPPER,22,0,0,0,0,0,0,0,0,0
SAN DIEGO,Jun 2015,DCH,2015,CHILD NUTRITION PROGRAM OF SOUTHERN CALIFORNIA INC ,DCH_SUPPER,22,0,0,0,0,0,0,0,0,0
SAN DIEGO,Jul 2015,DCH,2015,CHILD NUTRITION PROGRAM OF SOUTHERN CALIFORNIA INC ,DCH_BREAKFAST,23,0,0,0,0,67632,0,0,67632,2940.5217
SAN DIEGO,Jul 2015,DCH,2015,CHILD NUTRITION PROGRAM OF SOUTHERN CALIFORNIA INC ,DCH_BREAKFAST,,0,0,0,0,0,363,12800,13163,0
SAN DIEGO,Jul 2015,DCH,2015,CHILD NUTRITION PROGRAM OF SOUTHERN CALIFORNIA INC ,DCH_BREAKFAST,22,0,0,0,0,0,0,0,0,0
SAN DIEGO,Jul 2015,DCH,2015,CHILD NUTRITION PROGRAM OF SOUTHERN CALIFORNIA INC ,DCH_BREAKFAST,23,0,0,0,0,0,0,0,0,0
SAN DIEGO,Jul 2015,DCH,2015,CHILD NUTRITION PROGRAM OF SOUTHERN CALIFORNIA INC ,DCH_BREAKFAST,22,0,0,0,0,0,0,0,0,0
SAN DIEGO,Jul 2015,DCH,2015,CHILD NUTRITION PROGRAM OF SOUTHERN CALIFORNIA INC ,DCH_LUNCH,23,0,0,0,0,96269,0,0,96269,4185.6087
SAN DIEGO,Jul 2015,DCH,2015,CHILD NUTRITION PROGRAM OF SOUTHERN CALIFORNIA INC ,DCH_LUNCH,,0,0,0,0,0,507,17764,18271,0
SAN DIEGO,Jul 2015,DCH,2015,CHILD NUTRITION PROGRAM OF SOUTHERN CALIFORNIA INC ,DCH_LUNCH,22,0,0,0,0,0,0,0,0,0
SAN DIEGO,Jul 2015,DCH,2015,CHILD NUTRITION PROGRAM OF SOUTHERN CALIFORNIA INC ,DCH_LUNCH,23,0,0,0,0,0,0,0,0,0
SAN DIEGO,Jul 2015,DCH,2015,CHILD NUTRITION PROGRAM OF SOUTHERN CALIFORNIA INC ,DCH_LUNCH,22,0,0,0,0,0,0,0,0,0
SAN DIEGO,Jul 2015,DCH,2015,CHILD NUTRITION PROGRAM OF SOUTHERN CALIFORNIA INC ,DCH_SNACK_AM,23,0,0,0,0,40561,0,0,40561,1763.5217
SAN DIEGO,Jul 2015,DCH,2015,CHILD NUTRITION PROGRAM OF SOUTHERN CALIFORNIA INC ,DCH_SNACK_AM,,0,0,0,0,0,245,8991,9236,0
SAN DIEGO,Jul 2015,DCH,2015,CHILD NUTRITION PROGRAM OF SOUTHERN CALIFORNIA INC ,DCH_SNACK_AM,22,0,0,0,0,0,0,0,0,0
SAN DIEGO,Jul 2015,DCH,2015,CHILD NUTRITION PROGRAM OF SOUTHERN CALIFORNIA INC ,DCH_SNACK_AM,23,0,0,0,0,0,0,0,0,0
SAN DIEGO,Jul 2015,DCH,2015,CHILD NUTRITION PROGRAM OF SOUTHERN CALIFORNIA INC ,DCH_SNACK_AM,22,0,0,0,0,0,0,0,0,0
SAN DIEGO,Jul 2015,DCH,2015,CHILD NUTRITION PROGRAM OF SOUTHERN CALIFORNIA INC ,DCH_SNACK_NT,23,0,0,0,0,2102,0,0,2102,91.3913
SAN DIEGO,Jul 2015,DCH,2015,CHILD NUTRITION PROGRAM OF SOUTHERN CALIFORNIA INC ,DCH_SNACK_NT,,0,0,0,0,0,0,21,21,0
SAN DIEGO,Jul 2015,DCH,2015,CHILD NUTRITION PROGRAM OF SOUTHERN CALIFORNIA INC ,DCH_SNACK_NT,22,0,0,0,0,0,0,0,0,0
SAN DIEGO,Jul 2015,DCH,2015,CHILD NUTRITION PROGRAM OF SOUTHERN CALIFORNIA INC ,DCH_SNACK_NT,23,0,0,0,0,0,0,0,0,0
SAN DIEGO,Jul 2015,DCH,2015,CHILD NUTRITION PROGRAM OF SOUTHERN CALIFORNIA INC ,DCH_SNACK_NT,22,0,0,0,0,0,0,0,0,0
SAN DIEGO,Jul 2015,DCH,2015,CHILD NUTRITION PROGRAM OF SOUTHERN CALIFORNIA INC ,DCH_SNACK_PM,23,0,0,0,0,64910,0,0,64910,2822.1739
SAN DIEGO,Jul 2015,DCH,2015,CHILD NUTRITION PROGRAM OF SOUTHERN CALIFORNIA INC ,DCH_SNACK_PM,,0,0,0,0,0,269,9864,10133,0
SAN DIEGO,Jul 2015,DCH,2015,CHILD NUTRITION PROGRAM OF SOUTHERN CALIFORNIA INC ,DCH_SNACK_PM,22,0,0,0,0,0,0,0,0,0
SAN DIEGO,Jul 2015,DCH,2015,CHILD NUTRITION PROGRAM OF SOUTHERN CALIFORNIA INC ,DCH_SNACK_PM,23,0,0,0,0,0,0,0,0,0
SAN DIEGO,Jul 2015,DCH,2015,CHILD NUTRITION PROGRAM OF SOUTHERN CALIFORNIA INC ,DCH_SNACK_PM,22,0,0,0,0,0,0,0,0,0
SAN DIEGO,Jul 2015,DCH,2015,CHILD NUTRITION PROGRAM OF SOUTHERN CALIFORNIA INC ,DCH_SUPPER,23,0,0,0,0,31628,0,0,31628,1375.1304
SAN DIEGO,Jul 2015,DCH,2015,CHILD NUTRITION PROGRAM OF SOUTHERN CALIFORNIA INC ,DCH_SUPPER,,0,0,0,0,0,172,4263,4435,0
SAN DIEGO,Jul 2015,DCH,2015,CHILD NUTRITION PROGRAM OF SOUTHERN CALIFORNIA INC ,DCH_SUPPER,22,0,0,0,0,0,0,0,0,0
SAN DIEGO,Jul 2015,DCH,2015,CHILD NUTRITION PROGRAM OF SOUTHERN CALIFORNIA INC ,DCH_SUPPER,23,0,0,0,0,0,0,0,0,0
SAN DIEGO,Jul 2015,DCH,2015,CHILD NUTRITION PROGRAM OF SOUTHERN CALIFORNIA INC ,DCH_SUPPER,22,0,0,0,0,0,0,0,0,0
SAN DIEGO,Aug 2015,DCH,2015,CHILD NUTRITION PROGRAM OF SOUTHERN CALIFORNIA INC ,DCH_BREAKFAST,21,0,0,0,0,67570,0,0,67570,3217.619
SAN DIEGO,Aug 2015,DCH,2015,CHILD NUTRITION PROGRAM OF SOUTHERN CALIFORNIA INC ,DCH_BREAKFAST,,0,0,0,0,0,310,12935,13245,0
SAN DIEGO,Aug 2015,DCH,2015,CHILD NUTRITION PROGRAM OF SOUTHERN CALIFORNIA INC ,DCH_BREAKFAST,21,0,0,0,0,0,0,0,0,0
SAN DIEGO,Aug 2015,DCH,2015,CHILD NUTRITION PROGRAM OF SOUTHERN CALIFORNIA INC ,DCH_BREAKFAST,21,0,0,0,0,0,0,0,0,0
SAN DIEGO,Aug 2015,DCH,2015,CHILD NUTRITION PROGRAM OF SOUTHERN CALIFORNIA INC ,DCH_BREAKFAST,21,0,0,0,0,0,0,0,0,0
SAN DIEGO,Aug 2015,DCH,2015,CHILD NUTRITION PROGRAM OF SOUTHERN CALIFORNIA INC ,DCH_LUNCH,21,0,0,0,0,81648,0,0,81648,3888
SAN DIEGO,Aug 2015,DCH,2015,CHILD NUTRITION PROGRAM OF SOUTHERN CALIFORNIA INC ,DCH_LUNCH,,0,0,0,0,0,414,16274,16688,0
SAN DIEGO,Aug 2015,DCH,2015,CHILD NUTRITION PROGRAM OF SOUTHERN CALIFORNIA INC ,DCH_LUNCH,21,0,0,0,0,0,0,0,0,0
SAN DIEGO,Aug 2015,DCH,2015,CHILD NUTRITION PROGRAM OF SOUTHERN CALIFORNIA INC ,DCH_LUNCH,21,0,0,0,0,0,0,0,0,0
SAN DIEGO,Aug 2015,DCH,2015,CHILD NUTRITION PROGRAM OF SOUTHERN CALIFORNIA INC ,DCH_LUNCH,21,0,0,0,0,0,0,0,0,0
SAN DIEGO,Aug 2015,DCH,2015,CHILD NUTRITION PROGRAM OF SOUTHERN CALIFORNIA INC ,DCH_SNACK_AM,21,0,0,0,0,34171,0,0,34171,1627.1905
SAN DIEGO,Aug 2015,DCH,2015,CHILD NUTRITION PROGRAM OF SOUTHERN CALIFORNIA INC ,DCH_SNACK_AM,,0,0,0,0,0,238,8290,8528,0
SAN DIEGO,Aug 2015,DCH,2015,CHILD NUTRITION PROGRAM OF SOUTHERN CALIFORNIA INC ,DCH_SNACK_AM,21,0,0,0,0,0,0,0,0,0
SAN DIEGO,Aug 2015,DCH,2015,CHILD NUTRITION PROGRAM OF SOUTHERN CALIFORNIA INC ,DCH_SNACK_AM,21,0,0,0,0,0,0,0,0,0
SAN DIEGO,Aug 2015,DCH,2015,CHILD NUTRITION PROGRAM OF SOUTHERN CALIFORNIA INC ,DCH_SNACK_AM,21,0,0,0,0,0,0,0,0,0
SAN DIEGO,Aug 2015,DCH,2015,CHILD NUTRITION PROGRAM OF SOUTHERN CALIFORNIA INC ,DCH_SNACK_NT,21,0,0,0,0,2239,0,0,2239,106.619
SAN DIEGO,Aug 2015,DCH,2015,CHILD NUTRITION PROGRAM OF SOUTHERN CALIFORNIA INC ,DCH_SNACK_NT,,0,0,0,0,0,1,42,43,0
SAN DIEGO,Aug 2015,DCH,2015,CHILD NUTRITION PROGRAM OF SOUTHERN CALIFORNIA INC ,DCH_SNACK_NT,21,0,0,0,0,0,0,0,0,0
SAN DIEGO,Aug 2015,DCH,2015,CHILD NUTRITION PROGRAM OF SOUTHERN CALIFORNIA INC ,DCH_SNACK_NT,21,0,0,0,0,0,0,0,0,0
SAN DIEGO,Aug 2015,DCH,2015,CHILD NUTRITION PROGRAM OF SOUTHERN CALIFORNIA INC ,DCH_SNACK_NT,21,0,0,0,0,0,0,0,0,0
SAN DIEGO,Aug 2015,DCH,2015,CHILD NUTRITION PROGRAM OF SOUTHERN CALIFORNIA INC ,DCH_SNACK_PM,21,0,0,0,0,66968,0,0,66968,3188.9524
SAN DIEGO,Aug 2015,DCH,2015,CHILD NUTRITION PROGRAM OF SOUTHERN CALIFORNIA INC ,DCH_SNACK_PM,,0,0,0,0,0,252,9940,10192,0
SAN DIEGO,Aug 2015,DCH,2015,CHILD NUTRITION PROGRAM OF SOUTHERN CALIFORNIA INC ,DCH_SNACK_PM,21,0,0,0,0,0,0,0,0,0
SAN DIEGO,Aug 2015,DCH,2015,CHILD NUTRITION PROGRAM OF SOUTHERN CALIFORNIA INC ,DCH_SNACK_PM,21,0,0,0,0,0,0,0,0,0
SAN DIEGO,Aug 2015,DCH,2015,CHILD NUTRITION PROGRAM OF SOUTHERN CALIFORNIA INC ,DCH_SNACK_PM,21,0,0,0,0,0,0,0,0,0
SAN DIEGO,Aug 2015,DCH,2015,CHILD NUTRITION PROGRAM OF SOUTHERN CALIFORNIA INC ,DCH_SUPPER,21,0,0,0,0,30925,0,0,30925,1472.619
SAN DIEGO,Aug 2015,DCH,2015,CHILD NUTRITION PROGRAM OF SOUTHERN CALIFORNIA INC ,DCH_SUPPER,,0,0,0,0,0,172,3645,3817,0
SAN DIEGO,Aug 2015,DCH,2015,CHILD NUTRITION PROGRAM OF SOUTHERN CALIFORNIA INC ,DCH_SUPPER,21,0,0,0,0,0,0,0,0,0
SAN DIEGO,Aug 2015,DCH,2015,CHILD NUTRITION PROGRAM OF SOUTHERN CALIFORNIA INC ,DCH_SUPPER,21,0,0,0,0,0,0,0,0,0
SAN DIEGO,Aug 2015,DCH,2015,CHILD NUTRITION PROGRAM OF SOUTHERN CALIFORNIA INC ,DCH_SUPPER,21,0,0,0,0,0,0,0,0,0
SAN DIEGO,Sep 2015,DCH,2015,CHILD NUTRITION PROGRAM OF SOUTHERN CALIFORNIA INC ,DCH_BREAKFAST,21,0,0,0,0,70930,0,0,70930,3377.619
SAN DIEGO,Sep 2015,DCH,2015,CHILD NUTRITION PROGRAM OF SOUTHERN CALIFORNIA INC ,DCH_BREAKFAST,,0,0,0,0,0,415,12288,12703,0
SAN DIEGO,Sep 2015,DCH,2015,CHILD NUTRITION PROGRAM OF SOUTHERN CALIFORNIA INC ,DCH_BREAKFAST,15,0,0,0,0,0,0,0,0,0
SAN DIEGO,Sep 2015,DCH,2015,CHILD NUTRITION PROGRAM OF SOUTHERN CALIFORNIA INC ,DCH_BREAKFAST,21,0,0,0,0,0,0,0,0,0
SAN DIEGO,Sep 2015,DCH,2015,CHILD NUTRITION PROGRAM OF SOUTHERN CALIFORNIA INC ,DCH_BREAKFAST,21,0,0,0,0,0,0,0,0,0
SAN DIEGO,Sep 2015,DCH,2015,CHILD NUTRITION PROGRAM OF SOUTHERN CALIFORNIA INC ,DCH_LUNCH,21,0,0,0,0,74048,0,0,74048,3526.0952
SAN DIEGO,Sep 2015,DCH,2015,CHILD NUTRITION PROGRAM OF SOUTHERN CALIFORNIA INC ,DCH_LUNCH,,0,0,0,0,0,556,15757,16313,0
SAN DIEGO,Sep 2015,DCH,2015,CHILD NUTRITION PROGRAM OF SOUTHERN CALIFORNIA INC ,DCH_LUNCH,15,0,0,0,0,0,0,0,0,0
SAN DIEGO,Sep 2015,DCH,2015,CHILD NUTRITION PROGRAM OF SOUTHERN CALIFORNIA INC ,DCH_LUNCH,21,0,0,0,0,0,0,0,0,0
SAN DIEGO,Sep 2015,DCH,2015,CHILD NUTRITION PROGRAM OF SOUTHERN CALIFORNIA INC ,DCH_LUNCH,21,0,0,0,0,0,0,0,0,0
SAN DIEGO,Sep 2015,DCH,2015,CHILD NUTRITION PROGRAM OF SOUTHERN CALIFORNIA INC ,DCH_SNACK_AM,21,0,0,0,0,31404,0,0,31404,1495.4286
SAN DIEGO,Sep 2015,DCH,2015,CHILD NUTRITION PROGRAM OF SOUTHERN CALIFORNIA INC ,DCH_SNACK_AM,,0,0,0,0,0,236,7569,7805,0
SAN DIEGO,Sep 2015,DCH,2015,CHILD NUTRITION PROGRAM OF SOUTHERN CALIFORNIA INC ,DCH_SNACK_AM,15,0,0,0,0,0,0,0,0,0
SAN DIEGO,Sep 2015,DCH,2015,CHILD NUTRITION PROGRAM OF SOUTHERN CALIFORNIA INC ,DCH_SNACK_AM,21,0,0,0,0,0,0,0,0,0
SAN DIEGO,Sep 2015,DCH,2015,CHILD NUTRITION PROGRAM OF SOUTHERN CALIFORNIA INC ,DCH_SNACK_AM,21,0,0,0,0,0,0,0,0,0
SAN DIEGO,Sep 2015,DCH,2015,CHILD NUTRITION PROGRAM OF SOUTHERN CALIFORNIA INC ,DCH_SNACK_NT,21,0,0,0,0,2458,0,0,2458,117.0476
SAN DIEGO,Sep 2015,DCH,2015,CHILD NUTRITION PROGRAM OF SOUTHERN CALIFORNIA INC ,DCH_SNACK_NT,,0,0,0,0,0,11,92,103,0
SAN DIEGO,Sep 2015,DCH,2015,CHILD NUTRITION PROGRAM OF SOUTHERN CALIFORNIA INC ,DCH_SNACK_NT,15,0,0,0,0,0,0,0,0,0
SAN DIEGO,Sep 2015,DCH,2015,CHILD NUTRITION PROGRAM OF SOUTHERN CALIFORNIA INC ,DCH_SNACK_NT,21,0,0,0,0,0,0,0,0,0
SAN DIEGO,Sep 2015,DCH,2015,CHILD NUTRITION PROGRAM OF SOUTHERN CALIFORNIA INC ,DCH_SNACK_NT,21,0,0,0,0,0,0,0,0,0
SAN DIEGO,Sep 2015,DCH,2015,CHILD NUTRITION PROGRAM OF SOUTHERN CALIFORNIA INC ,DCH_SNACK_PM,21,0,0,0,0,71835,0,0,71835,3420.7143
SAN DIEGO,Sep 2015,DCH,2015,CHILD NUTRITION PROGRAM OF SOUTHERN CALIFORNIA INC ,DCH_SNACK_PM,,0,0,0,0,0,408,10814,11222,0
SAN DIEGO,Sep 2015,DCH,2015,CHILD NUTRITION PROGRAM OF SOUTHERN CALIFORNIA INC ,DCH_SNACK_PM,15,0,0,0,0,0,0,0,0,0
SAN DIEGO,Sep 2015,DCH,2015,CHILD NUTRITION PROGRAM OF SOUTHERN CALIFORNIA INC ,DCH_SNACK_PM,21,0,0,0,0,0,0,0,0,0
SAN DIEGO,Sep 2015,DCH,2015,CHILD NUTRITION PROGRAM OF SOUTHERN CALIFORNIA INC ,DCH_SNACK_PM,21,0,0,0,0,0,0,0,0,0
SAN DIEGO,Sep 2015,DCH,2015,CHILD NUTRITION PROGRAM OF SOUTHERN CALIFORNIA INC ,DCH_SUPPER,21,0,0,0,0,32121,0,0,32121,1529.5714
SAN DIEGO,Sep 2015,DCH,2015,CHILD NUTRITION PROGRAM OF SOUTHERN CALIFORNIA INC ,DCH_SUPPER,,0,0,0,0,0,200,3767,3967,0
SAN DIEGO,Sep 2015,DCH,2015,CHILD NUTRITION PROGRAM OF SOUTHERN CALIFORNIA INC ,DCH_SUPPER,15,0,0,0,0,0,0,0,0,0
SAN DIEGO,Sep 2015,DCH,2015,CHILD NUTRITION PROGRAM OF SOUTHERN CALIFORNIA INC ,DCH_SUPPER,21,0,0,0,0,0,0,0,0,0
SAN DIEGO,Sep 2015,DCH,2015,CHILD NUTRITION PROGRAM OF SOUTHERN CALIFORNIA INC ,DCH_SUPPER,21,0,0,0,0,0,0,0,0,0
SAN DIEGO,Oct 2014,CACF,2015,CHILDREN OF THE RAINBOW INC,CHILD_BREAKFAST,23,98,28,12,138,1422,406,175,2003,87.087
SAN DIEGO,Oct 2014,CACF,2015,CHILDREN OF THE RAINBOW INC,CHILD_LUNCH,23,98,28,12,138,1679,480,206,2365,102.8261
SAN DIEGO,Oct 2014,CACF,2015,CHILDREN OF THE RAINBOW INC,CHILD_SNACK_AM,23,98,28,12,138,1645,470,201,2316,100.6957
SAN DIEGO,Oct 2014,CACF,2015,CHILDREN OF THE RAINBOW INC,CHILD_SNACK_PM,23,98,28,12,138,247,71,30,348,15.1304
SAN DIEGO,Nov 2014,CACF,2015,CHILDREN OF THE RAINBOW INC,CHILD_BREAKFAST,17,98,28,12,138,1140,326,140,1606,94.4706
SAN DIEGO,Nov 2014,CACF,2015,CHILDREN OF THE RAINBOW INC,CHILD_LUNCH,17,98,28,12,138,1344,384,164,1892,111.2941
SAN DIEGO,Nov 2014,CACF,2015,CHILDREN OF THE RAINBOW INC,CHILD_SNACK_AM,17,98,28,12,138,1314,375,161,1850,108.8235
SAN DIEGO,Nov 2014,CACF,2015,CHILDREN OF THE RAINBOW INC,CHILD_SNACK_PM,17,98,28,12,138,178,51,22,251,14.7647
SAN DIEGO,Nov 2014,CACF,2015,CHILDREN OF THE RAINBOW INC,CHILD_SUPPER,17,98,28,12,138,11,3,2,16,0.9412
SAN DIEGO,Dec 2014,CACF,2015,CHILDREN OF THE RAINBOW INC,CHILD_BREAKFAST,22,98,28,12,138,1339,382,164,1885,85.6818
SAN DIEGO,Dec 2014,CACF,2015,CHILDREN OF THE RAINBOW INC,CHILD_LUNCH,22,98,28,12,138,1604,458,197,2259,102.6818
SAN DIEGO,Dec 2014,CACF,2015,CHILDREN OF THE RAINBOW INC,CHILD_SNACK_AM,22,98,28,12,138,1530,437,187,2154,97.9091
SAN DIEGO,Dec 2014,CACF,2015,CHILDREN OF THE RAINBOW INC,CHILD_SNACK_PM,22,98,28,12,138,249,71,30,350,15.9091
SAN DIEGO,Dec 2014,CACF,2015,CHILDREN OF THE RAINBOW INC,CHILD_SUPPER,22,98,28,12,138,11,3,2,16,0.7273
SAN DIEGO,Jan 2015,CACF,2015,CHILDREN OF THE RAINBOW INC,CHILD_BREAKFAST,20,98,28,12,138,1336,382,163,1881,94.05
SAN DIEGO,Jan 2015,CACF,2015,CHILDREN OF THE RAINBOW INC,CHILD_LUNCH,20,98,28,12,138,1546,442,189,2177,108.85
SAN DIEGO,Jan 2015,CACF,2015,CHILDREN OF THE RAINBOW INC,CHILD_SNACK_AM,20,98,28,12,138,1510,432,185,2127,106.35
SAN DIEGO,Jan 2015,CACF,2015,CHILDREN OF THE RAINBOW INC,CHILD_SNACK_PM,20,98,28,12,138,204,58,25,287,14.35
SAN DIEGO,Jan 2015,CACF,2015,CHILDREN OF THE RAINBOW INC,CHILD_SUPPER,20,98,28,12,138,3,1,0,4,0.2
SAN DIEGO,Feb 2015,CACF,2015,CHILDREN OF THE RAINBOW INC,CHILD_BREAKFAST,19,98,28,12,138,1413,404,173,1990,104.7368
SAN DIEGO,Feb 2015,CACF,2015,CHILDREN OF THE RAINBOW INC,CHILD_LUNCH,19,98,28,12,138,1648,471,202,2321,122.1579
SAN DIEGO,Feb 2015,CACF,2015,CHILDREN OF THE RAINBOW INC,CHILD_SNACK_AM,19,98,28,12,138,1593,455,195,2243,118.0526
SAN DIEGO,Feb 2015,CACF,2015,CHILDREN OF THE RAINBOW INC,CHILD_SNACK_PM,19,98,28,12,138,245,70,30,345,18.1579
SAN DIEGO,Feb 2015,CACF,2015,CHILDREN OF THE RAINBOW INC,CHILD_SUPPER,19,98,28,12,138,16,5,2,23,1.2105
SAN DIEGO,Mar 2015,CACF,2015,CHILDREN OF THE RAINBOW INC,CHILD_BREAKFAST,21,98,28,12,138,1621,463,199,2283,108.7143
SAN DIEGO,Mar 2015,CACF,2015,CHILDREN OF THE RAINBOW INC,CHILD_LUNCH,21,98,28,12,138,1924,550,236,2710,129.0476
SAN DIEGO,Mar 2015,CACF,2015,CHILDREN OF THE RAINBOW INC,CHILD_SNACK_AM,21,98,28,12,138,1856,530,228,2614,124.4762
SAN DIEGO,Mar 2015,CACF,2015,CHILDREN OF THE RAINBOW INC,CHILD_SNACK_PM,21,98,28,12,138,284,81,35,400,19.0476
SAN DIEGO,Mar 2015,CACF,2015,CHILDREN OF THE RAINBOW INC,CHILD_SUPPER,21,98,28,12,138,29,8,4,41,1.9524
SAN DIEGO,Apr 2015,CACF,2015,CHILDREN OF THE RAINBOW INC,CHILD_BREAKFAST,22,98,28,12,138,1586,453,195,2234,101.5455
SAN DIEGO,Apr 2015,CACF,2015,CHILDREN OF THE RAINBOW INC,CHILD_LUNCH,22,98,28,12,138,1919,548,235,2702,122.8182
SAN DIEGO,Apr 2015,CACF,2015,CHILDREN OF THE RAINBOW INC,CHILD_SNACK_AM,22,98,28,12,138,1830,523,224,2577,117.1364
SAN DIEGO,Apr 2015,CACF,2015,CHILDREN OF THE RAINBOW INC,CHILD_SNACK_PM,22,98,28,12,138,299,85,37,421,19.1364
SAN DIEGO,Apr 2015,CACF,2015,CHILDREN OF THE RAINBOW INC,CHILD_SUPPER,22,98,28,12,138,22,6,3,31,1.4091
SAN DIEGO,May 2015,CACF,2015,CHILDREN OF THE RAINBOW INC,CHILD_BREAKFAST,20,98,28,12,138,1475,421,181,2077,103.85
SAN DIEGO,May 2015,CACF,2015,CHILDREN OF THE RAINBOW INC,CHILD_LUNCH,20,98,28,12,138,1753,501,214,2468,123.4
SAN DIEGO,May 2015,CACF,2015,CHILDREN OF THE RAINBOW INC,CHILD_SNACK_AM,20,98,28,12,138,1677,479,205,2361,118.05
SAN DIEGO,May 2015,CACF,2015,CHILDREN OF THE RAINBOW INC,CHILD_SNACK_PM,20,98,28,12,138,251,72,30,353,17.65
SAN DIEGO,May 2015,CACF,2015,CHILDREN OF THE RAINBOW INC,CHILD_SUPPER,20,98,28,12,138,32,9,4,45,2.25
SAN DIEGO,Jun 2015,CACF,2015,CHILDREN OF THE RAINBOW INC,CHILD_BREAKFAST,22,98,28,12,138,1521,435,186,2142,97.3636
SAN DIEGO,Jun 2015,CACF,2015,CHILDREN OF THE RAINBOW INC,CHILD_LUNCH,22,98,28,12,138,1847,528,226,2601,118.2273
SAN DIEGO,Jun 2015,CACF,2015,CHILDREN OF THE RAINBOW INC,CHILD_SNACK_AM,22,98,28,12,138,1746,499,214,2459,111.7727
SAN DIEGO,Jun 2015,CACF,2015,CHILDREN OF THE RAINBOW INC,CHILD_SNACK_PM,22,98,28,12,138,285,82,35,402,18.2727
SAN DIEGO,Jun 2015,CACF,2015,CHILDREN OF THE RAINBOW INC,CHILD_SUPPER,22,98,28,12,138,41,12,5,58,2.6364
SAN DIEGO,Jul 2015,CACF,2015,CHILDREN OF THE RAINBOW INC,CHILD_BREAKFAST,22,98,28,12,138,1662,475,204,2341,106.4091
SAN DIEGO,Jul 2015,CACF,2015,CHILDREN OF THE RAINBOW INC,CHILD_LUNCH,22,98,28,12,138,2007,573,246,2826,128.4545
SAN DIEGO,Jul 2015,CACF,2015,CHILDREN OF THE RAINBOW INC,CHILD_SNACK_AM,22,98,28,12,138,1912,546,234,2692,122.3636
SAN DIEGO,Jul 2015,CACF,2015,CHILDREN OF THE RAINBOW INC,CHILD_SNACK_PM,22,98,28,12,138,285,82,35,402,18.2727
SAN DIEGO,Jul 2015,CACF,2015,CHILDREN OF THE RAINBOW INC,CHILD_SUPPER,22,98,28,12,138,62,18,7,87,3.9545
SAN DIEGO,Aug 2015,CACF,2015,CHILDREN OF THE RAINBOW INC,CHILD_BREAKFAST,19,98,28,12,138,1208,345,148,1701,89.5263
SAN DIEGO,Aug 2015,CACF,2015,CHILDREN OF THE RAINBOW INC,CHILD_LUNCH,19,98,28,12,138,1525,436,187,2148,113.0526
SAN DIEGO,Aug 2015,CACF,2015,CHILDREN OF THE RAINBOW INC,CHILD_SNACK_AM,19,98,28,12,138,1427,408,174,2009,105.7368
SAN DIEGO,Aug 2015,CACF,2015,CHILDREN OF THE RAINBOW INC,CHILD_SNACK_PM,19,98,28,12,138,290,83,35,408,21.4737
SAN DIEGO,Aug 2015,CACF,2015,CHILDREN OF THE RAINBOW INC,CHILD_SUPPER,19,98,28,12,138,53,15,6,74,3.8947
SAN DIEGO,Sep 2015,CACF,2015,CHILDREN OF THE RAINBOW INC,CHILD_BREAKFAST,21,98,28,12,138,1425,407,175,2007,95.5714
SAN DIEGO,Sep 2015,CACF,2015,CHILDREN OF THE RAINBOW INC,CHILD_LUNCH,21,98,28,12,138,1794,513,219,2526,120.2857
SAN DIEGO,Sep 2015,CACF,2015,CHILDREN OF THE RAINBOW INC,CHILD_SNACK_AM,21,98,28,12,138,1685,481,207,2373,113
SAN DIEGO,Sep 2015,CACF,2015,CHILDREN OF THE RAINBOW INC,CHILD_SNACK_PM,21,98,28,12,138,320,91,39,450,21.4286
SAN DIEGO,Sep 2015,CACF,2015,CHILDREN OF THE RAINBOW INC,CHILD_SUPPER,21,98,28,12,138,65,19,8,92,4.381
SAN DIEGO,Oct 2014,CACF,2015,CHILDRENS PARADISE INC,CHILD_BREAKFAST,23,241,33,152,426,2111,289,1331,3731,162.2174
SAN DIEGO,Oct 2014,CACF,2015,CHILDRENS PARADISE INC,CHILD_LUNCH,23,241,33,152,426,2444,335,1541,4320,187.8261
SAN DIEGO,Oct 2014,CACF,2015,CHILDRENS PARADISE INC,CHILD_SNACK_PM,23,241,33,152,426,2020,277,1274,3571,155.2609
SAN DIEGO,Oct 2014,CACF,2015,CHILDRENS PARADISE INC,HS_CHILD_BREAKFAST,23,179,0,0,179,2661,0,0,2661,115.6957
SAN DIEGO,Oct 2014,CACF,2015,CHILDRENS PARADISE INC,HS_CHILD_LUNCH,23,179,0,0,179,3278,0,0,3278,142.5217
SAN DIEGO,Oct 2014,CACF,2015,CHILDRENS PARADISE INC,HS_CHILD_SNACK_PM,23,179,0,0,179,2057,0,0,2057,89.4348
SAN DIEGO,Oct 2014,CACF,2015,CHILDRENS PARADISE INC,OSCH_CHILD_BREAKFAST,23,93,5,9,107,422,23,41,486,21.1304
SAN DIEGO,Oct 2014,CACF,2015,CHILDRENS PARADISE INC,OSCH_CHILD_LUNCH,23,93,5,9,107,168,9,16,193,8.3913
SAN DIEGO,Oct 2014,CACF,2015,CHILDRENS PARADISE INC,OSCH_CHILD_SNACK_PM,23,93,5,9,107,1384,74,134,1592,69.2174
SAN DIEGO,Nov 2014,CACF,2015,CHILDRENS PARADISE INC,CHILD_BREAKFAST,18,248,33,154,435,1553,207,964,2724,151.3333
SAN DIEGO,Nov 2014,CACF,2015,CHILDRENS PARADISE INC,CHILD_LUNCH,18,248,33,154,435,1874,249,1164,3287,182.6111
SAN DIEGO,Nov 2014,CACF,2015,CHILDRENS PARADISE INC,CHILD_SNACK_PM,18,248,33,154,435,1774,236,1101,3111,172.8333
SAN DIEGO,Nov 2014,CACF,2015,CHILDRENS PARADISE INC,HS_CHILD_BREAKFAST,18,185,0,0,185,1886,0,0,1886,104.7778
SAN DIEGO,Nov 2014,CACF,2015,CHILDRENS PARADISE INC,HS_CHILD_LUNCH,18,185,0,0,185,2208,0,0,2208,122.6667
SAN DIEGO,Nov 2014,CACF,2015,CHILDRENS PARADISE INC,HS_CHILD_SNACK_PM,18,185,0,0,185,1320,0,0,1320,73.3333
SAN DIEGO,Nov 2014,CACF,2015,CHILDRENS PARADISE INC,OSCH_CHILD_BREAKFAST,18,94,5,9,108,259,14,24,297,16.5
SAN DIEGO,Nov 2014,CACF,2015,CHILDRENS PARADISE INC,OSCH_CHILD_LUNCH,18,94,5,9,108,242,13,23,278,15.4444
SAN DIEGO,Nov 2014,CACF,2015,CHILDRENS PARADISE INC,OSCH_CHILD_SNACK_PM,18,94,5,9,108,887,47,85,1019,56.6111
SAN DIEGO,Dec 2014,CACF,2015,CHILDRENS PARADISE INC,CHILD_BREAKFAST,20,248,33,154,435,1573,209,978,2760,138
SAN DIEGO,Dec 2014,CACF,2015,CHILDRENS PARADISE INC,CHILD_LUNCH,20,248,33,154,435,1891,252,1174,3317,165.85
SAN DIEGO,Dec 2014,CACF,2015,CHILDRENS PARADISE INC,CHILD_SNACK_PM,20,248,33,154,435,1530,204,950,2684,134.2
SAN DIEGO,Dec 2014,CACF,2015,CHILDRENS PARADISE INC,HS_CHILD_BREAKFAST,15,183,0,0,183,1958,0,0,1958,130.5333
SAN DIEGO,Dec 2014,CACF,2015,CHILDRENS PARADISE INC,HS_CHILD_LUNCH,15,183,0,0,183,2375,0,0,2375,158.3333
SAN DIEGO,Dec 2014,CACF,2015,CHILDRENS PARADISE INC,HS_CHILD_SNACK_PM,15,183,0,0,183,1452,0,0,1452,96.8
SAN DIEGO,Dec 2014,CACF,2015,CHILDRENS PARADISE INC,OSCH_CHILD_BREAKFAST,20,94,5,9,108,190,10,18,218,10.9
SAN DIEGO,Dec 2014,CACF,2015,CHILDRENS PARADISE INC,OSCH_CHILD_LUNCH,20,94,5,9,108,232,12,22,266,13.3
SAN DIEGO,Dec 2014,CACF,2015,CHILDRENS PARADISE INC,OSCH_CHILD_SNACK_PM,20,94,5,9,108,914,49,87,1050,52.5
SAN DIEGO,Jan 2015,CACF,2015,CHILDRENS PARADISE INC,CHILD_BREAKFAST,21,248,33,154,435,1708,227,1061,2996,142.6667
SAN DIEGO,Jan 2015,CACF,2015,CHILDRENS PARADISE INC,CHILD_LUNCH,21,248,33,154,435,1976,263,1227,3466,165.0476
SAN DIEGO,Jan 2015,CACF,2015,CHILDRENS PARADISE INC,CHILD_SNACK_PM,21,248,33,154,435,1469,196,911,2576,122.6667
SAN DIEGO,Jan 2015,CACF,2015,CHILDRENS PARADISE INC,HS_CHILD_BREAKFAST,21,220,0,0,220,2375,0,0,2375,113.0952
SAN DIEGO,Jan 2015,CACF,2015,CHILDRENS PARADISE INC,HS_CHILD_LUNCH,21,220,0,0,220,3012,0,0,3012,143.4286
SAN DIEGO,Jan 2015,CACF,2015,CHILDRENS PARADISE INC,HS_CHILD_SNACK_PM,21,220,0,0,220,1792,0,0,1792,85.3333
SAN DIEGO,Jan 2015,CACF,2015,CHILDRENS PARADISE INC,OSCH_CHILD_BREAKFAST,21,94,5,9,108,174,9,17,200,9.5238
SAN DIEGO,Jan 2015,CACF,2015,CHILDRENS PARADISE INC,OSCH_CHILD_LUNCH,21,94,5,9,108,220,12,21,253,12.0476
SAN DIEGO,Jan 2015,CACF,2015,CHILDRENS PARADISE INC,OSCH_CHILD_SNACK_PM,21,94,5,9,108,892,47,86,1025,48.8095
SAN DIEGO,Feb 2015,CACF,2015,CHILDRENS PARADISE INC,CHILD_BREAKFAST,19,267,32,149,448,1788,214,998,3000,157.8947
SAN DIEGO,Feb 2015,CACF,2015,CHILDRENS PARADISE INC,CHILD_LUNCH,19,267,32,149,448,2090,250,1166,3506,184.5263
SAN DIEGO,Feb 2015,CACF,2015,CHILDRENS PARADISE INC,CHILD_SNACK_PM,19,267,32,149,448,1539,184,859,2582,135.8947
SAN DIEGO,Feb 2015,CACF,2015,CHILDRENS PARADISE INC,HS_CHILD_BREAKFAST,19,221,0,0,221,2437,0,0,2437,128.2632
SAN DIEGO,Feb 2015,CACF,2015,CHILDRENS PARADISE INC,HS_CHILD_LUNCH,19,221,0,0,221,2983,0,0,2983,157
SAN DIEGO,Feb 2015,CACF,2015,CHILDRENS PARADISE INC,HS_CHILD_SNACK_PM,19,221,0,0,221,1815,0,0,1815,95.5263
SAN DIEGO,Feb 2015,CACF,2015,CHILDRENS PARADISE INC,OSCH_CHILD_BREAKFAST,19,96,5,9,110,417,22,39,478,25.1579
SAN DIEGO,Feb 2015,CACF,2015,CHILDRENS PARADISE INC,OSCH_CHILD_LUNCH,19,96,5,9,110,148,8,14,170,8.9474
SAN DIEGO,Feb 2015,CACF,2015,CHILDRENS PARADISE INC,OSCH_CHILD_SNACK_PM,19,96,5,9,110,871,45,82,998,52.5263
SAN DIEGO,Mar 2015,CACF,2015,CHILDRENS PARADISE INC,CHILD_BREAKFAST,22,267,32,149,448,2039,244,1138,3421,155.5
SAN DIEGO,Mar 2015,CACF,2015,CHILDRENS PARADISE INC,CHILD_LUNCH,22,267,32,149,448,2295,275,1280,3850,175
SAN DIEGO,Mar 2015,CACF,2015,CHILDRENS PARADISE INC,CHILD_SNACK_PM,22,267,32,149,448,1805,216,1008,3029,137.6818
SAN DIEGO,Mar 2015,CACF,2015,CHILDRENS PARADISE INC,HS_CHILD_BREAKFAST,22,240,0,0,240,2556,0,0,2556,116.1818
SAN DIEGO,Mar 2015,CACF,2015,CHILDRENS PARADISE INC,HS_CHILD_LUNCH,22,240,0,0,240,3071,0,0,3071,139.5909
SAN DIEGO,Mar 2015,CACF,2015,CHILDRENS PARADISE INC,HS_CHILD_SNACK_PM,22,240,0,0,240,1967,0,0,1967,89.4091
SAN DIEGO,Mar 2015,CACF,2015,CHILDRENS PARADISE INC,OSCH_CHILD_BREAKFAST,22,96,5,9,110,545,28,51,624,28.3636
SAN DIEGO,Mar 2015,CACF,2015,CHILDRENS PARADISE INC,OSCH_CHILD_LUNCH,22,96,5,9,110,299,16,28,343,15.5909
SAN DIEGO,Mar 2015,CACF,2015,CHILDRENS PARADISE INC,OSCH_CHILD_SNACK_PM,22,96,5,9,110,1061,55,100,1216,55.2727
SAN DIEGO,Apr 2015,CACF,2015,CHILDRENS PARADISE INC,CHILD_BREAKFAST,22,267,32,149,448,1974,236,1102,3312,150.5455
SAN DIEGO,Apr 2015,CACF,2015,CHILDRENS PARADISE INC,CHILD_LUNCH,22,267,32,149,448,2258,271,1260,3789,172.2273
SAN DIEGO,Apr 2015,CACF,2015,CHILDRENS PARADISE INC,CHILD_SNACK_PM,22,267,32,149,448,1844,221,1029,3094,140.6364
SAN DIEGO,Apr 2015,CACF,2015,CHILDRENS PARADISE INC,HS_CHILD_BREAKFAST,22,222,0,0,222,2910,0,0,2910,132.2727
SAN DIEGO,Apr 2015,CACF,2015,CHILDRENS PARADISE INC,HS_CHILD_LUNCH,22,222,0,0,222,3660,0,0,3660,166.3636
SAN DIEGO,Apr 2015,CACF,2015,CHILDRENS PARADISE INC,HS_CHILD_SNACK_PM,22,222,0,0,222,2177,0,0,2177,98.9545
SAN DIEGO,Apr 2015,CACF,2015,CHILDRENS PARADISE INC,OSCH_CHILD_BREAKFAST,22,96,5,9,110,513,27,48,588,26.7273
SAN DIEGO,Apr 2015,CACF,2015,CHILDRENS PARADISE INC,OSCH_CHILD_LUNCH,22,96,5,9,110,193,10,18,221,10.0455
SAN DIEGO,Apr 2015,CACF,2015,CHILDRENS PARADISE INC,OSCH_CHILD_SNACK_PM,22,96,5,9,110,1204,63,113,1380,62.7273
SAN DIEGO,May 2015,CACF,2015,CHILDRENS PARADISE INC,CHILD_BREAKFAST,20,267,32,149,448,1860,223,1037,3120,156
SAN DIEGO,May 2015,CACF,2015,CHILDRENS PARADISE INC,CHILD_LUNCH,20,267,32,149,448,2252,270,1257,3779,188.95
SAN DIEGO,May 2015,CACF,2015,CHILDRENS PARADISE INC,CHILD_SNACK_PM,20,267,32,149,448,1863,223,1039,3125,156.25
SAN DIEGO,May 2015,CACF,2015,CHILDRENS PARADISE INC,HS_CHILD_BREAKFAST,20,230,0,0,230,2553,0,0,2553,127.65
SAN DIEGO,May 2015,CACF,2015,CHILDRENS PARADISE INC,HS_CHILD_LUNCH,20,230,0,0,230,3234,0,0,3234,161.7
SAN DIEGO,May 2015,CACF,2015,CHILDRENS PARADISE INC,HS_CHILD_SNACK_PM,20,230,0,0,230,1891,0,0,1891,94.55
SAN DIEGO,May 2015,CACF,2015,CHILDRENS PARADISE INC,OSCH_CHILD_BREAKFAST,20,96,5,9,110,387,20,36,443,22.15
SAN DIEGO,May 2015,CACF,2015,CHILDRENS PARADISE INC,OSCH_CHILD_LUNCH,20,96,5,9,110,60,3,6,69,3.45
SAN DIEGO,May 2015,CACF,2015,CHILDRENS PARADISE INC,OSCH_CHILD_SNACK_PM,20,96,5,9,110,842,44,79,965,48.25
SAN DIEGO,Jun 2015,CACF,2015,CHILDRENS PARADISE INC,CHILD_BREAKFAST,22,267,32,149,448,1881,225,1050,3156,143.4545
SAN DIEGO,Jun 2015,CACF,2015,CHILDRENS PARADISE INC,CHILD_LUNCH,22,267,32,149,448,2262,271,1262,3795,172.5
SAN DIEGO,Jun 2015,CACF,2015,CHILDRENS PARADISE INC,CHILD_SNACK_PM,22,267,32,149,448,1992,239,1111,3342,151.9091
SAN DIEGO,Jun 2015,CACF,2015,CHILDRENS PARADISE INC,HS_CHILD_BREAKFAST,22,229,0,0,229,1692,0,0,1692,76.9091
SAN DIEGO,Jun 2015,CACF,2015,CHILDRENS PARADISE INC,HS_CHILD_LUNCH,22,229,0,0,229,2335,0,0,2335,106.1364
SAN DIEGO,Jun 2015,CACF,2015,CHILDRENS PARADISE INC,HS_CHILD_SNACK_PM,22,229,0,0,229,1208,0,0,1208,54.9091
SAN DIEGO,Jun 2015,CACF,2015,CHILDRENS PARADISE INC,OSCH_CHILD_BREAKFAST,22,96,5,9,110,701,37,65,803,36.5
SAN DIEGO,Jun 2015,CACF,2015,CHILDRENS PARADISE INC,OSCH_CHILD_LUNCH,22,96,5,9,110,657,34,62,753,34.2273
SAN DIEGO,Jun 2015,CACF,2015,CHILDRENS PARADISE INC,OSCH_CHILD_SNACK_PM,22,96,5,9,110,847,44,79,970,44.0909
SAN DIEGO,Jul 2015,CACF,2015,CHILDRENS PARADISE INC,CHILD_BREAKFAST,22,267,32,149,448,2086,250,1164,3500,159.0909
SAN DIEGO,Jul 2015,CACF,2015,CHILDRENS PARADISE INC,CHILD_LUNCH,22,267,32,149,448,2459,295,1371,4125,187.5
SAN DIEGO,Jul 2015,CACF,2015,CHILDRENS PARADISE INC,CHILD_SNACK_PM,22,267,32,149,448,2189,262,1221,3672,166.9091
SAN DIEGO,Jul 2015,CACF,2015,CHILDRENS PARADISE INC,HS_CHILD_BREAKFAST,22,124,0,0,124,47,0,0,47,2.1364
SAN DIEGO,Jul 2015,CACF,2015,CHILDRENS PARADISE INC,HS_CHILD_LUNCH,22,124,0,0,124,64,0,0,64,2.9091
SAN DIEGO,Jul 2015,CACF,2015,CHILDRENS PARADISE INC,HS_CHILD_SNACK_PM,22,124,0,0,124,53,0,0,53,2.4091
SAN DIEGO,Jul 2015,CACF,2015,CHILDRENS PARADISE INC,OSCH_CHILD_BREAKFAST,22,96,5,9,110,895,47,83,1025,46.5909
SAN DIEGO,Jul 2015,CACF,2015,CHILDRENS PARADISE INC,OSCH_CHILD_LUNCH,22,96,5,9,110,1012,53,95,1160,52.7273
SAN DIEGO,Jul 2015,CACF,2015,CHILDRENS PARADISE INC,OSCH_CHILD_SNACK_PM,22,96,5,9,110,977,51,92,1120,50.9091
SAN DIEGO,Aug 2015,CACF,2015,CHILDRENS PARADISE INC,CHILD_BREAKFAST,21,267,32,149,448,1566,188,874,2628,125.1429
SAN DIEGO,Aug 2015,CACF,2015,CHILDRENS PARADISE INC,CHILD_LUNCH,21,267,32,149,448,2053,246,1146,3445,164.0476
SAN DIEGO,Aug 2015,CACF,2015,CHILDRENS PARADISE INC,CHILD_SNACK_PM,21,267,32,149,448,1810,217,1010,3037,144.619
SAN DIEGO,Aug 2015,CACF,2015,CHILDRENS PARADISE INC,HS_CHILD_BREAKFAST,21,168,0,0,168,761,0,0,761,36.2381
SAN DIEGO,Aug 2015,CACF,2015,CHILDRENS PARADISE INC,HS_CHILD_LUNCH,21,168,0,0,168,971,0,0,971,46.2381
SAN DIEGO,Aug 2015,CACF,2015,CHILDRENS PARADISE INC,HS_CHILD_SNACK_PM,21,168,0,0,168,732,0,0,732,34.8571
SAN DIEGO,Aug 2015,CACF,2015,CHILDRENS PARADISE INC,OSCH_CHILD_BREAKFAST,21,96,5,9,110,665,35,62,762,36.2857
SAN DIEGO,Aug 2015,CACF,2015,CHILDRENS PARADISE INC,OSCH_CHILD_LUNCH,21,96,5,9,110,625,33,58,716,34.0952
SAN DIEGO,Aug 2015,CACF,2015,CHILDRENS PARADISE INC,OSCH_CHILD_SNACK_PM,21,96,5,9,110,1076,56,101,1233,58.7143
SAN DIEGO,Sep 2015,CACF,2015,CHILDRENS PARADISE INC,CHILD_BREAKFAST,21,267,32,149,448,1226,147,684,2057,97.9524
SAN DIEGO,Sep 2015,CACF,2015,CHILDRENS PARADISE INC,CHILD_LUNCH,21,267,32,149,448,1454,174,811,2439,116.1429
SAN DIEGO,Sep 2015,CACF,2015,CHILDRENS PARADISE INC,CHILD_SNACK_PM,21,267,32,149,448,1395,167,778,2340,111.4286
SAN DIEGO,Sep 2015,CACF,2015,CHILDRENS PARADISE INC,HS_CHILD_BREAKFAST,21,319,0,0,319,2764,0,0,2764,131.619
SAN DIEGO,Sep 2015,CACF,2015,CHILDRENS PARADISE INC,HS_CHILD_LUNCH,21,319,0,0,319,3218,0,0,3218,153.2381
SAN DIEGO,Sep 2015,CACF,2015,CHILDRENS PARADISE INC,HS_CHILD_SNACK_PM,21,319,0,0,319,2267,0,0,2267,107.9524
SAN DIEGO,Sep 2015,CACF,2015,CHILDRENS PARADISE INC,OSCH_CHILD_BREAKFAST,21,96,5,9,110,497,26,47,570,27.1429
SAN DIEGO,Sep 2015,CACF,2015,CHILDRENS PARADISE INC,OSCH_CHILD_LUNCH,21,96,5,9,110,241,13,22,276,13.1429
SAN DIEGO,Sep 2015,CACF,2015,CHILDRENS PARADISE INC,OSCH_CHILD_SNACK_PM,21,96,5,9,110,1265,66,118,1449,69
SAN DIEGO,Oct 2014,CACF,2015,Chula Vista Elementary School District,CHILD_BREAKFAST,23,373,106,238,717,3025,859,1931,5815,252.8261
SAN DIEGO,Oct 2014,CACF,2015,Chula Vista Elementary School District,CHILD_LUNCH,23,373,106,238,717,2753,782,1757,5292,230.087
SAN DIEGO,Nov 2014,Cacf,2015,Chula Vista Elementary School District,CHILD_BREAKFAST,14,454,136,160,750,2707,811,954,4472,319.4286
SAN DIEGO,Nov 2014,Cacf,2015,Chula Vista Elementary School District,CHILD_LUNCH,14,454,136,160,750,2531,758,893,4182,298.7143
SAN DIEGO,Dec 2014,CACF,2015,Chula Vista Elementary School District,CHILD_BREAKFAST,15,454,136,160,750,2947,883,1039,4869,324.6
SAN DIEGO,Dec 2014,CACF,2015,Chula Vista Elementary School District,CHILD_LUNCH,15,454,136,160,750,2685,804,946,4435,295.6667
SAN DIEGO,Jan 2015,CACF,2015,Chula Vista Elementary School District,CHILD_BREAKFAST,18,454,136,160,750,2680,803,945,4428,246
SAN DIEGO,Jan 2015,CACF,2015,Chula Vista Elementary School District,CHILD_LUNCH,18,454,136,160,750,2422,726,854,4002,222.3333
SAN DIEGO,Feb 2015,Cacf,2015,Chula Vista Elementary School District,CHILD_BREAKFAST,18,454,136,160,750,3730,1117,1315,6162,342.3333
SAN DIEGO,Feb 2015,Cacf,2015,Chula Vista Elementary School District,CHILD_LUNCH,18,454,136,160,750,3457,1035,1219,5711,317.2778
SAN DIEGO,Mar 2015,CACF,2015,Chula Vista Elementary School District,CHILD_BREAKFAST,20,454,136,160,750,3148,943,1109,5200,260
SAN DIEGO,Mar 2015,CACF,2015,Chula Vista Elementary School District,CHILD_LUNCH,20,454,136,160,750,2855,855,1006,4716,235.8
SAN DIEGO,Apr 2015,Cacf,2015,Chula Vista Elementary School District,CHILD_BREAKFAST,19,454,136,160,750,3911,1172,1379,6462,340.1053
SAN DIEGO,Apr 2015,Cacf,2015,Chula Vista Elementary School District,CHILD_LUNCH,19,454,136,160,750,3614,1082,1274,5970,314.2105
SAN DIEGO,May 2015,Cacf,2015,Chula Vista Elementary School District,CHILD_BREAKFAST,21,454,136,160,750,4113,1232,1450,6795,323.5714
SAN DIEGO,May 2015,Cacf,2015,Chula Vista Elementary School District,CHILD_LUNCH,21,454,136,160,750,3600,1078,1269,5947,283.1905
SAN DIEGO,Jun 2015,CACF,2015,Chula Vista Elementary School District,CHILD_BREAKFAST,14,454,136,160,750,1116,334,393,1843,131.6429
SAN DIEGO,Jun 2015,CACF,2015,Chula Vista Elementary School District,CHILD_LUNCH,14,454,136,160,750,982,294,347,1623,115.9286
SAN DIEGO,Jul 2015,Cacf,2015,Chula Vista Elementary School District,CHILD_BREAKFAST,7,454,136,160,750,1135,340,400,1875,267.8571
SAN DIEGO,Jul 2015,Cacf,2015,Chula Vista Elementary School District,CHILD_LUNCH,7,454,136,160,750,1022,306,361,1689,241.2857
SAN DIEGO,Aug 2015,Cacf,2015,Chula Vista Elementary School District,CHILD_BREAKFAST,21,454,136,160,750,3721,1115,1312,6148,292.7619
SAN DIEGO,Aug 2015,Cacf,2015,Chula Vista Elementary School District,CHILD_LUNCH,21,454,136,160,750,3534,1058,1246,5838,278
SAN DIEGO,Sep 2015,CACF,2015,Chula Vista Elementary School District,CHILD_BREAKFAST,17,454,136,160,750,2685,804,946,4435,260.8824
SAN DIEGO,Sep 2015,CACF,2015,Chula Vista Elementary School District,CHILD_LUNCH,17,454,136,160,750,2537,760,894,4191,246.5294
SAN DIEGO,Oct 2014,CACF,2015,CHURCH OF COMPASSION DAYSPRING CHRISTIAN LRNING CTR,CHILD_BREAKFAST,23,26,2,22,50,372,29,315,716,31.1304
SAN DIEGO,Oct 2014,CACF,2015,CHURCH OF COMPASSION DAYSPRING CHRISTIAN LRNING CTR,CHILD_LUNCH,23,26,2,22,50,488,38,412,938,40.7826
SAN DIEGO,Oct 2014,CACF,2015,CHURCH OF COMPASSION DAYSPRING CHRISTIAN LRNING CTR,CHILD_SNACK_PM,23,26,2,22,50,415,32,351,798,34.6957
SAN DIEGO,Oct 2014,CACF,2015,CHURCH OF COMPASSION DAYSPRING CHRISTIAN LRNING CTR,OSCH_CHILD_BREAKFAST,23,28,1,8,37,174,6,50,230,10
SAN DIEGO,Oct 2014,CACF,2015,CHURCH OF COMPASSION DAYSPRING CHRISTIAN LRNING CTR,OSCH_CHILD_SNACK_PM,23,28,1,8,37,475,17,136,628,27.3043
SAN DIEGO,Nov 2014,CACF,2015,CHURCH OF COMPASSION DAYSPRING CHRISTIAN LRNING CTR,CHILD_BREAKFAST,17,26,2,22,50,278,21,235,534,31.4118
SAN DIEGO,Nov 2014,CACF,2015,CHURCH OF COMPASSION DAYSPRING CHRISTIAN LRNING CTR,CHILD_LUNCH,17,26,2,22,50,365,28,308,701,41.2353
SAN DIEGO,Nov 2014,CACF,2015,CHURCH OF COMPASSION DAYSPRING CHRISTIAN LRNING CTR,CHILD_SNACK_PM,17,26,2,22,50,318,24,270,612,36
SAN DIEGO,Nov 2014,CACF,2015,CHURCH OF COMPASSION DAYSPRING CHRISTIAN LRNING CTR,OSCH_CHILD_BREAKFAST,17,28,1,8,37,164,6,47,217,12.7647
SAN DIEGO,Nov 2014,CACF,2015,CHURCH OF COMPASSION DAYSPRING CHRISTIAN LRNING CTR,OSCH_CHILD_LUNCH,17,28,1,8,37,73,3,21,97,5.7059
SAN DIEGO,Nov 2014,CACF,2015,CHURCH OF COMPASSION DAYSPRING CHRISTIAN LRNING CTR,OSCH_CHILD_SNACK_PM,17,28,1,8,37,293,10,84,387,22.7647
SAN DIEGO,Dec 2014,CACF,2015,CHURCH OF COMPASSION DAYSPRING CHRISTIAN LRNING CTR,CHILD_BREAKFAST,20,26,2,22,50,301,23,255,579,28.95
SAN DIEGO,Dec 2014,CACF,2015,CHURCH OF COMPASSION DAYSPRING CHRISTIAN LRNING CTR,CHILD_LUNCH,20,26,2,22,50,387,30,327,744,37.2
SAN DIEGO,Dec 2014,CACF,2015,CHURCH OF COMPASSION DAYSPRING CHRISTIAN LRNING CTR,CHILD_SNACK_PM,20,26,2,22,50,333,26,282,641,32.05
SAN DIEGO,Dec 2014,CACF,2015,CHURCH OF COMPASSION DAYSPRING CHRISTIAN LRNING CTR,OSCH_CHILD_BREAKFAST,20,28,1,8,37,164,6,47,217,10.85
SAN DIEGO,Dec 2014,CACF,2015,CHURCH OF COMPASSION DAYSPRING CHRISTIAN LRNING CTR,OSCH_CHILD_LUNCH,20,28,1,8,37,35,1,10,46,2.3
SAN DIEGO,Dec 2014,CACF,2015,CHURCH OF COMPASSION DAYSPRING CHRISTIAN LRNING CTR,OSCH_CHILD_SNACK_PM,20,28,1,8,37,265,9,76,350,17.5
SAN DIEGO,Jan 2015,CACF,2015,CHURCH OF COMPASSION DAYSPRING CHRISTIAN LRNING CTR,CHILD_BREAKFAST,20,26,2,22,50,309,24,261,594,29.7
SAN DIEGO,Jan 2015,CACF,2015,CHURCH OF COMPASSION DAYSPRING CHRISTIAN LRNING CTR,CHILD_LUNCH,20,26,2,22,50,417,32,353,802,40.1
SAN DIEGO,Jan 2015,CACF,2015,CHURCH OF COMPASSION DAYSPRING CHRISTIAN LRNING CTR,CHILD_SNACK_PM,20,26,2,22,50,363,28,307,698,34.9
SAN DIEGO,Jan 2015,CACF,2015,CHURCH OF COMPASSION DAYSPRING CHRISTIAN LRNING CTR,OSCH_CHILD_BREAKFAST,20,28,1,8,37,148,5,43,196,9.8
SAN DIEGO,Jan 2015,CACF,2015,CHURCH OF COMPASSION DAYSPRING CHRISTIAN LRNING CTR,OSCH_CHILD_LUNCH,20,28,1,8,37,42,1,12,55,2.75
SAN DIEGO,Jan 2015,CACF,2015,CHURCH OF COMPASSION DAYSPRING CHRISTIAN LRNING CTR,OSCH_CHILD_SNACK_PM,20,28,1,8,37,312,11,89,412,20.6
SAN DIEGO,Feb 2015,CACF,2015,CHURCH OF COMPASSION DAYSPRING CHRISTIAN LRNING CTR,CHILD_BREAKFAST,19,26,2,22,50,308,24,260,592,31.1579
SAN DIEGO,Feb 2015,CACF,2015,CHURCH OF COMPASSION DAYSPRING CHRISTIAN LRNING CTR,CHILD_LUNCH,19,26,2,22,50,439,34,371,844,44.4211
SAN DIEGO,Feb 2015,CACF,2015,CHURCH OF COMPASSION DAYSPRING CHRISTIAN LRNING CTR,CHILD_SNACK_PM,19,26,2,22,50,356,27,302,685,36.0526
SAN DIEGO,Feb 2015,CACF,2015,CHURCH OF COMPASSION DAYSPRING CHRISTIAN LRNING CTR,OSCH_CHILD_BREAKFAST,19,28,1,8,37,156,6,44,206,10.8421
SAN DIEGO,Feb 2015,CACF,2015,CHURCH OF COMPASSION DAYSPRING CHRISTIAN LRNING CTR,OSCH_CHILD_LUNCH,19,28,1,8,37,14,0,4,18,0.9474
SAN DIEGO,Feb 2015,CACF,2015,CHURCH OF COMPASSION DAYSPRING CHRISTIAN LRNING CTR,OSCH_CHILD_SNACK_PM,19,28,1,8,37,319,11,92,422,22.2105
SAN DIEGO,Mar 2015,CACF,2015,CHURCH OF COMPASSION DAYSPRING CHRISTIAN LRNING CTR,CHILD_BREAKFAST,22,26,2,22,50,331,25,280,636,28.9091
SAN DIEGO,Mar 2015,CACF,2015,CHURCH OF COMPASSION DAYSPRING CHRISTIAN LRNING CTR,CHILD_LUNCH,22,26,2,22,50,525,40,445,1010,45.9091
SAN DIEGO,Mar 2015,CACF,2015,CHURCH OF COMPASSION DAYSPRING CHRISTIAN LRNING CTR,CHILD_SNACK_PM,22,26,2,22,50,447,34,379,860,39.0909
SAN DIEGO,Mar 2015,CACF,2015,CHURCH OF COMPASSION DAYSPRING CHRISTIAN LRNING CTR,OSCH_CHILD_BREAKFAST,22,28,1,8,37,186,7,53,246,11.1818
SAN DIEGO,Mar 2015,CACF,2015,CHURCH OF COMPASSION DAYSPRING CHRISTIAN LRNING CTR,OSCH_CHILD_LUNCH,22,28,1,8,37,30,1,8,39,1.7727
SAN DIEGO,Mar 2015,CACF,2015,CHURCH OF COMPASSION DAYSPRING CHRISTIAN LRNING CTR,OSCH_CHILD_SNACK_PM,22,28,1,8,37,352,13,100,465,21.1364
SAN DIEGO,Apr 2015,CACF,2015,CHURCH OF COMPASSION DAYSPRING CHRISTIAN LRNING CTR,CHILD_BREAKFAST,22,26,2,22,50,353,27,299,679,30.8636
SAN DIEGO,Apr 2015,CACF,2015,CHURCH OF COMPASSION DAYSPRING CHRISTIAN LRNING CTR,CHILD_LUNCH,22,26,2,22,50,539,41,457,1037,47.1364
SAN DIEGO,Apr 2015,CACF,2015,CHURCH OF COMPASSION DAYSPRING CHRISTIAN LRNING CTR,CHILD_SNACK_PM,22,26,2,22,50,453,35,384,872,39.6364
SAN DIEGO,Apr 2015,CACF,2015,CHURCH OF COMPASSION DAYSPRING CHRISTIAN LRNING CTR,OSCH_CHILD_BREAKFAST,22,28,1,8,37,188,7,53,248,11.2727
SAN DIEGO,Apr 2015,CACF,2015,CHURCH OF COMPASSION DAYSPRING CHRISTIAN LRNING CTR,OSCH_CHILD_LUNCH,22,28,1,8,37,114,4,32,150,6.8182
SAN DIEGO,Apr 2015,CACF,2015,CHURCH OF COMPASSION DAYSPRING CHRISTIAN LRNING CTR,OSCH_CHILD_SNACK_PM,22,28,1,8,37,331,12,95,438,19.9091
SAN DIEGO,May 2015,CACF,2015,CHURCH OF COMPASSION DAYSPRING CHRISTIAN LRNING CTR,CHILD_BREAKFAST,20,26,2,24,52,309,24,285,618,30.9
SAN DIEGO,May 2015,CACF,2015,CHURCH OF COMPASSION DAYSPRING CHRISTIAN LRNING CTR,CHILD_LUNCH,20,26,2,24,52,504,39,464,1007,50.35
SAN DIEGO,May 2015,CACF,2015,CHURCH OF COMPASSION DAYSPRING CHRISTIAN LRNING CTR,CHILD_SNACK_PM,20,26,2,24,52,431,33,398,862,43.1
SAN DIEGO,May 2015,CACF,2015,CHURCH OF COMPASSION DAYSPRING CHRISTIAN LRNING CTR,OSCH_CHILD_BREAKFAST,20,28,1,8,37,133,5,38,176,8.8
SAN DIEGO,May 2015,CACF,2015,CHURCH OF COMPASSION DAYSPRING CHRISTIAN LRNING CTR,OSCH_CHILD_SNACK_PM,20,28,1,8,37,272,10,77,359,17.95
SAN DIEGO,Jun 2015,CACF,2015,CHURCH OF COMPASSION DAYSPRING CHRISTIAN LRNING CTR,CHILD_BREAKFAST,22,26,2,24,52,332,26,306,664,30.1818
SAN DIEGO,Jun 2015,CACF,2015,CHURCH OF COMPASSION DAYSPRING CHRISTIAN LRNING CTR,CHILD_LUNCH,22,26,2,24,52,516,40,476,1032,46.9091
SAN DIEGO,Jun 2015,CACF,2015,CHURCH OF COMPASSION DAYSPRING CHRISTIAN LRNING CTR,CHILD_SNACK_PM,22,26,2,24,52,443,34,409,886,40.2727
SAN DIEGO,Jun 2015,CACF,2015,CHURCH OF COMPASSION DAYSPRING CHRISTIAN LRNING CTR,OSCH_CHILD_BREAKFAST,22,28,1,8,37,153,5,44,202,9.1818
SAN DIEGO,Jun 2015,CACF,2015,CHURCH OF COMPASSION DAYSPRING CHRISTIAN LRNING CTR,OSCH_CHILD_LUNCH,22,28,1,8,37,107,4,30,141,6.4091
SAN DIEGO,Jun 2015,CACF,2015,CHURCH OF COMPASSION DAYSPRING CHRISTIAN LRNING CTR,OSCH_CHILD_SNACK_PM,22,28,1,8,37,258,9,74,341,15.5
SAN DIEGO,Jul 2015,CACF,2015,CHURCH OF COMPASSION DAYSPRING CHRISTIAN LRNING CTR,CHILD_BREAKFAST,22,26,2,24,52,323,25,297,645,29.3182
SAN DIEGO,Jul 2015,CACF,2015,CHURCH OF COMPASSION DAYSPRING CHRISTIAN LRNING CTR,CHILD_LUNCH,22,26,2,24,52,537,41,495,1073,48.7727
SAN DIEGO,Jul 2015,CACF,2015,CHURCH OF COMPASSION DAYSPRING CHRISTIAN LRNING CTR,CHILD_SNACK_PM,22,26,2,24,52,447,34,413,894,40.6364
SAN DIEGO,Jul 2015,CACF,2015,CHURCH OF COMPASSION DAYSPRING CHRISTIAN LRNING CTR,OSCH_CHILD_BREAKFAST,22,28,1,8,37,256,9,73,338,15.3636
SAN DIEGO,Jul 2015,CACF,2015,CHURCH OF COMPASSION DAYSPRING CHRISTIAN LRNING CTR,OSCH_CHILD_LUNCH,22,28,1,8,37,324,12,92,428,19.4545
SAN DIEGO,Jul 2015,CACF,2015,CHURCH OF COMPASSION DAYSPRING CHRISTIAN LRNING CTR,OSCH_CHILD_SNACK_PM,22,28,1,8,37,274,10,78,362,16.4545
SAN DIEGO,Aug 2015,CACF,2015,CHURCH OF COMPASSION DAYSPRING CHRISTIAN LRNING CTR,CHILD_BREAKFAST,21,26,2,24,52,344,26,317,687,32.7143
SAN DIEGO,Aug 2015,CACF,2015,CHURCH OF COMPASSION DAYSPRING CHRISTIAN LRNING CTR,CHILD_LUNCH,21,26,2,24,52,522,40,481,1043,49.6667
SAN DIEGO,Aug 2015,CACF,2015,CHURCH OF COMPASSION DAYSPRING CHRISTIAN LRNING CTR,CHILD_SNACK_PM,21,26,2,24,52,429,33,396,858,40.8571
SAN DIEGO,Aug 2015,CACF,2015,CHURCH OF COMPASSION DAYSPRING CHRISTIAN LRNING CTR,OSCH_CHILD_BREAKFAST,21,28,1,8,37,212,8,60,280,13.3333
SAN DIEGO,Aug 2015,CACF,2015,CHURCH OF COMPASSION DAYSPRING CHRISTIAN LRNING CTR,OSCH_CHILD_LUNCH,21,28,1,8,37,241,9,69,319,15.1905
SAN DIEGO,Aug 2015,CACF,2015,CHURCH OF COMPASSION DAYSPRING CHRISTIAN LRNING CTR,OSCH_CHILD_SNACK_PM,21,28,1,8,37,244,9,70,323,15.381
SAN DIEGO,Sep 2015,CACF,2015,CHURCH OF COMPASSION DAYSPRING CHRISTIAN LRNING CTR,CHILD_BREAKFAST,20,26,2,24,52,340,26,314,680,34
SAN DIEGO,Sep 2015,CACF,2015,CHURCH OF COMPASSION DAYSPRING CHRISTIAN LRNING CTR,CHILD_LUNCH,20,26,2,24,52,435,33,402,870,43.5
SAN DIEGO,Sep 2015,CACF,2015,CHURCH OF COMPASSION DAYSPRING CHRISTIAN LRNING CTR,CHILD_SNACK_PM,20,26,2,24,52,352,27,325,704,35.2
SAN DIEGO,Sep 2015,CACF,2015,CHURCH OF COMPASSION DAYSPRING CHRISTIAN LRNING CTR,OSCH_CHILD_BREAKFAST,20,28,1,8,37,188,7,54,249,12.45
SAN DIEGO,Sep 2015,CACF,2015,CHURCH OF COMPASSION DAYSPRING CHRISTIAN LRNING CTR,OSCH_CHILD_LUNCH,20,28,1,8,37,104,4,29,137,6.85
SAN DIEGO,Sep 2015,CACF,2015,CHURCH OF COMPASSION DAYSPRING CHRISTIAN LRNING CTR,OSCH_CHILD_SNACK_PM,20,28,1,8,37,282,10,81,373,18.65
SAN DIEGO,Oct 2014,CACF,2015,CLAIREMONT VILLA ADHC INC ,ADULT_BREAKFAST,23,89,0,1,90,1181,0,13,1194,51.913
SAN DIEGO,Oct 2014,CACF,2015,CLAIREMONT VILLA ADHC INC ,ADULT_LUNCH,23,89,0,1,90,1178,0,13,1191,51.7826
SAN DIEGO,Nov 2014,CACF,2015,CLAIREMONT VILLA ADHC INC ,ADULT_BREAKFAST,19,92,0,1,93,1020,0,11,1031,54.2632
SAN DIEGO,Nov 2014,CACF,2015,CLAIREMONT VILLA ADHC INC ,ADULT_LUNCH,19,92,0,1,93,1020,0,11,1031,54.2632
SAN DIEGO,Dec 2014,CACF,2015,CLAIREMONT VILLA ADHC INC ,ADULT_BREAKFAST,22,93,0,0,93,1166,0,0,1166,53
SAN DIEGO,Dec 2014,CACF,2015,CLAIREMONT VILLA ADHC INC ,ADULT_LUNCH,22,93,0,0,93,1163,0,0,1163,52.8636
SAN DIEGO,Jan 2015,CACF,2015,CLAIREMONT VILLA ADHC INC ,ADULT_BREAKFAST,21,95,0,0,95,1087,0,0,1087,51.7619
SAN DIEGO,Jan 2015,CACF,2015,CLAIREMONT VILLA ADHC INC ,ADULT_LUNCH,21,95,0,0,95,1085,0,0,1085,51.6667
SAN DIEGO,Feb 2015,CACF,2015,CLAIREMONT VILLA ADHC INC ,ADULT_BREAKFAST,20,95,0,0,95,1037,0,0,1037,51.85
SAN DIEGO,Feb 2015,CACF,2015,CLAIREMONT VILLA ADHC INC ,ADULT_LUNCH,20,95,0,0,95,1037,0,0,1037,51.85
SAN DIEGO,Mar 2015,CACF,2015,CLAIREMONT VILLA ADHC INC ,ADULT_BREAKFAST,22,95,0,0,95,1191,0,0,1191,54.1364
SAN DIEGO,Mar 2015,CACF,2015,CLAIREMONT VILLA ADHC INC ,ADULT_LUNCH,22,95,0,0,95,1198,0,0,1198,54.4545
SAN DIEGO,Apr 2015,CACF,2015,CLAIREMONT VILLA ADHC INC ,ADULT_BREAKFAST,22,135,0,0,135,1504,0,0,1504,68.3636
SAN DIEGO,Apr 2015,CACF,2015,CLAIREMONT VILLA ADHC INC ,ADULT_LUNCH,22,135,0,0,135,1503,0,0,1503,68.3182
SAN DIEGO,May 2015,CACF,2015,CLAIREMONT VILLA ADHC INC ,ADULT_BREAKFAST,21,135,0,0,135,1493,0,0,1493,71.0952
SAN DIEGO,May 2015,CACF,2015,CLAIREMONT VILLA ADHC INC ,ADULT_LUNCH,21,135,0,0,135,1493,0,0,1493,71.0952
SAN DIEGO,Jun 2015,CACF,2015,CLAIREMONT VILLA ADHC INC ,ADULT_BREAKFAST,22,135,0,0,135,1502,0,0,1502,68.2727
SAN DIEGO,Jun 2015,CACF,2015,CLAIREMONT VILLA ADHC INC ,ADULT_LUNCH,22,135,0,0,135,1498,0,0,1498,68.0909
SAN DIEGO,Jul 2015,CACF,2015,CLAIREMONT VILLA ADHC INC ,ADULT_BREAKFAST,23,140,0,0,140,1569,0,0,1569,68.2174
SAN DIEGO,Jul 2015,CACF,2015,CLAIREMONT VILLA ADHC INC ,ADULT_LUNCH,23,140,0,0,140,1567,0,0,1567,68.1304
SAN DIEGO,Aug 2015,CACF,2015,CLAIREMONT VILLA ADHC INC ,ADULT_BREAKFAST,21,140,0,0,140,1284,0,0,1284,61.1429
SAN DIEGO,Aug 2015,CACF,2015,CLAIREMONT VILLA ADHC INC ,ADULT_LUNCH,21,140,0,0,140,1282,0,0,1282,61.0476
SAN DIEGO,Sep 2015,CACF,2015,CLAIREMONT VILLA ADHC INC ,ADULT_BREAKFAST,21,140,0,0,140,1266,0,0,1266,60.2857
SAN DIEGO,Sep 2015,CACF,2015,CLAIREMONT VILLA ADHC INC ,ADULT_LUNCH,21,140,0,0,140,1266,0,0,1266,60.2857
SAN DIEGO,Oct 2014,CACF,2015,COLES COTTAGE CHILD CENTER INC,CHILD_BREAKFAST,22,10,1,31,42,164,16,509,689,31.3182
SAN DIEGO,Oct 2014,CACF,2015,COLES COTTAGE CHILD CENTER INC,CHILD_LUNCH,22,10,1,31,42,185,18,573,776,35.2727
SAN DIEGO,Oct 2014,CACF,2015,COLES COTTAGE CHILD CENTER INC,CHILD_SNACK_PM,22,10,1,31,42,174,17,538,729,33.1364
SAN DIEGO,Nov 2014,CACF,2015,COLES COTTAGE CHILD CENTER INC,CHILD_BREAKFAST,17,10,1,31,42,123,12,382,517,30.4118
SAN DIEGO,Nov 2014,CACF,2015,COLES COTTAGE CHILD CENTER INC,CHILD_LUNCH,17,10,1,31,42,134,13,415,562,33.0588
SAN DIEGO,Nov 2014,CACF,2015,COLES COTTAGE CHILD CENTER INC,CHILD_SNACK_PM,17,10,1,31,42,127,13,395,535,31.4706
SAN DIEGO,Jan 2015,CACF,2015,COLES COTTAGE CHILD CENTER INC,CHILD_BREAKFAST,21,9,1,30,40,134,15,447,596,28.381
SAN DIEGO,Jan 2015,CACF,2015,COLES COTTAGE CHILD CENTER INC,CHILD_LUNCH,21,9,1,30,40,146,16,488,650,30.9524
SAN DIEGO,Jan 2015,CACF,2015,COLES COTTAGE CHILD CENTER INC,CHILD_SNACK_PM,21,9,1,30,40,142,16,474,632,30.0952
SAN DIEGO,Feb 2015,CACF,2015,COLES COTTAGE CHILD CENTER INC,CHILD_BREAKFAST,19,11,1,31,43,166,15,466,647,34.0526
SAN DIEGO,Feb 2015,CACF,2015,COLES COTTAGE CHILD CENTER INC,CHILD_LUNCH,19,11,1,31,43,182,17,514,713,37.5263
SAN DIEGO,Feb 2015,CACF,2015,COLES COTTAGE CHILD CENTER INC,CHILD_SNACK_PM,19,11,1,31,43,179,16,504,699,36.7895
SAN DIEGO,Mar 2015,CACF,2015,COLES COTTAGE CHILD CENTER INC,CHILD_BREAKFAST,22,10,1,33,44,151,15,499,665,30.2273
SAN DIEGO,Mar 2015,CACF,2015,COLES COTTAGE CHILD CENTER INC,CHILD_LUNCH,22,10,1,33,44,167,17,552,736,33.4545
SAN DIEGO,Mar 2015,CACF,2015,COLES COTTAGE CHILD CENTER INC,CHILD_SNACK_PM,22,10,1,33,44,163,16,536,715,32.5
SAN DIEGO,Apr 2015,CACF,2015,COLES COTTAGE CHILD CENTER INC,CHILD_BREAKFAST,21,9,1,28,38,163,18,509,690,32.8571
SAN DIEGO,Apr 2015,CACF,2015,COLES COTTAGE CHILD CENTER INC,CHILD_LUNCH,21,9,1,28,38,178,20,554,752,35.8095
SAN DIEGO,Apr 2015,CACF,2015,COLES COTTAGE CHILD CENTER INC,CHILD_SNACK_PM,21,9,1,28,38,174,19,541,734,34.9524
SAN DIEGO,Jun 2015,CACF,2015,COLES COTTAGE CHILD CENTER INC,CHILD_BREAKFAST,22,9,1,22,32,180,20,439,639,29.0455
SAN DIEGO,Jun 2015,CACF,2015,COLES COTTAGE CHILD CENTER INC,CHILD_LUNCH,22,9,1,22,32,198,22,484,704,32
SAN DIEGO,Jun 2015,CACF,2015,COLES COTTAGE CHILD CENTER INC,CHILD_SNACK_PM,22,9,1,22,32,197,22,481,700,31.8182
SAN DIEGO,Jul 2015,CACF,2015,COLES COTTAGE CHILD CENTER INC,CHILD_BREAKFAST,22,9,1,21,31,185,21,432,638,29
SAN DIEGO,Jul 2015,CACF,2015,COLES COTTAGE CHILD CENTER INC,CHILD_LUNCH,22,9,1,21,31,198,22,462,682,31
SAN DIEGO,Jul 2015,CACF,2015,COLES COTTAGE CHILD CENTER INC,CHILD_SNACK_PM,22,9,1,21,31,195,22,453,670,30.4545
SAN DIEGO,Aug 2015,CACF,2015,COLES COTTAGE CHILD CENTER INC,CHILD_BREAKFAST,21,9,1,25,35,157,17,435,609,29
SAN DIEGO,Aug 2015,CACF,2015,COLES COTTAGE CHILD CENTER INC,CHILD_LUNCH,21,9,1,25,35,189,21,525,735,35
SAN DIEGO,Aug 2015,CACF,2015,COLES COTTAGE CHILD CENTER INC,CHILD_SNACK_PM,21,9,1,25,35,178,20,495,693,33
SAN DIEGO,Oct 2014,CACF,2015,DINO DAY CARE INC,CHILD_BREAKFAST,23,20,0,12,32,245,0,147,392,17.0435
SAN DIEGO,Oct 2014,CACF,2015,DINO DAY CARE INC,CHILD_LUNCH,23,20,0,12,32,333,0,199,532,23.1304
SAN DIEGO,Oct 2014,CACF,2015,DINO DAY CARE INC,CHILD_SNACK_PM,23,20,0,12,32,269,0,161,430,18.6957
SAN DIEGO,Nov 2014,CACF,2015,DINO DAY CARE INC,CHILD_BREAKFAST,18,20,0,15,35,169,0,126,295,16.3889
SAN DIEGO,Nov 2014,CACF,2015,DINO DAY CARE INC,CHILD_LUNCH,18,20,0,15,35,235,0,176,411,22.8333
SAN DIEGO,Nov 2014,CACF,2015,DINO DAY CARE INC,CHILD_SNACK_PM,18,20,0,15,35,191,0,144,335,18.6111
SAN DIEGO,Dec 2014,CACF,2015,DINO DAY CARE INC,CHILD_BREAKFAST,20,22,1,15,38,168,8,115,291,14.55
SAN DIEGO,Dec 2014,CACF,2015,DINO DAY CARE INC,CHILD_LUNCH,20,22,1,15,38,254,12,172,438,21.9
SAN DIEGO,Dec 2014,CACF,2015,DINO DAY CARE INC,CHILD_SNACK_PM,20,22,1,15,38,221,10,150,381,19.05
SAN DIEGO,Jan 2015,CACF,2015,DINO DAY CARE INC,CHILD_BREAKFAST,21,22,1,15,38,189,9,128,326,15.5238
SAN DIEGO,Jan 2015,CACF,2015,DINO DAY CARE INC,CHILD_LUNCH,21,22,1,15,38,280,13,191,484,23.0476
SAN DIEGO,Jan 2015,CACF,2015,DINO DAY CARE INC,CHILD_SNACK_PM,21,22,1,15,38,179,8,122,309,14.7143
SAN DIEGO,Feb 2015,CACF,2015,DINO DAY CARE INC,CHILD_BREAKFAST,19,22,1,15,38,214,10,145,369,19.4211
SAN DIEGO,Feb 2015,CACF,2015,DINO DAY CARE INC,CHILD_LUNCH,19,22,1,15,38,303,14,207,524,27.5789
SAN DIEGO,Feb 2015,CACF,2015,DINO DAY CARE INC,CHILD_SNACK_PM,19,22,1,15,38,256,12,175,443,23.3158
SAN DIEGO,Mar 2015,CACF,2015,DINO DAY CARE INC,CHILD_BREAKFAST,22,27,2,16,45,263,19,157,439,19.9545
SAN DIEGO,Mar 2015,CACF,2015,DINO DAY CARE INC,CHILD_LUNCH,22,27,2,16,45,400,30,237,667,30.3182
SAN DIEGO,Mar 2015,CACF,2015,DINO DAY CARE INC,CHILD_SNACK_PM,22,27,2,16,45,332,25,196,553,25.1364
SAN DIEGO,Apr 2015,CACF,2015,DINO DAY CARE INC,CHILD_BREAKFAST,22,30,2,15,47,266,18,132,416,18.9091
SAN DIEGO,Apr 2015,CACF,2015,DINO DAY CARE INC,CHILD_LUNCH,22,30,2,15,47,324,22,162,508,23.0909
SAN DIEGO,Apr 2015,CACF,2015,DINO DAY CARE INC,CHILD_SNACK_PM,22,30,2,15,47,333,22,166,521,23.6818
SAN DIEGO,May 2015,CACF,2015,DINO DAY CARE INC,CHILD_BREAKFAST,20,31,2,12,45,268,17,104,389,19.45
SAN DIEGO,May 2015,CACF,2015,DINO DAY CARE INC,CHILD_LUNCH,20,31,2,12,45,384,25,149,558,27.9
SAN DIEGO,May 2015,CACF,2015,DINO DAY CARE INC,CHILD_SNACK_PM,20,31,2,12,45,333,21,129,483,24.15
SAN DIEGO,Jun 2015,CACF,2015,DINO DAY CARE INC,CHILD_BREAKFAST,22,27,2,11,40,280,21,114,415,18.8636
SAN DIEGO,Jun 2015,CACF,2015,DINO DAY CARE INC,CHILD_LUNCH,22,27,2,11,40,420,31,171,622,28.2727
SAN DIEGO,Jun 2015,CACF,2015,DINO DAY CARE INC,CHILD_SNACK_PM,22,27,2,11,40,356,26,146,528,24
SAN DIEGO,Jul 2015,CACF,2015,DINO DAY CARE INC,CHILD_BREAKFAST,22,29,2,11,42,249,17,95,361,16.4091
SAN DIEGO,Jul 2015,CACF,2015,DINO DAY CARE INC,CHILD_LUNCH,22,29,2,11,42,450,31,170,651,29.5909
SAN DIEGO,Jul 2015,CACF,2015,DINO DAY CARE INC,CHILD_SNACK_PM,22,29,2,11,42,392,27,149,568,25.8182
SAN DIEGO,Aug 2015,CACF,2015,DINO DAY CARE INC,CHILD_BREAKFAST,21,33,2,11,46,245,15,81,341,16.2381
SAN DIEGO,Aug 2015,CACF,2015,DINO DAY CARE INC,CHILD_LUNCH,21,33,2,11,46,478,29,159,666,31.7143
SAN DIEGO,Aug 2015,CACF,2015,DINO DAY CARE INC,CHILD_SNACK_PM,21,33,2,11,46,364,22,122,508,24.1905
SAN DIEGO,Sep 2015,CACF,2015,DINO DAY CARE INC,CHILD_BREAKFAST,21,33,2,10,45,279,17,84,380,18.0952
SAN DIEGO,Sep 2015,CACF,2015,DINO DAY CARE INC,CHILD_LUNCH,21,33,2,10,45,460,28,139,627,29.8571
SAN DIEGO,Sep 2015,CACF,2015,DINO DAY CARE INC,CHILD_SNACK_PM,21,33,2,10,45,351,21,106,478,22.7619
SAN DIEGO,Oct 2014,CACF,2015,EAST SAN DIEGO ASSEMBLY OF GOD,ATRISK_CHILD_LUNCH,27,90,0,0,90,1366,0,0,1366,50.5926
SAN DIEGO,Oct 2014,CACF,2015,EAST SAN DIEGO ASSEMBLY OF GOD,ATRISK_CHILD_SNACK_AM,27,90,0,0,90,317,0,0,317,11.7407
SAN DIEGO,Nov 2014,CACF,2015,EAST SAN DIEGO ASSEMBLY OF GOD,ATRISK_CHILD_SNACK_AM,19,79,0,0,79,172,0,0,172,9.0526
SAN DIEGO,Nov 2014,CACF,2015,EAST SAN DIEGO ASSEMBLY OF GOD,ATRISK_CHILD_SUPPER,19,79,0,0,79,898,0,0,898,47.2632
SAN DIEGO,Dec 2014,CACF,2015,EAST SAN DIEGO ASSEMBLY OF GOD,ATRISK_CHILD_LUNCH,21,80,0,0,80,998,0,0,998,47.5238
SAN DIEGO,Dec 2014,CACF,2015,EAST SAN DIEGO ASSEMBLY OF GOD,ATRISK_CHILD_SNACK_AM,21,80,0,0,80,155,0,0,155,7.381
SAN DIEGO,Jan 2015,CACF,2015,EAST SAN DIEGO ASSEMBLY OF GOD,ATRISK_CHILD_LUNCH,15,60,0,0,60,679,0,0,679,45.2667
SAN DIEGO,Jan 2015,CACF,2015,EAST SAN DIEGO ASSEMBLY OF GOD,ATRISK_CHILD_SNACK_AM,15,60,0,0,60,157,0,0,157,10.4667
SAN DIEGO,Feb 2015,CACF,2015,EAST SAN DIEGO ASSEMBLY OF GOD,ATRISK_CHILD_LUNCH,23,70,0,0,70,1215,0,0,1215,52.8261
SAN DIEGO,Feb 2015,CACF,2015,EAST SAN DIEGO ASSEMBLY OF GOD,ATRISK_CHILD_SNACK_AM,23,70,0,0,70,308,0,0,308,13.3913
SAN DIEGO,Mar 2015,CACF,2015,EAST SAN DIEGO ASSEMBLY OF GOD,ATRISK_CHILD_LUNCH,25,74,0,0,74,1106,0,0,1106,44.24
SAN DIEGO,Mar 2015,CACF,2015,EAST SAN DIEGO ASSEMBLY OF GOD,ATRISK_CHILD_SNACK_AM,25,74,0,0,74,244,0,0,244,9.76
SAN DIEGO,Mar 2015,CACF,2015,EAST SAN DIEGO ASSEMBLY OF GOD,ATRISK_CHILD_SUPPER,25,74,0,0,74,116,0,0,116,4.64
SAN DIEGO,Apr 2015,CACF,2015,EAST SAN DIEGO ASSEMBLY OF GOD,ATRISK_CHILD_LUNCH,21,62,0,0,62,693,0,0,693,33
SAN DIEGO,Apr 2015,CACF,2015,EAST SAN DIEGO ASSEMBLY OF GOD,ATRISK_CHILD_SUPPER,21,62,0,0,62,145,0,0,145,6.9048
SAN DIEGO,May 2015,CACF,2015,EAST SAN DIEGO ASSEMBLY OF GOD,ATRISK_CHILD_LUNCH,25,79,0,0,79,1763,0,0,1763,70.52
SAN DIEGO,May 2015,CACF,2015,EAST SAN DIEGO ASSEMBLY OF GOD,ATRISK_CHILD_SNACK_AM,25,79,0,0,79,10,0,0,10,0.4
SAN DIEGO,Jun 2015,CACF,2015,EAST SAN DIEGO ASSEMBLY OF GOD,ATRISK_CHILD_LUNCH,25,101,0,0,101,2085,0,0,2085,83.4
SAN DIEGO,Jul 2015,CACF,2015,EAST SAN DIEGO ASSEMBLY OF GOD,ATRISK_CHILD_LUNCH,25,85,0,0,85,1613,0,0,1613,64.52
SAN DIEGO,Aug 2015,CACF,2015,EAST SAN DIEGO ASSEMBLY OF GOD,ATRISK_CHILD_LUNCH,19,42,0,0,42,704,0,0,704,37.0526
SAN DIEGO,Sep 2015,CACF,2015,EAST SAN DIEGO ASSEMBLY OF GOD,ATRISK_CHILD_LUNCH,21,75,0,0,75,1248,0,0,1248,59.4286
SAN DIEGO,Oct 2014,CACF,2015,EDUCATIONAL ENRICHMENT SYSTEMS INC ,CHILD_BREAKFAST,23,661,182,74,917,8043,2215,900,11158,485.1304
SAN DIEGO,Oct 2014,CACF,2015,EDUCATIONAL ENRICHMENT SYSTEMS INC ,CHILD_LUNCH,23,661,182,74,917,6926,1907,776,9609,417.7826
SAN DIEGO,Oct 2014,CACF,2015,EDUCATIONAL ENRICHMENT SYSTEMS INC ,CHILD_SNACK_AM,23,661,182,74,917,5317,1464,596,7377,320.7391
SAN DIEGO,Oct 2014,CACF,2015,EDUCATIONAL ENRICHMENT SYSTEMS INC ,CHILD_SNACK_PM,23,661,182,74,917,6381,1757,714,8852,384.8696
SAN DIEGO,Nov 2014,CACF,2015,EDUCATIONAL ENRICHMENT SYSTEMS INC ,CHILD_BREAKFAST,18,661,182,74,917,5279,1454,591,7324,406.8889
SAN DIEGO,Nov 2014,CACF,2015,EDUCATIONAL ENRICHMENT SYSTEMS INC ,CHILD_LUNCH,18,661,182,74,917,4990,1374,559,6923,384.6111
SAN DIEGO,Nov 2014,CACF,2015,EDUCATIONAL ENRICHMENT SYSTEMS INC ,CHILD_SNACK_AM,18,661,182,74,917,3062,843,343,4248,236
SAN DIEGO,Nov 2014,CACF,2015,EDUCATIONAL ENRICHMENT SYSTEMS INC ,CHILD_SNACK_PM,18,661,182,74,917,4276,1178,478,5932,329.5556
SAN DIEGO,Dec 2014,CACF,2015,EDUCATIONAL ENRICHMENT SYSTEMS INC ,CHILD_BREAKFAST,22,661,182,74,917,6011,1655,674,8340,379.0909
SAN DIEGO,Dec 2014,CACF,2015,EDUCATIONAL ENRICHMENT SYSTEMS INC ,CHILD_LUNCH,22,661,182,74,917,5629,1550,631,7810,355
SAN DIEGO,Dec 2014,CACF,2015,EDUCATIONAL ENRICHMENT SYSTEMS INC ,CHILD_SNACK_AM,22,661,182,74,917,3644,1004,408,5056,229.8182
SAN DIEGO,Dec 2014,CACF,2015,EDUCATIONAL ENRICHMENT SYSTEMS INC ,CHILD_SNACK_PM,22,661,182,74,917,4922,1356,551,6829,310.4091
SAN DIEGO,Jan 2015,CACF,2015,EDUCATIONAL ENRICHMENT SYSTEMS INC ,CHILD_BREAKFAST,20,661,182,74,917,6179,1702,692,8573,428.65
SAN DIEGO,Jan 2015,CACF,2015,EDUCATIONAL ENRICHMENT SYSTEMS INC ,CHILD_LUNCH,20,661,182,74,917,5800,1597,649,8046,402.3
SAN DIEGO,Jan 2015,CACF,2015,EDUCATIONAL ENRICHMENT SYSTEMS INC ,CHILD_SNACK_AM,20,661,182,74,917,3861,1063,432,5356,267.8
SAN DIEGO,Jan 2015,CACF,2015,EDUCATIONAL ENRICHMENT SYSTEMS INC ,CHILD_SNACK_PM,20,661,182,74,917,5224,1439,585,7248,362.4
SAN DIEGO,Feb 2015,CACF,2015,EDUCATIONAL ENRICHMENT SYSTEMS INC ,CHILD_BREAKFAST,19,661,182,74,917,6900,1900,773,9573,503.8421
SAN DIEGO,Feb 2015,CACF,2015,EDUCATIONAL ENRICHMENT SYSTEMS INC ,CHILD_LUNCH,19,661,182,74,917,6550,1804,733,9087,478.2632
SAN DIEGO,Feb 2015,CACF,2015,EDUCATIONAL ENRICHMENT SYSTEMS INC ,CHILD_SNACK_AM,19,661,182,74,917,4421,1217,495,6133,322.7895
SAN DIEGO,Feb 2015,CACF,2015,EDUCATIONAL ENRICHMENT SYSTEMS INC ,CHILD_SNACK_PM,19,661,182,74,917,5960,1641,668,8269,435.2105
SAN DIEGO,Mar 2015,CACF,2015,EDUCATIONAL ENRICHMENT SYSTEMS INC ,CHILD_BREAKFAST,22,661,182,74,917,7421,2044,831,10296,468
SAN DIEGO,Mar 2015,CACF,2015,EDUCATIONAL ENRICHMENT SYSTEMS INC ,CHILD_LUNCH,22,661,182,74,917,7222,1989,809,10020,455.4545
SAN DIEGO,Mar 2015,CACF,2015,EDUCATIONAL ENRICHMENT SYSTEMS INC ,CHILD_SNACK_AM,22,661,182,74,917,4455,1227,498,6180,280.9091
SAN DIEGO,Mar 2015,CACF,2015,EDUCATIONAL ENRICHMENT SYSTEMS INC ,CHILD_SNACK_PM,22,661,182,74,917,6289,1732,704,8725,396.5909
SAN DIEGO,Apr 2015,CACF,2015,EDUCATIONAL ENRICHMENT SYSTEMS INC ,CHILD_BREAKFAST,22,661,182,74,917,8376,2307,937,11620,528.1818
SAN DIEGO,Apr 2015,CACF,2015,EDUCATIONAL ENRICHMENT SYSTEMS INC ,CHILD_LUNCH,22,661,182,74,917,7937,2186,889,11012,500.5455
SAN DIEGO,Apr 2015,CACF,2015,EDUCATIONAL ENRICHMENT SYSTEMS INC ,CHILD_SNACK_AM,22,661,182,74,917,5369,1478,601,7448,338.5455
SAN DIEGO,Apr 2015,CACF,2015,EDUCATIONAL ENRICHMENT SYSTEMS INC ,CHILD_SNACK_PM,22,661,182,74,917,7205,1984,807,9996,454.3636
SAN DIEGO,May 2015,CACF,2015,EDUCATIONAL ENRICHMENT SYSTEMS INC ,CHILD_BREAKFAST,20,661,182,74,917,7752,2135,868,10755,537.75
SAN DIEGO,May 2015,CACF,2015,EDUCATIONAL ENRICHMENT SYSTEMS INC ,CHILD_LUNCH,20,661,182,74,917,7418,2043,830,10291,514.55
SAN DIEGO,May 2015,CACF,2015,EDUCATIONAL ENRICHMENT SYSTEMS INC ,CHILD_SNACK_AM,20,661,182,74,917,5023,1383,563,6969,348.45
SAN DIEGO,May 2015,CACF,2015,EDUCATIONAL ENRICHMENT SYSTEMS INC ,CHILD_SNACK_PM,20,661,182,74,917,6698,1845,750,9293,464.65
SAN DIEGO,Jun 2015,CACF,2015,EDUCATIONAL ENRICHMENT SYSTEMS INC ,CHILD_BREAKFAST,22,661,182,74,917,5007,1379,561,6947,315.7727
SAN DIEGO,Jun 2015,CACF,2015,EDUCATIONAL ENRICHMENT SYSTEMS INC ,CHILD_LUNCH,22,661,182,74,917,5123,1411,573,7107,323.0455
SAN DIEGO,Jun 2015,CACF,2015,EDUCATIONAL ENRICHMENT SYSTEMS INC ,CHILD_SNACK_AM,22,661,182,74,917,2106,580,236,2922,132.8182
SAN DIEGO,Jun 2015,CACF,2015,EDUCATIONAL ENRICHMENT SYSTEMS INC ,CHILD_SNACK_PM,22,661,182,74,917,4398,1211,492,6101,277.3182
SAN DIEGO,Jul 2015,CACF,2015,EDUCATIONAL ENRICHMENT SYSTEMS INC ,CHILD_BREAKFAST,22,661,182,74,917,3332,918,373,4623,210.1364
SAN DIEGO,Jul 2015,CACF,2015,EDUCATIONAL ENRICHMENT SYSTEMS INC ,CHILD_LUNCH,22,661,182,74,917,3585,987,401,4973,226.0455
SAN DIEGO,Jul 2015,CACF,2015,EDUCATIONAL ENRICHMENT SYSTEMS INC ,CHILD_SNACK_AM,22,661,182,74,917,522,144,58,724,32.9091
SAN DIEGO,Jul 2015,CACF,2015,EDUCATIONAL ENRICHMENT SYSTEMS INC ,CHILD_SNACK_PM,22,661,182,74,917,2738,754,306,3798,172.6364
SAN DIEGO,Aug 2015,CACF,2015,EDUCATIONAL ENRICHMENT SYSTEMS INC ,CHILD_BREAKFAST,21,661,182,74,917,4041,1113,452,5606,266.9524
SAN DIEGO,Aug 2015,CACF,2015,EDUCATIONAL ENRICHMENT SYSTEMS INC ,CHILD_LUNCH,21,661,182,74,917,4124,1136,462,5722,272.4762
SAN DIEGO,Aug 2015,CACF,2015,EDUCATIONAL ENRICHMENT SYSTEMS INC ,CHILD_SNACK_AM,21,661,182,74,917,1550,427,174,2151,102.4286
SAN DIEGO,Aug 2015,CACF,2015,EDUCATIONAL ENRICHMENT SYSTEMS INC ,CHILD_SNACK_PM,21,661,182,74,917,3479,958,389,4826,229.8095
SAN DIEGO,Sep 2015,CACF,2015,EDUCATIONAL ENRICHMENT SYSTEMS INC ,CHILD_BREAKFAST,21,661,182,74,917,7452,2052,835,10339,492.3333
SAN DIEGO,Sep 2015,CACF,2015,EDUCATIONAL ENRICHMENT SYSTEMS INC ,CHILD_LUNCH,21,661,182,74,917,6662,1835,745,9242,440.0952
SAN DIEGO,Sep 2015,CACF,2015,EDUCATIONAL ENRICHMENT SYSTEMS INC ,CHILD_SNACK_AM,21,661,182,74,917,4563,1257,511,6331,301.4762
SAN DIEGO,Sep 2015,CACF,2015,EDUCATIONAL ENRICHMENT SYSTEMS INC ,CHILD_SNACK_PM,21,661,182,74,917,5885,1621,659,8165,388.8095
SAN DIEGO,Oct 2014,CACF,2015,EL CAJON WESLEYAN CHURCH ,CHILD_BREAKFAST,23,3,4,53,60,46,61,815,922,40.087
SAN DIEGO,Oct 2014,CACF,2015,EL CAJON WESLEYAN CHURCH ,CHILD_LUNCH,23,3,4,53,60,46,62,816,924,40.1739
SAN DIEGO,Oct 2014,CACF,2015,EL CAJON WESLEYAN CHURCH ,CHILD_SNACK_PM,23,3,4,53,60,43,57,755,855,37.1739
SAN DIEGO,Nov 2014,CACF,2015,EL CAJON WESLEYAN CHURCH ,CHILD_BREAKFAST,17,3,4,53,60,34,46,604,684,40.2353
SAN DIEGO,Nov 2014,CACF,2015,EL CAJON WESLEYAN CHURCH ,CHILD_LUNCH,17,3,4,53,60,36,47,628,711,41.8235
SAN DIEGO,Nov 2014,CACF,2015,EL CAJON WESLEYAN CHURCH ,CHILD_SNACK_PM,17,3,4,53,60,32,43,567,642,37.7647
SAN DIEGO,Dec 2014,CACF,2015,EL CAJON WESLEYAN CHURCH ,CHILD_BREAKFAST,20,3,4,53,60,40,53,698,791,39.55
SAN DIEGO,Dec 2014,CACF,2015,EL CAJON WESLEYAN CHURCH ,CHILD_LUNCH,20,3,4,53,60,42,56,738,836,41.8
SAN DIEGO,Dec 2014,CACF,2015,EL CAJON WESLEYAN CHURCH ,CHILD_SNACK_PM,20,3,4,53,60,37,50,662,749,37.45
SAN DIEGO,Jan 2015,CACF,2015,EL CAJON WESLEYAN CHURCH ,CHILD_BREAKFAST,20,3,4,53,60,42,56,745,843,42.15
SAN DIEGO,Jan 2015,CACF,2015,EL CAJON WESLEYAN CHURCH ,CHILD_LUNCH,20,3,4,53,60,43,57,750,850,42.5
SAN DIEGO,Jan 2015,CACF,2015,EL CAJON WESLEYAN CHURCH ,CHILD_SNACK_PM,20,3,4,53,60,38,51,679,768,38.4
SAN DIEGO,Feb 2015,CACF,2015,EL CAJON WESLEYAN CHURCH ,CHILD_BREAKFAST,19,3,4,53,60,43,58,763,864,45.4737
SAN DIEGO,Feb 2015,CACF,2015,EL CAJON WESLEYAN CHURCH ,CHILD_LUNCH,19,3,4,53,60,44,59,785,888,46.7368
SAN DIEGO,Feb 2015,CACF,2015,EL CAJON WESLEYAN CHURCH ,CHILD_SNACK_PM,19,3,4,53,60,40,53,698,791,41.6316
SAN DIEGO,Mar 2015,CACF,2015,EL CAJON WESLEYAN CHURCH ,CHILD_BREAKFAST,21,3,4,53,60,54,72,955,1081,51.4762
SAN DIEGO,Mar 2015,CACF,2015,EL CAJON WESLEYAN CHURCH ,CHILD_LUNCH,21,3,4,53,60,53,71,934,1058,50.381
SAN DIEGO,Mar 2015,CACF,2015,EL CAJON WESLEYAN CHURCH ,CHILD_SNACK_PM,21,3,4,53,60,48,65,856,969,46.1429
SAN DIEGO,Apr 2015,CACF,2015,EL CAJON WESLEYAN CHURCH ,CHILD_BREAKFAST,22,3,4,53,60,52,69,915,1036,47.0909
SAN DIEGO,Apr 2015,CACF,2015,EL CAJON WESLEYAN CHURCH ,CHILD_LUNCH,22,3,4,53,60,52,70,926,1048,47.6364
SAN DIEGO,Apr 2015,CACF,2015,EL CAJON WESLEYAN CHURCH ,CHILD_SNACK_PM,22,3,4,53,60,46,61,812,919,41.7727
SAN DIEGO,May 2015,CACF,2015,EL CAJON WESLEYAN CHURCH ,CHILD_BREAKFAST,20,3,4,53,60,51,68,899,1018,50.9
SAN DIEGO,May 2015,CACF,2015,EL CAJON WESLEYAN CHURCH ,CHILD_LUNCH,20,3,4,53,60,53,71,933,1057,52.85
SAN DIEGO,May 2015,CACF,2015,EL CAJON WESLEYAN CHURCH ,CHILD_SNACK_PM,20,3,4,53,60,47,63,834,944,47.2
SAN DIEGO,Jun 2015,CACF,2015,EL CAJON WESLEYAN CHURCH ,CHILD_BREAKFAST,22,3,4,53,60,51,68,899,1018,46.2727
SAN DIEGO,Jun 2015,CACF,2015,EL CAJON WESLEYAN CHURCH ,CHILD_LUNCH,22,3,4,53,60,53,70,932,1055,47.9545
SAN DIEGO,Jun 2015,CACF,2015,EL CAJON WESLEYAN CHURCH ,CHILD_SNACK_PM,22,3,4,53,60,46,62,820,928,42.1818
SAN DIEGO,Jul 2015,CACF,2015,EL CAJON WESLEYAN CHURCH ,CHILD_BREAKFAST,22,3,4,53,60,44,59,780,883,40.1364
SAN DIEGO,Jul 2015,CACF,2015,EL CAJON WESLEYAN CHURCH ,CHILD_LUNCH,22,3,4,53,60,46,62,821,929,42.2273
SAN DIEGO,Jul 2015,CACF,2015,EL CAJON WESLEYAN CHURCH ,CHILD_SNACK_PM,22,3,4,53,60,40,54,715,809,36.7727
SAN DIEGO,Aug 2015,CACF,2015,EL CAJON WESLEYAN CHURCH ,CHILD_BREAKFAST,18,3,4,53,60,38,51,677,766,42.5556
SAN DIEGO,Aug 2015,CACF,2015,EL CAJON WESLEYAN CHURCH ,CHILD_LUNCH,18,3,4,53,60,40,53,707,800,44.4444
SAN DIEGO,Aug 2015,CACF,2015,EL CAJON WESLEYAN CHURCH ,CHILD_SNACK_PM,18,3,4,53,60,35,47,627,709,39.3889
SAN DIEGO,Sep 2015,CACF,2015,EL CAJON WESLEYAN CHURCH ,CHILD_BREAKFAST,21,3,4,53,60,45,60,790,895,42.619
SAN DIEGO,Sep 2015,CACF,2015,EL CAJON WESLEYAN CHURCH ,CHILD_LUNCH,21,3,4,53,60,47,63,836,946,45.0476
SAN DIEGO,Sep 2015,CACF,2015,EL CAJON WESLEYAN CHURCH ,CHILD_SNACK_PM,21,3,4,53,60,41,55,730,826,39.3333
SAN DIEGO,Oct 2014,CACF,2015,EPISCOPAL COMMUNITY SERVICES ,HS_CHILD_BREAKFAST,21,1225,0,0,1225,10989,0,0,10989,523.2857
SAN DIEGO,Oct 2014,CACF,2015,EPISCOPAL COMMUNITY SERVICES ,HS_CHILD_LUNCH,21,1225,0,0,1225,16966,0,0,16966,807.9048
SAN DIEGO,Oct 2014,CACF,2015,EPISCOPAL COMMUNITY SERVICES ,HS_CHILD_SNACK_PM,21,1225,0,0,1225,9151,0,0,9151,435.7619
SAN DIEGO,Nov 2014,CACF,2015,EPISCOPAL COMMUNITY SERVICES ,HS_CHILD_BREAKFAST,16,1225,0,0,1225,7767,0,0,7767,485.4375
SAN DIEGO,Nov 2014,CACF,2015,EPISCOPAL COMMUNITY SERVICES ,HS_CHILD_LUNCH,16,1225,0,0,1225,11416,0,0,11416,713.5
SAN DIEGO,Nov 2014,CACF,2015,EPISCOPAL COMMUNITY SERVICES ,HS_CHILD_SNACK_PM,16,1225,0,0,1225,6290,0,0,6290,393.125
SAN DIEGO,Dec 2014,CACF,2015,EPISCOPAL COMMUNITY SERVICES ,HS_CHILD_BREAKFAST,15,1293,0,0,1293,8036,0,0,8036,535.7333
SAN DIEGO,Dec 2014,CACF,2015,EPISCOPAL COMMUNITY SERVICES ,HS_CHILD_LUNCH,15,1293,0,0,1293,12726,0,0,12726,848.4
SAN DIEGO,Dec 2014,CACF,2015,EPISCOPAL COMMUNITY SERVICES ,HS_CHILD_SNACK_PM,15,1293,0,0,1293,7113,0,0,7113,474.2
SAN DIEGO,Jan 2015,CACF,2015,EPISCOPAL COMMUNITY SERVICES ,HS_CHILD_BREAKFAST,18,1293,0,0,1293,9703,0,0,9703,539.0556
SAN DIEGO,Jan 2015,CACF,2015,EPISCOPAL COMMUNITY SERVICES ,HS_CHILD_LUNCH,18,1293,0,0,1293,15191,0,0,15191,843.9444
SAN DIEGO,Jan 2015,CACF,2015,EPISCOPAL COMMUNITY SERVICES ,HS_CHILD_SNACK_PM,18,1293,0,0,1293,8886,0,0,8886,493.6667
SAN DIEGO,Feb 2015,CACF,2015,EPISCOPAL COMMUNITY SERVICES ,HS_CHILD_BREAKFAST,18,1293,0,0,1293,10404,0,0,10404,578
SAN DIEGO,Feb 2015,CACF,2015,EPISCOPAL COMMUNITY SERVICES ,HS_CHILD_LUNCH,18,1293,0,0,1293,16299,0,0,16299,905.5
SAN DIEGO,Feb 2015,CACF,2015,EPISCOPAL COMMUNITY SERVICES ,HS_CHILD_SNACK_PM,18,1293,0,0,1293,9172,0,0,9172,509.5556
SAN DIEGO,Mar 2015,CACF,2015,EPISCOPAL COMMUNITY SERVICES ,HS_CHILD_BREAKFAST,20,1293,0,0,1293,10331,0,0,10331,516.55
SAN DIEGO,Mar 2015,CACF,2015,EPISCOPAL COMMUNITY SERVICES ,HS_CHILD_LUNCH,20,1293,0,0,1293,16583,0,0,16583,829.15
SAN DIEGO,Mar 2015,CACF,2015,EPISCOPAL COMMUNITY SERVICES ,HS_CHILD_SNACK_PM,20,1293,0,0,1293,9481,0,0,9481,474.05
SAN DIEGO,Apr 2015,CACF,2015,EPISCOPAL COMMUNITY SERVICES ,HS_CHILD_BREAKFAST,20,1293,0,0,1293,10689,0,0,10689,534.45
SAN DIEGO,Apr 2015,CACF,2015,EPISCOPAL COMMUNITY SERVICES ,HS_CHILD_LUNCH,20,1293,0,0,1293,17039,0,0,17039,851.95
SAN DIEGO,Apr 2015,CACF,2015,EPISCOPAL COMMUNITY SERVICES ,HS_CHILD_SNACK_PM,20,1293,0,0,1293,9919,0,0,9919,495.95
SAN DIEGO,May 2015,CACF,2015,EPISCOPAL COMMUNITY SERVICES ,HS_CHILD_BREAKFAST,19,1293,0,0,1293,9907,0,0,9907,521.4211
SAN DIEGO,May 2015,CACF,2015,EPISCOPAL COMMUNITY SERVICES ,HS_CHILD_LUNCH,19,1293,0,0,1293,15804,0,0,15804,831.7895
SAN DIEGO,May 2015,CACF,2015,EPISCOPAL COMMUNITY SERVICES ,HS_CHILD_SNACK_PM,19,1293,0,0,1293,9106,0,0,9106,479.2632
SAN DIEGO,Jun 2015,CACF,2015,EPISCOPAL COMMUNITY SERVICES ,HS_CHILD_BREAKFAST,15,1293,0,0,1293,5703,0,0,5703,380.2
SAN DIEGO,Jun 2015,CACF,2015,EPISCOPAL COMMUNITY SERVICES ,HS_CHILD_LUNCH,15,1293,0,0,1293,9030,0,0,9030,602
SAN DIEGO,Jun 2015,CACF,2015,EPISCOPAL COMMUNITY SERVICES ,HS_CHILD_SNACK_PM,15,1293,0,0,1293,5181,0,0,5181,345.4
SAN DIEGO,Jul 2015,CACF,2015,EPISCOPAL COMMUNITY SERVICES ,CHILD_BREAKFAST,10,1293,0,0,1293,463,0,0,463,46.3
SAN DIEGO,Jul 2015,CACF,2015,EPISCOPAL COMMUNITY SERVICES ,CHILD_LUNCH,10,1293,0,0,1293,472,0,0,472,47.2
SAN DIEGO,Jul 2015,CACF,2015,EPISCOPAL COMMUNITY SERVICES ,CHILD_SNACK_PM,10,1293,0,0,1293,260,0,0,260,26
SAN DIEGO,Jul 2015,CACF,2015,EPISCOPAL COMMUNITY SERVICES ,HS_CHILD_BREAKFAST,10,1129,0,0,1129,1129,0,0,1129,112.9
SAN DIEGO,Jul 2015,CACF,2015,EPISCOPAL COMMUNITY SERVICES ,HS_CHILD_LUNCH,10,1129,0,0,1129,1171,0,0,1171,117.1
SAN DIEGO,Jul 2015,CACF,2015,EPISCOPAL COMMUNITY SERVICES ,HS_CHILD_SNACK_PM,10,1129,0,0,1129,1166,0,0,1166,116.6
SAN DIEGO,Aug 2015,CACF,2015,EPISCOPAL COMMUNITY SERVICES ,CHILD_BREAKFAST,20,1293,0,0,1293,1004,0,0,1004,50.2
SAN DIEGO,Aug 2015,CACF,2015,EPISCOPAL COMMUNITY SERVICES ,CHILD_LUNCH,20,1293,0,0,1293,1011,0,0,1011,50.55
SAN DIEGO,Aug 2015,CACF,2015,EPISCOPAL COMMUNITY SERVICES ,CHILD_SNACK_PM,20,1293,0,0,1293,451,0,0,451,22.55
SAN DIEGO,Aug 2015,CACF,2015,EPISCOPAL COMMUNITY SERVICES ,HS_CHILD_BREAKFAST,20,1293,0,0,1293,4582,0,0,4582,229.1
SAN DIEGO,Aug 2015,CACF,2015,EPISCOPAL COMMUNITY SERVICES ,HS_CHILD_LUNCH,20,1293,0,0,1293,4790,0,0,4790,239.5
SAN DIEGO,Aug 2015,CACF,2015,EPISCOPAL COMMUNITY SERVICES ,HS_CHILD_SNACK_PM,20,1293,0,0,1293,4195,0,0,4195,209.75
SAN DIEGO,Sep 2015,CACF,2015,EPISCOPAL COMMUNITY SERVICES ,CHILD_BREAKFAST,19,1293,0,0,1293,921,0,0,921,48.4737
SAN DIEGO,Sep 2015,CACF,2015,EPISCOPAL COMMUNITY SERVICES ,CHILD_LUNCH,19,1293,0,0,1293,943,0,0,943,49.6316
SAN DIEGO,Sep 2015,CACF,2015,EPISCOPAL COMMUNITY SERVICES ,CHILD_SNACK_PM,19,1293,0,0,1293,431,0,0,431,22.6842
SAN DIEGO,Sep 2015,CACF,2015,EPISCOPAL COMMUNITY SERVICES ,HS_CHILD_BREAKFAST,19,586,0,0,586,8214,0,0,8214,432.3158
SAN DIEGO,Sep 2015,CACF,2015,EPISCOPAL COMMUNITY SERVICES ,HS_CHILD_LUNCH,19,586,0,0,586,10175,0,0,10175,535.5263
SAN DIEGO,Sep 2015,CACF,2015,EPISCOPAL COMMUNITY SERVICES ,HS_CHILD_SNACK_PM,19,586,0,0,586,5763,0,0,5763,303.3158
SAN DIEGO,Oct 2014,CACF,2015,ESCONDIDO COMMUNITY CHILD DEVELOPMENT CTR,CHILD_BREAKFAST,23,318,47,10,375,4855,717,153,5725,248.913
SAN DIEGO,Oct 2014,CACF,2015,ESCONDIDO COMMUNITY CHILD DEVELOPMENT CTR,CHILD_LUNCH,23,318,47,10,375,5451,805,172,6428,279.4783
SAN DIEGO,Oct 2014,CACF,2015,ESCONDIDO COMMUNITY CHILD DEVELOPMENT CTR,CHILD_SNACK_PM,23,318,47,10,375,4353,643,137,5133,223.1739
SAN DIEGO,Nov 2014,CACF,2015,ESCONDIDO COMMUNITY CHILD DEVELOPMENT CTR,CHILD_BREAKFAST,18,318,47,10,375,3616,534,114,4264,236.8889
SAN DIEGO,Nov 2014,CACF,2015,ESCONDIDO COMMUNITY CHILD DEVELOPMENT CTR,CHILD_LUNCH,18,318,47,10,375,4070,601,128,4799,266.6111
SAN DIEGO,Nov 2014,CACF,2015,ESCONDIDO COMMUNITY CHILD DEVELOPMENT CTR,CHILD_SNACK_PM,18,318,47,10,375,3057,452,96,3605,200.2778
SAN DIEGO,Dec 2014,CACF,2015,ESCONDIDO COMMUNITY CHILD DEVELOPMENT CTR,CHILD_BREAKFAST,21,318,47,10,375,3802,562,120,4484,213.5238
SAN DIEGO,Dec 2014,CACF,2015,ESCONDIDO COMMUNITY CHILD DEVELOPMENT CTR,CHILD_LUNCH,21,318,47,10,375,4330,640,136,5106,243.1429
SAN DIEGO,Dec 2014,CACF,2015,ESCONDIDO COMMUNITY CHILD DEVELOPMENT CTR,CHILD_SNACK_PM,21,318,47,10,375,3535,522,112,4169,198.5238
SAN DIEGO,Jan 2015,CACF,2015,ESCONDIDO COMMUNITY CHILD DEVELOPMENT CTR,CHILD_BREAKFAST,20,318,47,10,375,3828,566,120,4514,225.7
SAN DIEGO,Jan 2015,CACF,2015,ESCONDIDO COMMUNITY CHILD DEVELOPMENT CTR,CHILD_LUNCH,20,318,47,10,375,4367,645,138,5150,257.5
SAN DIEGO,Jan 2015,CACF,2015,ESCONDIDO COMMUNITY CHILD DEVELOPMENT CTR,CHILD_SNACK_PM,20,318,47,10,375,3570,528,112,4210,210.5
SAN DIEGO,Feb 2015,CACF,2015,ESCONDIDO COMMUNITY CHILD DEVELOPMENT CTR,CHILD_BREAKFAST,20,318,47,10,375,3790,560,119,4469,223.45
SAN DIEGO,Feb 2015,CACF,2015,ESCONDIDO COMMUNITY CHILD DEVELOPMENT CTR,CHILD_LUNCH,20,318,47,10,375,4290,634,135,5059,252.95
SAN DIEGO,Feb 2015,CACF,2015,ESCONDIDO COMMUNITY CHILD DEVELOPMENT CTR,CHILD_SNACK_PM,20,318,47,10,375,3366,497,106,3969,198.45
SAN DIEGO,Mar 2015,CACF,2015,ESCONDIDO COMMUNITY CHILD DEVELOPMENT CTR,CHILD_BREAKFAST,22,318,47,10,375,4140,612,130,4882,221.9091
SAN DIEGO,Mar 2015,CACF,2015,ESCONDIDO COMMUNITY CHILD DEVELOPMENT CTR,CHILD_LUNCH,22,318,47,10,375,4735,700,149,5584,253.8182
SAN DIEGO,Mar 2015,CACF,2015,ESCONDIDO COMMUNITY CHILD DEVELOPMENT CTR,CHILD_SNACK_PM,22,318,47,10,375,3782,559,119,4460,202.7273
SAN DIEGO,Apr 2015,CACF,2015,ESCONDIDO COMMUNITY CHILD DEVELOPMENT CTR,CHILD_BREAKFAST,22,318,47,10,375,4208,622,132,4962,225.5455
SAN DIEGO,Apr 2015,CACF,2015,ESCONDIDO COMMUNITY CHILD DEVELOPMENT CTR,CHILD_LUNCH,22,318,47,10,375,4921,727,155,5803,263.7727
SAN DIEGO,Apr 2015,CACF,2015,ESCONDIDO COMMUNITY CHILD DEVELOPMENT CTR,CHILD_SNACK_PM,22,318,47,10,375,3920,579,124,4623,210.1364
SAN DIEGO,May 2015,CACF,2015,ESCONDIDO COMMUNITY CHILD DEVELOPMENT CTR,CHILD_BREAKFAST,20,318,47,10,375,3977,588,125,4690,234.5
SAN DIEGO,May 2015,CACF,2015,ESCONDIDO COMMUNITY CHILD DEVELOPMENT CTR,CHILD_LUNCH,20,318,47,10,375,4531,669,143,5343,267.15
SAN DIEGO,May 2015,CACF,2015,ESCONDIDO COMMUNITY CHILD DEVELOPMENT CTR,CHILD_SNACK_PM,20,318,47,10,375,3569,527,113,4209,210.45
SAN DIEGO,Jun 2015,CACF,2015,ESCONDIDO COMMUNITY CHILD DEVELOPMENT CTR,CHILD_BREAKFAST,22,318,47,10,375,4436,655,140,5231,237.7727
SAN DIEGO,Jun 2015,CACF,2015,ESCONDIDO COMMUNITY CHILD DEVELOPMENT CTR,CHILD_LUNCH,22,318,47,10,375,4951,732,156,5839,265.4091
SAN DIEGO,Jun 2015,CACF,2015,ESCONDIDO COMMUNITY CHILD DEVELOPMENT CTR,CHILD_SNACK_PM,22,318,47,10,375,4003,591,126,4720,214.5455
SAN DIEGO,Jul 2015,CACF,2015,ESCONDIDO COMMUNITY CHILD DEVELOPMENT CTR,CHILD_BREAKFAST,20,318,47,10,375,3523,521,111,4155,207.75
SAN DIEGO,Jul 2015,CACF,2015,ESCONDIDO COMMUNITY CHILD DEVELOPMENT CTR,CHILD_LUNCH,20,318,47,10,375,4041,597,127,4765,238.25
SAN DIEGO,Jul 2015,CACF,2015,ESCONDIDO COMMUNITY CHILD DEVELOPMENT CTR,CHILD_SNACK_PM,20,318,47,10,375,3432,507,108,4047,202.35
SAN DIEGO,Aug 2015,CACF,2015,ESCONDIDO COMMUNITY CHILD DEVELOPMENT CTR,CHILD_BREAKFAST,21,318,47,10,375,3918,579,123,4620,220
SAN DIEGO,Aug 2015,CACF,2015,ESCONDIDO COMMUNITY CHILD DEVELOPMENT CTR,CHILD_LUNCH,21,318,47,10,375,4406,651,139,5196,247.4286
SAN DIEGO,Aug 2015,CACF,2015,ESCONDIDO COMMUNITY CHILD DEVELOPMENT CTR,CHILD_SNACK_PM,21,318,47,10,375,3776,558,119,4453,212.0476
SAN DIEGO,Sep 2015,CACF,2015,ESCONDIDO COMMUNITY CHILD DEVELOPMENT CTR,CHILD_BREAKFAST,21,318,47,10,375,3992,590,126,4708,224.1905
SAN DIEGO,Sep 2015,CACF,2015,ESCONDIDO COMMUNITY CHILD DEVELOPMENT CTR,CHILD_LUNCH,21,318,47,10,375,4472,661,140,5273,251.0952
SAN DIEGO,Sep 2015,CACF,2015,ESCONDIDO COMMUNITY CHILD DEVELOPMENT CTR,CHILD_SNACK_PM,21,318,47,10,375,3825,565,121,4511,214.8095
SAN DIEGO,Oct 2014,CACF,2015,Escondido Union High School District,ATRISK_CHILD_SUPPER,23,5211,0,0,5211,5211,0,0,5211,226.5652
SAN DIEGO,Oct 2014,CACF,2015,Escondido Union High School District,CHILD_BREAKFAST,23,20,2,0,22,295,29,0,324,14.087
SAN DIEGO,Oct 2014,CACF,2015,Escondido Union High School District,CHILD_LUNCH,23,20,2,0,22,305,31,0,336,14.6087
SAN DIEGO,Oct 2014,CACF,2015,Escondido Union High School District,CHILD_SNACK_PM,23,20,2,0,22,116,12,0,128,5.5652
SAN DIEGO,Nov 2014,CACF,2015,Escondido Union High School District,ATRISK_CHILD_SUPPER,14,2539,0,0,2539,2539,0,0,2539,181.3571
SAN DIEGO,Nov 2014,CACF,2015,Escondido Union High School District,CHILD_BREAKFAST,14,20,2,0,22,185,18,0,203,14.5
SAN DIEGO,Nov 2014,CACF,2015,Escondido Union High School District,CHILD_LUNCH,14,20,2,0,22,192,19,0,211,15.0714
SAN DIEGO,Nov 2014,CACF,2015,Escondido Union High School District,CHILD_SNACK_PM,14,20,2,0,22,57,6,0,63,4.5
SAN DIEGO,Dec 2014,CACF,2015,Escondido Union High School District,ATRISK_CHILD_SUPPER,12,2142,0,0,2142,2142,0,0,2142,178.5
SAN DIEGO,Dec 2014,CACF,2015,Escondido Union High School District,CHILD_BREAKFAST,15,20,2,0,22,169,17,0,186,12.4
SAN DIEGO,Dec 2014,CACF,2015,Escondido Union High School District,CHILD_LUNCH,15,20,2,0,22,169,17,0,186,12.4
SAN DIEGO,Dec 2014,CACF,2015,Escondido Union High School District,CHILD_SNACK_PM,15,20,2,0,22,23,2,0,25,1.6667
SAN DIEGO,Jan 2015,CACF,2015,Escondido Union High School District,ATRISK_CHILD_SUPPER,18,3116,0,0,3116,3116,0,0,3116,173.1111
SAN DIEGO,Jan 2015,CACF,2015,Escondido Union High School District,CHILD_BREAKFAST,18,20,2,0,22,207,21,0,228,12.6667
SAN DIEGO,Jan 2015,CACF,2015,Escondido Union High School District,CHILD_LUNCH,18,20,2,0,22,228,23,0,251,13.9444
SAN DIEGO,Jan 2015,CACF,2015,Escondido Union High School District,CHILD_SNACK_PM,18,20,2,0,22,67,7,0,74,4.1111
SAN DIEGO,Feb 2015,CACF,2015,Escondido Union High School District,ATRISK_CHILD_SUPPER,18,4226,0,0,4226,4226,0,0,4226,234.7778
SAN DIEGO,Feb 2015,CACF,2015,Escondido Union High School District,CHILD_BREAKFAST,18,20,2,0,22,227,23,0,250,13.8889
SAN DIEGO,Feb 2015,CACF,2015,Escondido Union High School District,CHILD_LUNCH,18,20,2,0,22,247,25,0,272,15.1111
SAN DIEGO,Feb 2015,CACF,2015,Escondido Union High School District,CHILD_SNACK_PM,18,20,2,0,22,75,7,0,82,4.5556
SAN DIEGO,Mar 2015,CACF,2015,Escondido Union High School District,ATRISK_CHILD_SUPPER,20,3605,0,0,3605,3605,0,0,3605,180.25
SAN DIEGO,Mar 2015,CACF,2015,Escondido Union High School District,CHILD_BREAKFAST,20,20,2,0,22,222,22,0,244,12.2
SAN DIEGO,Mar 2015,CACF,2015,Escondido Union High School District,CHILD_LUNCH,20,20,2,0,22,239,24,0,263,13.15
SAN DIEGO,Mar 2015,CACF,2015,Escondido Union High School District,CHILD_SNACK_PM,20,20,2,0,22,92,9,0,101,5.05
SAN DIEGO,Apr 2015,CACF,2015,Escondido Union High School District,ATRISK_CHILD_SUPPER,18,3145,0,0,3145,3145,0,0,3145,174.7222
SAN DIEGO,Apr 2015,CACF,2015,Escondido Union High School District,CHILD_BREAKFAST,18,20,2,0,22,205,21,0,226,12.5556
SAN DIEGO,Apr 2015,CACF,2015,Escondido Union High School District,CHILD_LUNCH,18,20,2,0,22,212,21,0,233,12.9444
SAN DIEGO,Apr 2015,CACF,2015,Escondido Union High School District,CHILD_SNACK_PM,18,20,2,0,22,73,7,0,80,4.4444
SAN DIEGO,May 2015,CACF,2015,Escondido Union High School District,ATRISK_CHILD_SUPPER,20,3633,0,0,3633,3633,0,0,3633,181.65
SAN DIEGO,May 2015,CACF,2015,Escondido Union High School District,CHILD_BREAKFAST,20,20,2,0,22,242,24,0,266,13.3
SAN DIEGO,May 2015,CACF,2015,Escondido Union High School District,CHILD_LUNCH,20,20,2,0,22,255,25,0,280,14
SAN DIEGO,May 2015,CACF,2015,Escondido Union High School District,CHILD_SNACK_PM,20,20,2,0,22,74,7,0,81,4.05
SAN DIEGO,Jun 2015,CACF,2015,Escondido Union High School District,CHILD_BREAKFAST,3,20,2,0,22,22,2,0,24,8
SAN DIEGO,Jun 2015,CACF,2015,Escondido Union High School District,CHILD_LUNCH,3,20,2,0,22,23,2,0,25,8.3333
SAN DIEGO,Jun 2015,CACF,2015,Escondido Union High School District,CHILD_SNACK_PM,3,20,2,0,22,7,1,0,8,2.6667
SAN DIEGO,Aug 2015,CACF,2015,Escondido Union High School District,ATRISK_CHILD_SUPPER,6,1033,0,0,1033,1033,0,0,1033,172.1667
SAN DIEGO,Aug 2015,CACF,2015,Escondido Union High School District,CHILD_BREAKFAST,11,18,0,0,18,123,0,0,123,11.1818
SAN DIEGO,Aug 2015,CACF,2015,Escondido Union High School District,CHILD_LUNCH,11,18,0,0,18,118,0,0,118,10.7273
SAN DIEGO,Aug 2015,CACF,2015,Escondido Union High School District,CHILD_SNACK_PM,11,18,0,0,18,81,0,0,81,7.3636
SAN DIEGO,Sep 2015,CACF,2015,Escondido Union High School District,ATRISK_CHILD_SUPPER,20,3887,0,0,3887,3887,0,0,3887,194.35
SAN DIEGO,Sep 2015,CACF,2015,Escondido Union High School District,CHILD_BREAKFAST,21,18,0,0,18,198,0,0,198,9.4286
SAN DIEGO,Sep 2015,CACF,2015,Escondido Union High School District,CHILD_LUNCH,21,18,0,0,18,191,0,0,191,9.0952
SAN DIEGO,Sep 2015,CACF,2015,Escondido Union High School District,CHILD_SNACK_PM,21,18,0,0,18,134,0,0,134,6.381
SAN DIEGO,Oct 2014,CACF,2015,Escondido Union School District,ATRISK_CHILD_SNACK,21,8346,0,0,8346,10175,0,0,10175,484.5238
SAN DIEGO,Oct 2014,CACF,2015,Escondido Union School District,ATRISK_CHILD_SUPPER,21,8346,0,0,8346,24087,0,0,24087,1147
SAN DIEGO,Nov 2014,CACF,2015,Escondido Union School District,ATRISK_CHILD_SNACK,14,9028,0,0,9028,4131,0,0,4131,295.0714
SAN DIEGO,Nov 2014,CACF,2015,Escondido Union School District,ATRISK_CHILD_SUPPER,14,9028,0,0,9028,20647,0,0,20647,1474.7857
SAN DIEGO,Dec 2014,CACF,2015,Escondido Union School District,ATRISK_CHILD_SNACK,15,8998,0,0,8998,4436,0,0,4436,295.7333
SAN DIEGO,Dec 2014,CACF,2015,Escondido Union School District,ATRISK_CHILD_SUPPER,15,8998,0,0,8998,21793,0,0,21793,1452.8667
SAN DIEGO,Jan 2015,CACF,2015,Escondido Union School District,ATRISK_CHILD_SNACK,18,9050,0,0,9050,4343,0,0,4343,241.2778
SAN DIEGO,Jan 2015,CACF,2015,Escondido Union School District,ATRISK_CHILD_SUPPER,18,9050,0,0,9050,26792,0,0,26792,1488.4444
SAN DIEGO,Feb 2015,CACF,2015,Escondido Union School District,ATRISK_CHILD_SNACK,18,9068,0,0,9068,4250,0,0,4250,236.1111
SAN DIEGO,Feb 2015,CACF,2015,Escondido Union School District,ATRISK_CHILD_SUPPER,18,9068,0,0,9068,28931,0,0,28931,1607.2778
SAN DIEGO,Mar 2015,CACF,2015,Escondido Union School District,ATRISK_CHILD_LUNCH,22,9547,0,0,9547,147,0,0,147,6.6818
SAN DIEGO,Mar 2015,CACF,2015,Escondido Union School District,ATRISK_CHILD_SNACK,22,9547,0,0,9547,5282,0,0,5282,240.0909
SAN DIEGO,Mar 2015,CACF,2015,Escondido Union School District,ATRISK_CHILD_SUPPER,22,9547,0,0,9547,31431,0,0,31431,1428.6818
SAN DIEGO,Apr 2015,CACF,2015,Escondido Union School District,ATRISK_CHILD_LUNCH,22,9547,0,0,9547,518,0,0,518,23.5455
SAN DIEGO,Apr 2015,CACF,2015,Escondido Union School District,ATRISK_CHILD_SNACK,22,9547,0,0,9547,4241,0,0,4241,192.7727
SAN DIEGO,Apr 2015,CACF,2015,Escondido Union School District,ATRISK_CHILD_SUPPER,22,9547,0,0,9547,22205,0,0,22205,1009.3182
SAN DIEGO,May 2015,CACF,2015,Escondido Union School District,ATRISK_CHILD_SNACK,20,9065,0,0,9065,4035,0,0,4035,201.75
SAN DIEGO,May 2015,CACF,2015,Escondido Union School District,ATRISK_CHILD_SUPPER,20,9065,0,0,9065,31417,0,0,31417,1570.85
SAN DIEGO,Jun 2015,CACF,2015,Escondido Union School District,ATRISK_CHILD_SNACK,20,9038,0,0,9038,1953,0,0,1953,97.65
SAN DIEGO,Jun 2015,CACF,2015,Escondido Union School District,ATRISK_CHILD_SUPPER,20,9038,0,0,9038,13914,0,0,13914,695.7
SAN DIEGO,Aug 2015,CACF,2015,Escondido Union School District,ATRISK_CHILD_SNACK,11,8810,0,0,8810,3117,0,0,3117,283.3636
SAN DIEGO,Aug 2015,CACF,2015,Escondido Union School District,ATRISK_CHILD_SUPPER,11,8810,0,0,8810,17076,0,0,17076,1552.3636
SAN DIEGO,Sep 2015,CACF,2015,Escondido Union School District,ATRISK_CHILD_SNACK,21,8620,0,0,8620,6494,0,0,6494,309.2381
SAN DIEGO,Sep 2015,CACF,2015,Escondido Union School District,ATRISK_CHILD_SUPPER,21,8620,0,0,8620,32688,0,0,32688,1556.5714
SAN DIEGO,Oct 2014,CACF,2015,FALLBROOK CHILD DEVELOP CENTER ,CHILD_BREAKFAST,23,37,6,4,47,707,115,76,898,39.0435
SAN DIEGO,Oct 2014,CACF,2015,FALLBROOK CHILD DEVELOP CENTER ,CHILD_LUNCH,23,37,6,4,47,694,113,75,882,38.3478
SAN DIEGO,Oct 2014,CACF,2015,FALLBROOK CHILD DEVELOP CENTER ,CHILD_SNACK_PM,23,37,6,4,47,547,89,59,695,30.2174
SAN DIEGO,Nov 2014,CACF,2015,FALLBROOK CHILD DEVELOP CENTER ,CHILD_BREAKFAST,18,37,6,4,47,511,83,55,649,36.0556
SAN DIEGO,Nov 2014,CACF,2015,FALLBROOK CHILD DEVELOP CENTER ,CHILD_LUNCH,18,37,6,4,47,498,81,54,633,35.1667
SAN DIEGO,Nov 2014,CACF,2015,FALLBROOK CHILD DEVELOP CENTER ,CHILD_SNACK_PM,18,37,6,4,47,398,64,43,505,28.0556
SAN DIEGO,Dec 2014,CACF,2015,FALLBROOK CHILD DEVELOP CENTER ,CHILD_BREAKFAST,15,37,6,4,47,456,74,49,579,38.6
SAN DIEGO,Dec 2014,CACF,2015,FALLBROOK CHILD DEVELOP CENTER ,CHILD_LUNCH,15,37,6,4,47,445,72,48,565,37.6667
SAN DIEGO,Dec 2014,CACF,2015,FALLBROOK CHILD DEVELOP CENTER ,CHILD_SNACK_PM,15,37,6,4,47,328,53,36,417,27.8
SAN DIEGO,Jan 2015,CACF,2015,FALLBROOK CHILD DEVELOP CENTER ,CHILD_BREAKFAST,20,37,6,4,47,562,91,61,714,35.7
SAN DIEGO,Jan 2015,CACF,2015,FALLBROOK CHILD DEVELOP CENTER ,CHILD_LUNCH,20,37,6,4,47,555,90,60,705,35.25
SAN DIEGO,Jan 2015,CACF,2015,FALLBROOK CHILD DEVELOP CENTER ,CHILD_SNACK_PM,20,37,6,4,47,419,68,45,532,26.6
SAN DIEGO,Feb 2015,CACF,2015,FALLBROOK CHILD DEVELOP CENTER ,CHILD_BREAKFAST,20,37,6,4,47,586,95,64,745,37.25
SAN DIEGO,Feb 2015,CACF,2015,FALLBROOK CHILD DEVELOP CENTER ,CHILD_LUNCH,20,37,6,4,47,571,93,61,725,36.25
SAN DIEGO,Feb 2015,CACF,2015,FALLBROOK CHILD DEVELOP CENTER ,CHILD_SNACK_PM,20,37,6,4,47,426,69,46,541,27.05
SAN DIEGO,Mar 2015,CACF,2015,FALLBROOK CHILD DEVELOP CENTER ,CHILD_BREAKFAST,22,37,6,4,47,629,102,68,799,36.3182
SAN DIEGO,Mar 2015,CACF,2015,FALLBROOK CHILD DEVELOP CENTER ,CHILD_LUNCH,22,37,6,4,47,619,100,67,786,35.7273
SAN DIEGO,Mar 2015,CACF,2015,FALLBROOK CHILD DEVELOP CENTER ,CHILD_SNACK_PM,22,37,6,4,47,468,76,51,595,27.0455
SAN DIEGO,Apr 2015,CACF,2015,FALLBROOK CHILD DEVELOP CENTER ,CHILD_BREAKFAST,22,37,6,4,47,650,105,71,826,37.5455
SAN DIEGO,Apr 2015,CACF,2015,FALLBROOK CHILD DEVELOP CENTER ,CHILD_LUNCH,22,37,6,4,47,642,104,70,816,37.0909
SAN DIEGO,Apr 2015,CACF,2015,FALLBROOK CHILD DEVELOP CENTER ,CHILD_SNACK_PM,22,37,6,4,47,486,79,53,618,28.0909
SAN DIEGO,May 2015,CACF,2015,FALLBROOK CHILD DEVELOP CENTER ,CHILD_BREAKFAST,20,37,6,4,47,597,97,64,758,37.9
SAN DIEGO,May 2015,CACF,2015,FALLBROOK CHILD DEVELOP CENTER ,CHILD_LUNCH,20,37,6,4,47,599,97,65,761,38.05
SAN DIEGO,May 2015,CACF,2015,FALLBROOK CHILD DEVELOP CENTER ,CHILD_SNACK_PM,20,37,6,4,47,441,72,47,560,28
SAN DIEGO,Jun 2015,CACF,2015,FALLBROOK CHILD DEVELOP CENTER ,CHILD_BREAKFAST,22,37,6,4,47,651,106,70,827,37.5909
SAN DIEGO,Jun 2015,CACF,2015,FALLBROOK CHILD DEVELOP CENTER ,CHILD_LUNCH,22,37,6,4,47,642,104,70,816,37.0909
SAN DIEGO,Jun 2015,CACF,2015,FALLBROOK CHILD DEVELOP CENTER ,CHILD_SNACK_PM,22,37,6,4,47,472,76,51,599,27.2273
SAN DIEGO,Jul 2015,CACF,2015,FALLBROOK CHILD DEVELOP CENTER ,CHILD_BREAKFAST,22,37,6,4,47,603,98,65,766,34.8182
SAN DIEGO,Jul 2015,CACF,2015,FALLBROOK CHILD DEVELOP CENTER ,CHILD_LUNCH,22,37,6,4,47,594,96,64,754,34.2727
SAN DIEGO,Jul 2015,CACF,2015,FALLBROOK CHILD DEVELOP CENTER ,CHILD_SNACK_PM,22,37,6,4,47,470,76,51,597,27.1364
SAN DIEGO,Aug 2015,CACF,2015,FALLBROOK CHILD DEVELOP CENTER ,CHILD_BREAKFAST,21,37,6,4,47,541,88,58,687,32.7143
SAN DIEGO,Aug 2015,CACF,2015,FALLBROOK CHILD DEVELOP CENTER ,CHILD_LUNCH,21,37,6,4,47,526,85,57,668,31.8095
SAN DIEGO,Aug 2015,CACF,2015,FALLBROOK CHILD DEVELOP CENTER ,CHILD_SNACK_PM,21,37,6,4,47,368,60,39,467,22.2381
SAN DIEGO,Sep 2015,CACF,2015,FALLBROOK CHILD DEVELOP CENTER ,CHILD_BREAKFAST,21,37,6,4,47,597,97,65,759,36.1429
SAN DIEGO,Sep 2015,CACF,2015,FALLBROOK CHILD DEVELOP CENTER ,CHILD_LUNCH,21,37,6,4,47,592,96,64,752,35.8095
SAN DIEGO,Sep 2015,CACF,2015,FALLBROOK CHILD DEVELOP CENTER ,CHILD_SNACK_PM,21,37,6,4,47,402,65,44,511,24.3333
SAN DIEGO,Mar 2015,CACF,2015,Feeding America San Diego,ATRISK_CHILD_SUPPER,2,130,0,0,130,160,0,0,160,80
SAN DIEGO,Apr 2015,CACF,2015,Feeding America San Diego,ATRISK_CHILD_SUPPER,22,232,0,0,232,3498,0,0,3498,159
SAN DIEGO,May 2015,CACF,2015,Feeding America San Diego,ATRISK_CHILD_SUPPER,19,273,0,0,273,3922,0,0,3922,206.4211
SAN DIEGO,Jun 2015,CACF,2015,Feeding America San Diego,ATRISK_CHILD_SUPPER,13,261,0,0,261,2399,0,0,2399,184.5385
SAN DIEGO,Aug 2015,CACF,2015,Feeding America San Diego,ATRISK_CHILD_SUPPER,1,217,0,0,217,150,0,0,150,150
SAN DIEGO,Sep 2015,CACF,2015,Feeding America San Diego,ATRISK_CHILD_SUPPER,21,241,0,0,241,3954,0,0,3954,188.2857
SAN DIEGO,May 2015,CACF,2015,GENAVEVES PLAYHOUSE PRESCHOOL,CHILD_BREAKFAST,19,36,22,33,91,280,171,258,709,37.3158
SAN DIEGO,May 2015,CACF,2015,GENAVEVES PLAYHOUSE PRESCHOOL,CHILD_LUNCH,19,36,22,33,91,495,302,453,1250,65.7895
SAN DIEGO,May 2015,CACF,2015,GENAVEVES PLAYHOUSE PRESCHOOL,CHILD_SNACK_AM,19,36,22,33,91,489,299,449,1237,65.1053
SAN DIEGO,May 2015,CACF,2015,GENAVEVES PLAYHOUSE PRESCHOOL,CHILD_SNACK_PM,19,36,22,33,91,235,144,215,594,31.2632
SAN DIEGO,Jun 2015,CACF,2015,GENAVEVES PLAYHOUSE PRESCHOOL,CHILD_BREAKFAST,22,36,22,33,91,395,241,362,998,45.3636
SAN DIEGO,Jun 2015,CACF,2015,GENAVEVES PLAYHOUSE PRESCHOOL,CHILD_LUNCH,22,36,22,33,91,455,278,417,1150,52.2727
SAN DIEGO,Jun 2015,CACF,2015,GENAVEVES PLAYHOUSE PRESCHOOL,CHILD_SNACK_AM,22,36,22,33,91,455,278,417,1150,52.2727
SAN DIEGO,Jun 2015,CACF,2015,GENAVEVES PLAYHOUSE PRESCHOOL,CHILD_SNACK_PM,22,36,22,33,91,199,122,183,504,22.9091
SAN DIEGO,Jul 2015,CACF,2015,GENAVEVES PLAYHOUSE PRESCHOOL,CHILD_BREAKFAST,23,45,31,23,99,875,603,448,1926,83.7391
SAN DIEGO,Jul 2015,CACF,2015,GENAVEVES PLAYHOUSE PRESCHOOL,CHILD_LUNCH,23,45,31,23,99,920,634,470,2024,88
SAN DIEGO,Jul 2015,CACF,2015,GENAVEVES PLAYHOUSE PRESCHOOL,CHILD_SNACK_AM,23,45,31,23,99,909,627,465,2001,87
SAN DIEGO,Jul 2015,CACF,2015,GENAVEVES PLAYHOUSE PRESCHOOL,CHILD_SNACK_PM,23,45,31,23,99,94,65,48,207,9
SAN DIEGO,Aug 2015,CACF,2015,GENAVEVES PLAYHOUSE PRESCHOOL,CHILD_BREAKFAST,21,45,31,23,99,802,552,410,1764,84
SAN DIEGO,Aug 2015,CACF,2015,GENAVEVES PLAYHOUSE PRESCHOOL,CHILD_LUNCH,21,45,31,23,99,857,591,438,1886,89.8095
SAN DIEGO,Aug 2015,CACF,2015,GENAVEVES PLAYHOUSE PRESCHOOL,CHILD_SNACK_AM,21,45,31,23,99,859,592,439,1890,90
SAN DIEGO,Aug 2015,CACF,2015,GENAVEVES PLAYHOUSE PRESCHOOL,CHILD_SNACK_PM,21,45,31,23,99,67,46,34,147,7
SAN DIEGO,Sep 2015,CACF,2015,GENAVEVES PLAYHOUSE PRESCHOOL,CHILD_BREAKFAST,21,45,31,24,100,905,623,482,2010,95.7143
SAN DIEGO,Sep 2015,CACF,2015,GENAVEVES PLAYHOUSE PRESCHOOL,CHILD_LUNCH,21,45,31,24,100,929,640,495,2064,98.2857
SAN DIEGO,Sep 2015,CACF,2015,GENAVEVES PLAYHOUSE PRESCHOOL,CHILD_SNACK_AM,21,45,31,24,100,933,643,497,2073,98.7143
SAN DIEGO,Sep 2015,CACF,2015,GENAVEVES PLAYHOUSE PRESCHOOL,CHILD_SNACK_PM,21,45,31,24,100,15,10,8,33,1.5714
SAN DIEGO,Oct 2014,CACF,2015,GEORGE G GLENNER ALZHEIMERS FM CTR INC,ADULT_BREAKFAST,23,30,14,74,118,201,94,494,789,34.3043
SAN DIEGO,Oct 2014,CACF,2015,GEORGE G GLENNER ALZHEIMERS FM CTR INC,ADULT_LUNCH,23,30,14,74,118,313,146,774,1233,53.6087
SAN DIEGO,Oct 2014,CACF,2015,GEORGE G GLENNER ALZHEIMERS FM CTR INC,ADULT_SNACK_PM,23,30,14,74,118,247,115,609,971,42.2174
SAN DIEGO,Nov 2014,CACF,2015,GEORGE G GLENNER ALZHEIMERS FM CTR INC,ADULT_BREAKFAST,17,30,14,74,118,148,69,366,583,34.2941
SAN DIEGO,Nov 2014,CACF,2015,GEORGE G GLENNER ALZHEIMERS FM CTR INC,ADULT_LUNCH,17,30,14,74,118,232,108,571,911,53.5882
SAN DIEGO,Nov 2014,CACF,2015,GEORGE G GLENNER ALZHEIMERS FM CTR INC,ADULT_SNACK_PM,17,30,14,74,118,178,83,441,702,41.2941
SAN DIEGO,Dec 2014,CACF,2015,GEORGE G GLENNER ALZHEIMERS FM CTR INC,ADULT_BREAKFAST,21,30,14,74,118,167,78,411,656,31.2381
SAN DIEGO,Dec 2014,CACF,2015,GEORGE G GLENNER ALZHEIMERS FM CTR INC,ADULT_LUNCH,21,30,14,74,118,285,133,702,1120,53.3333
SAN DIEGO,Dec 2014,CACF,2015,GEORGE G GLENNER ALZHEIMERS FM CTR INC,ADULT_SNACK_PM,21,30,14,74,118,189,88,467,744,35.4286
SAN DIEGO,Jan 2015,CACF,2015,GEORGE G GLENNER ALZHEIMERS FM CTR INC,ADULT_BREAKFAST,20,30,14,74,118,166,77,410,653,32.65
SAN DIEGO,Jan 2015,CACF,2015,GEORGE G GLENNER ALZHEIMERS FM CTR INC,ADULT_LUNCH,20,30,14,74,118,266,124,658,1048,52.4
SAN DIEGO,Jan 2015,CACF,2015,GEORGE G GLENNER ALZHEIMERS FM CTR INC,ADULT_SNACK_PM,20,30,14,74,118,193,90,476,759,37.95
SAN DIEGO,Feb 2015,CACF,2015,GEORGE G GLENNER ALZHEIMERS FM CTR INC,ADULT_BREAKFAST,19,30,14,74,118,160,75,394,629,33.1053
SAN DIEGO,Feb 2015,CACF,2015,GEORGE G GLENNER ALZHEIMERS FM CTR INC,ADULT_LUNCH,19,30,14,74,118,256,119,631,1006,52.9474
SAN DIEGO,Feb 2015,CACF,2015,GEORGE G GLENNER ALZHEIMERS FM CTR INC,ADULT_SNACK_PM,19,30,14,74,118,182,85,448,715,37.6316
SAN DIEGO,Mar 2015,CACF,2015,GEORGE G GLENNER ALZHEIMERS FM CTR INC,ADULT_BREAKFAST,20,30,14,74,118,180,84,443,707,35.35
SAN DIEGO,Mar 2015,CACF,2015,GEORGE G GLENNER ALZHEIMERS FM CTR INC,ADULT_LUNCH,20,30,14,74,118,294,137,726,1157,57.85
SAN DIEGO,Mar 2015,CACF,2015,GEORGE G GLENNER ALZHEIMERS FM CTR INC,ADULT_SNACK_PM,20,30,14,74,118,206,96,507,809,40.45
SAN DIEGO,Apr 2015,CACF,2015,GEORGE G GLENNER ALZHEIMERS FM CTR INC,ADULT_BREAKFAST,22,30,14,74,118,190,89,468,747,33.9545
SAN DIEGO,Apr 2015,CACF,2015,GEORGE G GLENNER ALZHEIMERS FM CTR INC,ADULT_LUNCH,22,30,14,74,118,280,131,691,1102,50.0909
SAN DIEGO,Apr 2015,CACF,2015,GEORGE G GLENNER ALZHEIMERS FM CTR INC,ADULT_SNACK_PM,22,30,14,74,118,198,92,488,778,35.3636
SAN DIEGO,May 2015,CACF,2015,GEORGE G GLENNER ALZHEIMERS FM CTR INC,ADULT_BREAKFAST,20,30,14,74,118,173,81,427,681,34.05
SAN DIEGO,May 2015,CACF,2015,GEORGE G GLENNER ALZHEIMERS FM CTR INC,ADULT_LUNCH,20,30,14,74,118,262,122,647,1031,51.55
SAN DIEGO,May 2015,CACF,2015,GEORGE G GLENNER ALZHEIMERS FM CTR INC,ADULT_SNACK_PM,20,30,14,74,118,184,86,452,722,36.1
SAN DIEGO,Jun 2015,CACF,2015,GEORGE G GLENNER ALZHEIMERS FM CTR INC,ADULT_BREAKFAST,22,30,14,74,118,202,94,500,796,36.1818
SAN DIEGO,Jun 2015,CACF,2015,GEORGE G GLENNER ALZHEIMERS FM CTR INC,ADULT_LUNCH,22,30,14,74,118,299,140,739,1178,53.5455
SAN DIEGO,Jun 2015,CACF,2015,GEORGE G GLENNER ALZHEIMERS FM CTR INC,ADULT_SNACK_PM,22,30,14,74,118,193,90,478,761,34.5909
SAN DIEGO,Jul 2015,CACF,2015,GEORGE G GLENNER ALZHEIMERS FM CTR INC,ADULT_BREAKFAST,22,30,14,74,118,193,90,478,761,34.5909
SAN DIEGO,Jul 2015,CACF,2015,GEORGE G GLENNER ALZHEIMERS FM CTR INC,ADULT_LUNCH,22,30,14,74,118,288,134,709,1131,51.4091
SAN DIEGO,Jul 2015,CACF,2015,GEORGE G GLENNER ALZHEIMERS FM CTR INC,ADULT_SNACK_PM,22,30,14,74,118,190,88,468,746,33.9091
SAN DIEGO,Aug 2015,CACF,2015,GEORGE G GLENNER ALZHEIMERS FM CTR INC,ADULT_BREAKFAST,21,30,14,74,118,174,81,430,685,32.619
SAN DIEGO,Aug 2015,CACF,2015,GEORGE G GLENNER ALZHEIMERS FM CTR INC,ADULT_LUNCH,21,30,14,74,118,290,135,717,1142,54.381
SAN DIEGO,Aug 2015,CACF,2015,GEORGE G GLENNER ALZHEIMERS FM CTR INC,ADULT_SNACK_PM,21,30,14,74,118,169,79,417,665,31.6667
SAN DIEGO,Sep 2015,CACF,2015,GEORGE G GLENNER ALZHEIMERS FM CTR INC,ADULT_BREAKFAST,21,30,14,74,118,181,84,447,712,33.9048
SAN DIEGO,Sep 2015,CACF,2015,GEORGE G GLENNER ALZHEIMERS FM CTR INC,ADULT_LUNCH,21,30,14,74,118,296,138,729,1163,55.381
SAN DIEGO,Sep 2015,CACF,2015,GEORGE G GLENNER ALZHEIMERS FM CTR INC,ADULT_SNACK_PM,21,30,14,74,118,187,87,462,736,35.0476
SAN DIEGO,Oct 2014,CACF,2015,GIGGLES & SMILES CHILD CARE CENTER  ,CHILD_BREAKFAST,23,23,4,55,82,416,72,996,1484,64.5217
SAN DIEGO,Oct 2014,CACF,2015,GIGGLES & SMILES CHILD CARE CENTER  ,CHILD_LUNCH,23,23,4,55,82,440,77,1051,1568,68.1739
SAN DIEGO,Oct 2014,CACF,2015,GIGGLES & SMILES CHILD CARE CENTER  ,CHILD_SNACK_PM,23,23,4,55,82,397,69,949,1415,61.5217
SAN DIEGO,Nov 2014,CACF,2015,GIGGLES & SMILES CHILD CARE CENTER  ,CHILD_BREAKFAST,17,23,4,55,82,300,52,716,1068,62.8235
SAN DIEGO,Nov 2014,CACF,2015,GIGGLES & SMILES CHILD CARE CENTER  ,CHILD_LUNCH,17,23,4,55,82,318,55,759,1132,66.5882
SAN DIEGO,Nov 2014,CACF,2015,GIGGLES & SMILES CHILD CARE CENTER  ,CHILD_SNACK_PM,17,23,4,55,82,289,50,690,1029,60.5294
SAN DIEGO,Dec 2014,CACF,2015,GIGGLES & SMILES CHILD CARE CENTER  ,CHILD_BREAKFAST,20,23,4,55,82,308,54,737,1099,54.95
SAN DIEGO,Dec 2014,CACF,2015,GIGGLES & SMILES CHILD CARE CENTER  ,CHILD_LUNCH,20,23,4,55,82,327,57,781,1165,58.25
SAN DIEGO,Dec 2014,CACF,2015,GIGGLES & SMILES CHILD CARE CENTER  ,CHILD_SNACK_PM,20,23,4,55,82,309,54,738,1101,55.05
SAN DIEGO,Jan 2015,CACF,2015,GIGGLES & SMILES CHILD CARE CENTER  ,CHILD_BREAKFAST,20,23,4,55,82,321,56,769,1146,57.3
SAN DIEGO,Jan 2015,CACF,2015,GIGGLES & SMILES CHILD CARE CENTER  ,CHILD_LUNCH,20,23,4,55,82,334,58,800,1192,59.6
SAN DIEGO,Jan 2015,CACF,2015,GIGGLES & SMILES CHILD CARE CENTER  ,CHILD_SNACK_PM,20,23,4,55,82,299,52,715,1066,53.3
SAN DIEGO,Feb 2015,CACF,2015,GIGGLES & SMILES CHILD CARE CENTER  ,CHILD_BREAKFAST,19,23,4,55,82,337,59,806,1202,63.2632
SAN DIEGO,Feb 2015,CACF,2015,GIGGLES & SMILES CHILD CARE CENTER  ,CHILD_LUNCH,19,23,4,55,82,355,62,849,1266,66.6316
SAN DIEGO,Feb 2015,CACF,2015,GIGGLES & SMILES CHILD CARE CENTER  ,CHILD_SNACK_PM,19,23,4,55,82,316,55,756,1127,59.3158
SAN DIEGO,Mar 2015,CACF,2015,GIGGLES & SMILES CHILD CARE CENTER  ,CHILD_BREAKFAST,22,23,4,55,82,369,64,881,1314,59.7273
SAN DIEGO,Mar 2015,CACF,2015,GIGGLES & SMILES CHILD CARE CENTER  ,CHILD_LUNCH,22,23,4,55,82,386,67,923,1376,62.5455
SAN DIEGO,Mar 2015,CACF,2015,GIGGLES & SMILES CHILD CARE CENTER  ,CHILD_SNACK_PM,22,23,4,55,82,339,59,812,1210,55
SAN DIEGO,Apr 2015,CACF,2015,GIGGLES & SMILES CHILD CARE CENTER  ,CHILD_BREAKFAST,21,23,4,55,82,358,62,857,1277,60.8095
SAN DIEGO,Apr 2015,CACF,2015,GIGGLES & SMILES CHILD CARE CENTER  ,CHILD_LUNCH,21,23,4,55,82,384,67,917,1368,65.1429
SAN DIEGO,Apr 2015,CACF,2015,GIGGLES & SMILES CHILD CARE CENTER  ,CHILD_SNACK_PM,21,23,4,55,82,344,60,821,1225,58.3333
SAN DIEGO,May 2015,CACF,2015,GIGGLES & SMILES CHILD CARE CENTER  ,CHILD_BREAKFAST,20,23,4,55,82,369,64,881,1314,65.7
SAN DIEGO,May 2015,CACF,2015,GIGGLES & SMILES CHILD CARE CENTER  ,CHILD_LUNCH,20,23,4,55,82,383,67,914,1364,68.2
SAN DIEGO,May 2015,CACF,2015,GIGGLES & SMILES CHILD CARE CENTER  ,CHILD_SNACK_PM,20,23,4,55,82,340,59,814,1213,60.65
SAN DIEGO,Jun 2015,CACF,2015,GIGGLES & SMILES CHILD CARE CENTER  ,CHILD_BREAKFAST,22,23,4,55,82,373,65,890,1328,60.3636
SAN DIEGO,Jun 2015,CACF,2015,GIGGLES & SMILES CHILD CARE CENTER  ,CHILD_LUNCH,22,23,4,55,82,405,71,969,1445,65.6818
SAN DIEGO,Jun 2015,CACF,2015,GIGGLES & SMILES CHILD CARE CENTER  ,CHILD_SNACK_PM,22,23,4,55,82,370,64,886,1320,60
SAN DIEGO,Jul 2015,CACF,2015,GIGGLES & SMILES CHILD CARE CENTER  ,CHILD_BREAKFAST,22,23,4,55,82,358,62,858,1278,58.0909
SAN DIEGO,Jul 2015,CACF,2015,GIGGLES & SMILES CHILD CARE CENTER  ,CHILD_LUNCH,22,23,4,55,82,392,68,939,1399,63.5909
SAN DIEGO,Jul 2015,CACF,2015,GIGGLES & SMILES CHILD CARE CENTER  ,CHILD_SNACK_PM,22,23,4,55,82,364,63,872,1299,59.0455
SAN DIEGO,Aug 2015,CACF,2015,GIGGLES & SMILES CHILD CARE CENTER  ,CHILD_BREAKFAST,21,23,4,55,82,332,58,793,1183,56.3333
SAN DIEGO,Aug 2015,CACF,2015,GIGGLES & SMILES CHILD CARE CENTER  ,CHILD_LUNCH,21,23,4,55,82,366,64,876,1306,62.1905
SAN DIEGO,Aug 2015,CACF,2015,GIGGLES & SMILES CHILD CARE CENTER  ,CHILD_SNACK_PM,21,23,4,55,82,339,59,812,1210,57.619
SAN DIEGO,Sep 2015,CACF,2015,GIGGLES & SMILES CHILD CARE CENTER  ,CHILD_BREAKFAST,21,23,4,55,82,348,61,833,1242,59.1429
SAN DIEGO,Sep 2015,CACF,2015,GIGGLES & SMILES CHILD CARE CENTER  ,CHILD_LUNCH,21,23,4,55,82,370,64,885,1319,62.8095
SAN DIEGO,Sep 2015,CACF,2015,GIGGLES & SMILES CHILD CARE CENTER  ,CHILD_SNACK_PM,21,23,4,55,82,343,60,819,1222,58.1905
SAN DIEGO,Oct 2014,CACF,2015,GROSSMONT CUYAMACA COMMUNITY COLLEGE DISTRICT ,CHILD_BREAKFAST,23,89,14,51,154,739,116,424,1279,55.6087
SAN DIEGO,Oct 2014,CACF,2015,GROSSMONT CUYAMACA COMMUNITY COLLEGE DISTRICT ,CHILD_LUNCH,23,89,14,51,154,1323,208,758,2289,99.5217
SAN DIEGO,Oct 2014,CACF,2015,GROSSMONT CUYAMACA COMMUNITY COLLEGE DISTRICT ,CHILD_SNACK_PM,23,89,14,51,154,611,96,351,1058,46
SAN DIEGO,Nov 2014,CACF,2015,GROSSMONT CUYAMACA COMMUNITY COLLEGE DISTRICT ,CHILD_BREAKFAST,18,89,14,51,154,537,84,308,929,51.6111
SAN DIEGO,Nov 2014,CACF,2015,GROSSMONT CUYAMACA COMMUNITY COLLEGE DISTRICT ,CHILD_LUNCH,18,89,14,51,154,956,150,549,1655,91.9444
SAN DIEGO,Nov 2014,CACF,2015,GROSSMONT CUYAMACA COMMUNITY COLLEGE DISTRICT ,CHILD_SNACK_PM,18,89,14,51,154,424,67,242,733,40.7222
SAN DIEGO,Dec 2014,CACF,2015,GROSSMONT CUYAMACA COMMUNITY COLLEGE DISTRICT ,CHILD_BREAKFAST,17,89,14,51,154,360,57,206,623,36.6471
SAN DIEGO,Dec 2014,CACF,2015,GROSSMONT CUYAMACA COMMUNITY COLLEGE DISTRICT ,CHILD_LUNCH,17,89,14,51,154,667,105,382,1154,67.8824
SAN DIEGO,Dec 2014,CACF,2015,GROSSMONT CUYAMACA COMMUNITY COLLEGE DISTRICT ,CHILD_SNACK_PM,17,89,14,51,154,260,41,149,450,26.4706
SAN DIEGO,Jan 2015,CACF,2015,GROSSMONT CUYAMACA COMMUNITY COLLEGE DISTRICT ,CHILD_BREAKFAST,19,89,14,51,154,297,47,170,514,27.0526
SAN DIEGO,Jan 2015,CACF,2015,GROSSMONT CUYAMACA COMMUNITY COLLEGE DISTRICT ,CHILD_LUNCH,19,89,14,51,154,602,95,344,1041,54.7895
SAN DIEGO,Jan 2015,CACF,2015,GROSSMONT CUYAMACA COMMUNITY COLLEGE DISTRICT ,CHILD_SNACK_PM,19,89,14,51,154,243,38,140,421,22.1579
SAN DIEGO,Feb 2015,CACF,2015,GROSSMONT CUYAMACA COMMUNITY COLLEGE DISTRICT ,CHILD_BREAKFAST,18,89,14,51,154,568,89,326,983,54.6111
SAN DIEGO,Feb 2015,CACF,2015,GROSSMONT CUYAMACA COMMUNITY COLLEGE DISTRICT ,CHILD_LUNCH,18,89,14,51,154,1118,176,640,1934,107.4444
SAN DIEGO,Feb 2015,CACF,2015,GROSSMONT CUYAMACA COMMUNITY COLLEGE DISTRICT ,CHILD_SNACK_PM,18,89,14,51,154,505,79,289,873,48.5
SAN DIEGO,Mar 2015,CACF,2015,GROSSMONT CUYAMACA COMMUNITY COLLEGE DISTRICT ,CHILD_BREAKFAST,21,89,14,51,154,555,87,318,960,45.7143
SAN DIEGO,Mar 2015,CACF,2015,GROSSMONT CUYAMACA COMMUNITY COLLEGE DISTRICT ,CHILD_LUNCH,21,89,14,51,154,1095,172,627,1894,90.1905
SAN DIEGO,Mar 2015,CACF,2015,GROSSMONT CUYAMACA COMMUNITY COLLEGE DISTRICT ,CHILD_SNACK_PM,21,89,14,51,154,483,76,276,835,39.7619
SAN DIEGO,Apr 2015,CACF,2015,GROSSMONT CUYAMACA COMMUNITY COLLEGE DISTRICT ,CHILD_BREAKFAST,22,89,14,51,154,678,107,388,1173,53.3182
SAN DIEGO,Apr 2015,CACF,2015,GROSSMONT CUYAMACA COMMUNITY COLLEGE DISTRICT ,CHILD_LUNCH,22,89,14,51,154,1345,212,770,2327,105.7727
SAN DIEGO,Apr 2015,CACF,2015,GROSSMONT CUYAMACA COMMUNITY COLLEGE DISTRICT ,CHILD_SNACK_PM,22,89,14,51,154,617,97,354,1068,48.5455
SAN DIEGO,May 2015,CACF,2015,GROSSMONT CUYAMACA COMMUNITY COLLEGE DISTRICT ,CHILD_BREAKFAST,21,89,14,51,154,593,93,340,1026,48.8571
SAN DIEGO,May 2015,CACF,2015,GROSSMONT CUYAMACA COMMUNITY COLLEGE DISTRICT ,CHILD_LUNCH,21,89,14,51,154,1202,189,689,2080,99.0476
SAN DIEGO,May 2015,CACF,2015,GROSSMONT CUYAMACA COMMUNITY COLLEGE DISTRICT ,CHILD_SNACK_PM,21,89,14,51,154,515,81,295,891,42.4286
SAN DIEGO,Jun 2015,CACF,2015,GROSSMONT CUYAMACA COMMUNITY COLLEGE DISTRICT ,CHILD_BREAKFAST,22,89,14,51,154,171,27,98,296,13.4545
SAN DIEGO,Jun 2015,CACF,2015,GROSSMONT CUYAMACA COMMUNITY COLLEGE DISTRICT ,CHILD_LUNCH,22,89,14,51,154,328,52,188,568,25.8182
SAN DIEGO,Jun 2015,CACF,2015,GROSSMONT CUYAMACA COMMUNITY COLLEGE DISTRICT ,CHILD_SNACK_PM,22,89,14,51,154,144,23,83,250,11.3636
SAN DIEGO,Jul 2015,CACF,2015,GROSSMONT CUYAMACA COMMUNITY COLLEGE DISTRICT ,CHILD_BREAKFAST,22,89,14,51,154,133,21,77,231,10.5
SAN DIEGO,Jul 2015,CACF,2015,GROSSMONT CUYAMACA COMMUNITY COLLEGE DISTRICT ,CHILD_LUNCH,22,89,14,51,154,307,48,177,532,24.1818
SAN DIEGO,Jul 2015,CACF,2015,GROSSMONT CUYAMACA COMMUNITY COLLEGE DISTRICT ,CHILD_SNACK_PM,22,89,14,51,154,138,22,78,238,10.8182
SAN DIEGO,Aug 2015,CACF,2015,GROSSMONT CUYAMACA COMMUNITY COLLEGE DISTRICT ,CHILD_BREAKFAST,16,89,14,51,154,379,60,217,656,41
SAN DIEGO,Aug 2015,CACF,2015,GROSSMONT CUYAMACA COMMUNITY COLLEGE DISTRICT ,CHILD_LUNCH,16,89,14,51,154,646,102,370,1118,69.875
SAN DIEGO,Aug 2015,CACF,2015,GROSSMONT CUYAMACA COMMUNITY COLLEGE DISTRICT ,CHILD_SNACK_PM,16,89,14,51,154,347,55,199,601,37.5625
SAN DIEGO,Sep 2015,CACF,2015,GROSSMONT CUYAMACA COMMUNITY COLLEGE DISTRICT ,CHILD_BREAKFAST,21,89,14,51,154,630,99,362,1091,51.9524
SAN DIEGO,Sep 2015,CACF,2015,GROSSMONT CUYAMACA COMMUNITY COLLEGE DISTRICT ,CHILD_LUNCH,21,89,14,51,154,1070,168,613,1851,88.1429
SAN DIEGO,Sep 2015,CACF,2015,GROSSMONT CUYAMACA COMMUNITY COLLEGE DISTRICT ,CHILD_SNACK_PM,21,89,14,51,154,544,86,311,941,44.8095
SAN DIEGO,Oct 2014,CACF,2015,Grossmont Union High School District,ATRISK_CHILD_SUPPER,27,1090,0,0,1090,22172,0,0,22172,821.1852
SAN DIEGO,Nov 2014,CACF,2015,Grossmont Union High School District,ATRISK_CHILD_SUPPER,15,1043,0,0,1043,11391,0,0,11391,759.4
SAN DIEGO,Dec 2014,CACF,2015,Grossmont Union High School District,ATRISK_CHILD_SUPPER,17,1051,0,0,1051,13147,0,0,13147,773.3529
SAN DIEGO,Jan 2015,CACF,2015,Grossmont Union High School District,ATRISK_CHILD_SUPPER,19,1074,0,0,1074,15059,0,0,15059,792.5789
SAN DIEGO,Feb 2015,CACF,2015,Grossmont Union High School District,ATRISK_CHILD_SUPPER,19,1106,0,0,1106,15767,0,0,15767,829.8421
SAN DIEGO,Mar 2015,CACF,2015,Grossmont Union High School District,ATRISK_CHILD_SUPPER,22,998,0,0,998,16186,0,0,16186,735.7273
SAN DIEGO,Apr 2015,CACF,2015,Grossmont Union High School District,ATRISK_CHILD_SUPPER,24,840,0,0,840,14521,0,0,14521,605.0417
SAN DIEGO,May 2015,CACF,2015,Grossmont Union High School District,ATRISK_CHILD_SUPPER,24,966,0,0,966,16828,0,0,16828,701.1667
SAN DIEGO,Jun 2015,CACF,2015,Grossmont Union High School District,ATRISK_CHILD_SUPPER,15,794,0,0,794,8002,0,0,8002,533.4667
SAN DIEGO,Sep 2015,CACF,2015,Grossmont Union High School District,ATRISK_CHILD_SUPPER,21,917,0,0,917,12552,0,0,12552,597.7143
SAN DIEGO,Oct 2014,CACF,2015,GSCA INC ,CHILD_BREAKFAST,23,61,9,22,92,517,76,187,780,33.913
SAN DIEGO,Oct 2014,CACF,2015,GSCA INC ,CHILD_LUNCH,23,61,9,22,92,1183,175,427,1785,77.6087
SAN DIEGO,Oct 2014,CACF,2015,GSCA INC ,CHILD_SNACK_AM,23,61,9,22,92,1172,173,423,1768,76.8696
SAN DIEGO,Oct 2014,CACF,2015,GSCA INC ,CHILD_SUPPER,23,61,9,22,92,626,92,226,944,41.0435
SAN DIEGO,Oct 2014,CACF,2015,GSCA INC ,OSCH_CHILD_LUNCH,23,5,0,0,5,105,0,0,105,4.5652
SAN DIEGO,Oct 2014,CACF,2015,GSCA INC ,OSCH_CHILD_SNACK_AM,23,5,0,0,5,5,0,0,5,0.2174
SAN DIEGO,Oct 2014,CACF,2015,GSCA INC ,OSCH_CHILD_SUPPER,23,5,0,0,5,102,0,0,102,4.4348
SAN DIEGO,Nov 2014,CACF,2015,GSCA INC ,CHILD_BREAKFAST,18,67,9,22,98,427,57,141,625,34.7222
SAN DIEGO,Nov 2014,CACF,2015,GSCA INC ,CHILD_LUNCH,18,67,9,22,98,965,130,316,1411,78.3889
SAN DIEGO,Nov 2014,CACF,2015,GSCA INC ,CHILD_SNACK_AM,18,67,9,22,98,956,128,314,1398,77.6667
SAN DIEGO,Nov 2014,CACF,2015,GSCA INC ,CHILD_SUPPER,18,67,9,22,98,496,67,163,726,40.3333
SAN DIEGO,Nov 2014,CACF,2015,GSCA INC ,OSCH_CHILD_LUNCH,18,5,0,0,5,85,0,0,85,4.7222
SAN DIEGO,Nov 2014,CACF,2015,GSCA INC ,OSCH_CHILD_SNACK_AM,18,5,0,0,5,13,0,0,13,0.7222
SAN DIEGO,Nov 2014,CACF,2015,GSCA INC ,OSCH_CHILD_SUPPER,18,5,0,0,5,83,0,0,83,4.6111
SAN DIEGO,Dec 2014,CACF,2015,GSCA INC ,CHILD_BREAKFAST,21,80,11,22,113,627,86,172,885,42.1429
SAN DIEGO,Dec 2014,CACF,2015,GSCA INC ,CHILD_LUNCH,21,80,11,22,113,1298,178,358,1834,87.3333
SAN DIEGO,Dec 2014,CACF,2015,GSCA INC ,CHILD_SNACK_AM,21,80,11,22,113,1277,176,351,1804,85.9048
SAN DIEGO,Dec 2014,CACF,2015,GSCA INC ,CHILD_SUPPER,21,80,11,22,113,620,85,170,875,41.6667
SAN DIEGO,Dec 2014,CACF,2015,GSCA INC ,OSCH_CHILD_LUNCH,21,5,0,0,5,15,0,0,15,0.7143
SAN DIEGO,Dec 2014,CACF,2015,GSCA INC ,OSCH_CHILD_SNACK_AM,21,5,0,0,5,12,0,0,12,0.5714
SAN DIEGO,Dec 2014,CACF,2015,GSCA INC ,OSCH_CHILD_SUPPER,21,5,0,0,5,14,0,0,14,0.6667
SAN DIEGO,Jan 2015,CACF,2015,GSCA INC ,CHILD_BREAKFAST,21,93,12,24,129,856,110,222,1188,56.5714
SAN DIEGO,Jan 2015,CACF,2015,GSCA INC ,CHILD_LUNCH,21,93,12,24,129,1557,201,402,2160,102.8571
SAN DIEGO,Jan 2015,CACF,2015,GSCA INC ,CHILD_SNACK_AM,21,93,12,24,129,1542,199,398,2139,101.8571
SAN DIEGO,Jan 2015,CACF,2015,GSCA INC ,CHILD_SUPPER,21,93,12,24,129,661,85,171,917,43.6667
SAN DIEGO,Jan 2015,CACF,2015,GSCA INC ,OSCH_CHILD_LUNCH,20,5,0,0,5,70,0,0,70,3.5
SAN DIEGO,Jan 2015,CACF,2015,GSCA INC ,OSCH_CHILD_SNACK_AM,20,5,0,0,5,4,0,0,4,0.2
SAN DIEGO,Jan 2015,CACF,2015,GSCA INC ,OSCH_CHILD_SUPPER,20,5,0,0,5,62,0,0,62,3.1
SAN DIEGO,Feb 2015,CACF,2015,GSCA INC ,CHILD_BREAKFAST,19,103,12,24,139,903,105,210,1218,64.1053
SAN DIEGO,Feb 2015,CACF,2015,GSCA INC ,CHILD_LUNCH,19,103,12,24,139,1651,192,385,2228,117.2632
SAN DIEGO,Feb 2015,CACF,2015,GSCA INC ,CHILD_SNACK_AM,19,103,12,24,139,1638,191,382,2211,116.3684
SAN DIEGO,Feb 2015,CACF,2015,GSCA INC ,CHILD_SUPPER,19,103,12,24,139,717,84,167,968,50.9474
SAN DIEGO,Feb 2015,CACF,2015,GSCA INC ,OSCH_CHILD_LUNCH,19,5,0,0,5,19,0,0,19,1
SAN DIEGO,Feb 2015,CACF,2015,GSCA INC ,OSCH_CHILD_SUPPER,19,5,0,0,5,19,0,0,19,1
SAN DIEGO,Mar 2015,CACF,2015,GSCA INC ,CHILD_BREAKFAST,22,102,12,25,139,1094,129,268,1491,67.7727
SAN DIEGO,Mar 2015,CACF,2015,GSCA INC ,CHILD_LUNCH,22,102,12,25,139,1952,230,478,2660,120.9091
SAN DIEGO,Mar 2015,CACF,2015,GSCA INC ,CHILD_SNACK_AM,22,102,12,25,139,1942,228,476,2646,120.2727
SAN DIEGO,Mar 2015,CACF,2015,GSCA INC ,CHILD_SUPPER,22,102,12,25,139,808,95,198,1101,50.0455
SAN DIEGO,Mar 2015,CACF,2015,GSCA INC ,OSCH_CHILD_LUNCH,22,5,0,0,5,40,0,0,40,1.8182
SAN DIEGO,Mar 2015,CACF,2015,GSCA INC ,OSCH_CHILD_SUPPER,22,5,0,0,5,39,0,0,39,1.7727
SAN DIEGO,Apr 2015,CACF,2015,GSCA INC ,CHILD_BREAKFAST,22,111,12,27,150,1321,143,321,1785,81.1364
SAN DIEGO,Apr 2015,CACF,2015,GSCA INC ,CHILD_LUNCH,22,111,12,27,150,2184,236,531,2951,134.1364
SAN DIEGO,Apr 2015,CACF,2015,GSCA INC ,CHILD_SNACK_AM,22,111,12,27,150,2170,235,527,2932,133.2727
SAN DIEGO,Apr 2015,CACF,2015,GSCA INC ,CHILD_SUPPER,22,111,12,27,150,831,90,202,1123,51.0455
SAN DIEGO,Apr 2015,CACF,2015,GSCA INC ,OSCH_CHILD_LUNCH,22,5,0,0,5,40,0,0,40,1.8182
SAN DIEGO,Apr 2015,CACF,2015,GSCA INC ,OSCH_CHILD_SNACK_AM,22,5,0,0,5,10,0,0,10,0.4545
SAN DIEGO,Apr 2015,CACF,2015,GSCA INC ,OSCH_CHILD_SUPPER,22,5,0,0,5,40,0,0,40,1.8182
SAN DIEGO,May 2015,CACF,2015,GSCA INC ,CHILD_BREAKFAST,20,121,12,27,160,1371,136,306,1813,90.65
SAN DIEGO,May 2015,CACF,2015,GSCA INC ,CHILD_LUNCH,20,121,12,27,160,2181,216,487,2884,144.2
SAN DIEGO,May 2015,CACF,2015,GSCA INC ,CHILD_SNACK_AM,20,121,12,27,160,2160,214,482,2856,142.8
SAN DIEGO,May 2015,CACF,2015,GSCA INC ,CHILD_SUPPER,20,121,12,27,160,771,76,172,1019,50.95
SAN DIEGO,May 2015,CACF,2015,GSCA INC ,OSCH_CHILD_LUNCH,20,5,0,0,5,20,0,0,20,1
SAN DIEGO,May 2015,CACF,2015,GSCA INC ,OSCH_CHILD_SUPPER,20,5,0,0,5,20,0,0,20,1
SAN DIEGO,Jun 2015,CACF,2015,GSCA INC ,CHILD_BREAKFAST,22,131,12,25,168,1634,150,311,2095,95.2273
SAN DIEGO,Jun 2015,CACF,2015,GSCA INC ,CHILD_LUNCH,22,131,12,25,168,2534,232,483,3249,147.6818
SAN DIEGO,Jun 2015,CACF,2015,GSCA INC ,CHILD_SNACK_AM,22,131,12,25,168,2517,230,481,3228,146.7273
SAN DIEGO,Jun 2015,CACF,2015,GSCA INC ,CHILD_SUPPER,22,131,12,25,168,849,78,162,1089,49.5
SAN DIEGO,Jun 2015,CACF,2015,GSCA INC ,OSCH_CHILD_LUNCH,22,5,0,0,5,44,0,0,44,2
SAN DIEGO,Jun 2015,CACF,2015,GSCA INC ,OSCH_CHILD_SNACK_AM,22,5,0,0,5,22,0,0,22,1
SAN DIEGO,Jun 2015,CACF,2015,GSCA INC ,OSCH_CHILD_SUPPER,22,5,0,0,5,44,0,0,44,2
SAN DIEGO,Jul 2015,CACF,2015,GSCA INC ,CHILD_BREAKFAST,22,135,12,25,172,1730,154,320,2204,100.1818
SAN DIEGO,Jul 2015,CACF,2015,GSCA INC ,CHILD_LUNCH,22,135,12,25,172,2626,234,486,3346,152.0909
SAN DIEGO,Jul 2015,CACF,2015,GSCA INC ,CHILD_SNACK_AM,22,135,12,25,172,2620,233,485,3338,151.7273
SAN DIEGO,Jul 2015,CACF,2015,GSCA INC ,CHILD_SUPPER,22,135,12,25,172,866,77,160,1103,50.1364
SAN DIEGO,Jul 2015,CACF,2015,GSCA INC ,OSCH_CHILD_LUNCH,22,5,0,0,5,37,0,0,37,1.6818
SAN DIEGO,Jul 2015,CACF,2015,GSCA INC ,OSCH_CHILD_SNACK_AM,22,5,0,0,5,37,0,0,37,1.6818
SAN DIEGO,Jul 2015,CACF,2015,GSCA INC ,OSCH_CHILD_SUPPER,22,5,0,0,5,36,0,0,36,1.6364
SAN DIEGO,Aug 2015,CACF,2015,GSCA INC ,CHILD_BREAKFAST,21,135,12,25,172,1628,145,301,2074,98.7619
SAN DIEGO,Aug 2015,CACF,2015,GSCA INC ,CHILD_LUNCH,21,135,12,25,172,2488,221,461,3170,150.9524
SAN DIEGO,Aug 2015,CACF,2015,GSCA INC ,CHILD_SNACK_AM,21,135,12,25,172,2497,222,462,3181,151.4762
SAN DIEGO,Aug 2015,CACF,2015,GSCA INC ,CHILD_SUPPER,21,135,12,25,172,833,74,154,1061,50.5238
SAN DIEGO,Sep 2015,CACF,2015,GSCA INC ,CHILD_BREAKFAST,21,135,12,25,172,1613,143,299,2055,97.8571
SAN DIEGO,Sep 2015,CACF,2015,GSCA INC ,CHILD_LUNCH,21,135,12,25,172,2503,223,463,3189,151.8571
SAN DIEGO,Sep 2015,CACF,2015,GSCA INC ,CHILD_SNACK_AM,21,135,12,25,172,2493,222,461,3176,151.2381
SAN DIEGO,Sep 2015,CACF,2015,GSCA INC ,CHILD_SUPPER,21,135,12,25,172,832,74,154,1060,50.4762
SAN DIEGO,Oct 2014,CACF,2015,HAGAR & SHRYOCK,CHILD_BREAKFAST,23,26,5,20,51,371,71,286,728,31.6522
SAN DIEGO,Oct 2014,CACF,2015,HAGAR & SHRYOCK,CHILD_LUNCH,23,26,5,20,51,362,70,278,710,30.8696
SAN DIEGO,Oct 2014,CACF,2015,HAGAR & SHRYOCK,CHILD_SNACK_PM,23,26,5,20,51,441,85,339,865,37.6087
SAN DIEGO,Nov 2014,CACF,2015,HAGAR & SHRYOCK,CHILD_BREAKFAST,18,26,5,20,51,284,55,218,557,30.9444
SAN DIEGO,Nov 2014,CACF,2015,HAGAR & SHRYOCK,CHILD_LUNCH,18,26,5,20,51,277,53,214,544,30.2222
SAN DIEGO,Nov 2014,CACF,2015,HAGAR & SHRYOCK,CHILD_SNACK_PM,18,26,5,20,51,331,64,255,650,36.1111
SAN DIEGO,Dec 2014,CACF,2015,HAGAR & SHRYOCK,CHILD_BREAKFAST,22,26,5,20,51,305,59,234,598,27.1818
SAN DIEGO,Dec 2014,CACF,2015,HAGAR & SHRYOCK,CHILD_LUNCH,22,26,5,20,51,305,59,234,598,27.1818
SAN DIEGO,Dec 2014,CACF,2015,HAGAR & SHRYOCK,CHILD_SNACK_PM,22,26,5,20,51,354,68,272,694,31.5455
SAN DIEGO,Jan 2015,CACF,2015,HAGAR & SHRYOCK,CHILD_BREAKFAST,21,26,5,20,51,280,54,216,550,26.1905
SAN DIEGO,Jan 2015,CACF,2015,HAGAR & SHRYOCK,CHILD_LUNCH,21,26,5,20,51,277,53,214,544,25.9048
SAN DIEGO,Jan 2015,CACF,2015,HAGAR & SHRYOCK,CHILD_SNACK_PM,21,26,5,20,51,332,64,255,651,31
SAN DIEGO,Feb 2015,CACF,2015,HAGAR & SHRYOCK,CHILD_BREAKFAST,20,26,5,20,51,343,66,263,672,33.6
SAN DIEGO,Feb 2015,CACF,2015,HAGAR & SHRYOCK,CHILD_LUNCH,20,26,5,20,51,342,66,262,670,33.5
SAN DIEGO,Feb 2015,CACF,2015,HAGAR & SHRYOCK,CHILD_SNACK_PM,20,26,5,20,51,385,74,296,755,37.75
SAN DIEGO,Mar 2015,CACF,2015,HAGAR & SHRYOCK,CHILD_BREAKFAST,22,26,5,20,51,384,74,296,754,34.2727
SAN DIEGO,Mar 2015,CACF,2015,HAGAR & SHRYOCK,CHILD_LUNCH,22,26,5,20,51,393,76,302,771,35.0455
SAN DIEGO,Mar 2015,CACF,2015,HAGAR & SHRYOCK,CHILD_SNACK_PM,22,26,5,20,51,422,81,325,828,37.6364
SAN DIEGO,Apr 2015,CACF,2015,HAGAR & SHRYOCK,CHILD_BREAKFAST,22,26,5,20,51,435,84,334,853,38.7727
SAN DIEGO,Apr 2015,CACF,2015,HAGAR & SHRYOCK,CHILD_LUNCH,22,26,5,20,51,434,83,334,851,38.6818
SAN DIEGO,Apr 2015,CACF,2015,HAGAR & SHRYOCK,CHILD_SNACK_PM,22,26,5,20,51,479,92,369,940,42.7273
SAN DIEGO,May 2015,CACF,2015,HAGAR & SHRYOCK,CHILD_BREAKFAST,20,26,5,20,51,409,79,315,803,40.15
SAN DIEGO,May 2015,CACF,2015,HAGAR & SHRYOCK,CHILD_LUNCH,20,26,5,20,51,398,76,306,780,39
SAN DIEGO,May 2015,CACF,2015,HAGAR & SHRYOCK,CHILD_SNACK_PM,20,26,5,20,51,434,83,334,851,42.55
SAN DIEGO,Jun 2015,CACF,2015,HAGAR & SHRYOCK,CHILD_BREAKFAST,22,26,5,20,51,367,70,282,719,32.6818
SAN DIEGO,Jun 2015,CACF,2015,HAGAR & SHRYOCK,CHILD_LUNCH,22,26,5,20,51,389,75,300,764,34.7273
SAN DIEGO,Jun 2015,CACF,2015,HAGAR & SHRYOCK,CHILD_SNACK_PM,22,26,5,20,51,373,72,287,732,33.2727
SAN DIEGO,Jul 2015,CACF,2015,HAGAR & SHRYOCK,CHILD_BREAKFAST,23,26,5,20,51,391,75,300,766,33.3043
SAN DIEGO,Jul 2015,CACF,2015,HAGAR & SHRYOCK,CHILD_LUNCH,23,26,5,20,51,428,82,329,839,36.4783
SAN DIEGO,Jul 2015,CACF,2015,HAGAR & SHRYOCK,CHILD_SNACK_PM,23,26,5,20,51,412,79,318,809,35.1739
SAN DIEGO,Aug 2015,CACF,2015,HAGAR & SHRYOCK,CHILD_BREAKFAST,21,26,5,20,51,363,70,280,713,33.9524
SAN DIEGO,Aug 2015,CACF,2015,HAGAR & SHRYOCK,CHILD_LUNCH,21,26,5,20,51,375,72,289,736,35.0476
SAN DIEGO,Aug 2015,CACF,2015,HAGAR & SHRYOCK,CHILD_SNACK_PM,21,26,5,20,51,407,78,314,799,38.0476
SAN DIEGO,Sep 2015,CACF,2015,HAGAR & SHRYOCK,CHILD_BREAKFAST,22,26,5,20,51,393,75,302,770,35
SAN DIEGO,Sep 2015,CACF,2015,HAGAR & SHRYOCK,CHILD_LUNCH,22,26,5,20,51,402,77,309,788,35.8182
SAN DIEGO,Sep 2015,CACF,2015,HAGAR & SHRYOCK,CHILD_SNACK_PM,22,26,5,20,51,438,84,338,860,39.0909
SAN DIEGO,Mar 2015,CACF,2015,HEALTHY SOLUTIONS FOR PARENTS,CHILD_BREAKFAST,21,6,0,0,6,96,0,0,96,4.5714
SAN DIEGO,Mar 2015,CACF,2015,HEALTHY SOLUTIONS FOR PARENTS,CHILD_LUNCH,21,6,0,0,6,96,0,0,96,4.5714
SAN DIEGO,Mar 2015,CACF,2015,HEALTHY SOLUTIONS FOR PARENTS,CHILD_SNACK_PM,21,6,0,0,6,96,0,0,96,4.5714
SAN DIEGO,Apr 2015,CACF,2015,HEALTHY SOLUTIONS FOR PARENTS,CHILD_BREAKFAST,21,8,0,0,8,154,0,0,154,7.3333
SAN DIEGO,Apr 2015,CACF,2015,HEALTHY SOLUTIONS FOR PARENTS,CHILD_LUNCH,21,8,0,0,8,154,0,0,154,7.3333
SAN DIEGO,Apr 2015,CACF,2015,HEALTHY SOLUTIONS FOR PARENTS,CHILD_SNACK_PM,21,8,0,0,8,154,0,0,154,7.3333
SAN DIEGO,Oct 2014,CACF,2015,HEAVEN'S WINDOWS,ATRISK_CHILD_SNACK,23,120,0,0,120,1025,0,0,1025,44.5652
SAN DIEGO,Oct 2014,CACF,2015,HEAVEN'S WINDOWS,ATRISK_CHILD_SUPPER,23,120,0,0,120,1735,0,0,1735,75.4348
SAN DIEGO,Nov 2014,CACF,2015,HEAVEN'S WINDOWS,ATRISK_CHILD_SNACK,16,120,0,0,120,702,0,0,702,43.875
SAN DIEGO,Nov 2014,CACF,2015,HEAVEN'S WINDOWS,ATRISK_CHILD_SUPPER,16,120,0,0,120,1170,0,0,1170,73.125
SAN DIEGO,Dec 2014,CACF,2015,HEAVEN'S WINDOWS,ATRISK_CHILD_SNACK,15,120,0,0,120,874,0,0,874,58.2667
SAN DIEGO,Dec 2014,CACF,2015,HEAVEN'S WINDOWS,ATRISK_CHILD_SUPPER,15,120,0,0,120,1183,0,0,1183,78.8667
SAN DIEGO,Jan 2015,CACF,2015,HEAVEN'S WINDOWS,ATRISK_CHILD_SNACK,19,120,0,0,120,949,0,0,949,49.9474
SAN DIEGO,Jan 2015,CACF,2015,HEAVEN'S WINDOWS,ATRISK_CHILD_SUPPER,19,120,0,0,120,1314,0,0,1314,69.1579
SAN DIEGO,Feb 2015,CACF,2015,HEAVEN'S WINDOWS,ATRISK_CHILD_SNACK,19,120,0,0,120,796,0,0,796,41.8947
SAN DIEGO,Feb 2015,CACF,2015,HEAVEN'S WINDOWS,ATRISK_CHILD_SUPPER,19,120,0,0,120,1318,0,0,1318,69.3684
SAN DIEGO,Mar 2015,CACF,2015,HEAVEN'S WINDOWS,ATRISK_CHILD_SNACK,21,120,0,0,120,1022,0,0,1022,48.6667
SAN DIEGO,Mar 2015,CACF,2015,HEAVEN'S WINDOWS,ATRISK_CHILD_SUPPER,21,120,0,0,120,1533,0,0,1533,73
SAN DIEGO,Apr 2015,CACF,2015,HEAVEN'S WINDOWS,ATRISK_CHILD_SNACK,22,120,0,0,120,1434,0,0,1434,65.1818
SAN DIEGO,Apr 2015,CACF,2015,HEAVEN'S WINDOWS,ATRISK_CHILD_SUPPER,22,120,0,0,120,1835,0,0,1835,83.4091
SAN DIEGO,May 2015,CACF,2015,HEAVEN'S WINDOWS,ATRISK_CHILD_SNACK,20,120,0,0,120,1187,0,0,1187,59.35
SAN DIEGO,May 2015,CACF,2015,HEAVEN'S WINDOWS,ATRISK_CHILD_SUPPER,20,120,0,0,120,1480,0,0,1480,74
SAN DIEGO,Jun 2015,CACF,2015,HEAVEN'S WINDOWS,ATRISK_CHILD_SNACK,15,120,0,0,120,770,0,0,770,51.3333
SAN DIEGO,Jun 2015,CACF,2015,HEAVEN'S WINDOWS,ATRISK_CHILD_SUPPER,15,120,0,0,120,1057,0,0,1057,70.4667
SAN DIEGO,Aug 2015,CACF,2015,HEAVEN'S WINDOWS,ATRISK_CHILD_SNACK,13,80,0,0,80,349,0,0,349,26.8462
SAN DIEGO,Aug 2015,CACF,2015,HEAVEN'S WINDOWS,ATRISK_CHILD_SUPPER,13,80,0,0,80,422,0,0,422,32.4615
SAN DIEGO,Sep 2015,CACF,2015,HEAVEN'S WINDOWS,ATRISK_CHILD_SNACK,20,100,0,0,100,1018,0,0,1018,50.9
SAN DIEGO,Sep 2015,CACF,2015,HEAVEN'S WINDOWS,ATRISK_CHILD_SUPPER,20,100,0,0,100,883,0,0,883,44.15
SAN DIEGO,Oct 2014,CACF,2015,HIGHER LEARNING ACADEMY INC,CHILD_LUNCH,23,62,7,8,77,675,76,87,838,36.4348
SAN DIEGO,Oct 2014,CACF,2015,HIGHER LEARNING ACADEMY INC,CHILD_SNACK_AM,23,62,7,8,77,741,84,95,920,40
SAN DIEGO,Oct 2014,CACF,2015,HIGHER LEARNING ACADEMY INC,CHILD_SUPPER,23,62,7,8,77,774,87,100,961,41.7826
SAN DIEGO,Nov 2014,CACF,2015,HIGHER LEARNING ACADEMY INC,CHILD_LUNCH,16,62,7,8,77,552,62,71,685,42.8125
SAN DIEGO,Nov 2014,CACF,2015,HIGHER LEARNING ACADEMY INC,CHILD_SNACK_AM,16,62,7,8,77,552,62,71,685,42.8125
SAN DIEGO,Nov 2014,CACF,2015,HIGHER LEARNING ACADEMY INC,CHILD_SUPPER,16,62,7,8,77,552,62,71,685,42.8125
SAN DIEGO,Dec 2014,CACF,2015,HIGHER LEARNING ACADEMY INC,CHILD_LUNCH,19,62,7,8,77,500,56,65,621,32.6842
SAN DIEGO,Dec 2014,CACF,2015,HIGHER LEARNING ACADEMY INC,CHILD_SNACK_AM,19,62,7,8,77,589,66,76,731,38.4737
SAN DIEGO,Dec 2014,CACF,2015,HIGHER LEARNING ACADEMY INC,CHILD_SUPPER,19,62,7,8,77,592,67,76,735,38.6842
SAN DIEGO,Jan 2015,CACF,2015,HIGHER LEARNING ACADEMY INC,CHILD_LUNCH,20,62,7,8,77,439,50,56,545,27.25
SAN DIEGO,Jan 2015,CACF,2015,HIGHER LEARNING ACADEMY INC,CHILD_SNACK_AM,20,62,7,8,77,553,62,72,687,34.35
SAN DIEGO,Jan 2015,CACF,2015,HIGHER LEARNING ACADEMY INC,CHILD_SUPPER,20,62,7,8,77,555,63,71,689,34.45
SAN DIEGO,Feb 2015,CACF,2015,HIGHER LEARNING ACADEMY INC,CHILD_LUNCH,20,62,7,8,77,668,75,86,829,41.45
SAN DIEGO,Feb 2015,CACF,2015,HIGHER LEARNING ACADEMY INC,CHILD_SNACK_AM,20,62,7,8,77,779,88,101,968,48.4
SAN DIEGO,Feb 2015,CACF,2015,HIGHER LEARNING ACADEMY INC,CHILD_SUPPER,20,62,7,8,77,787,89,101,977,48.85
SAN DIEGO,Mar 2015,CACF,2015,HIGHER LEARNING ACADEMY INC,CHILD_LUNCH,22,62,7,8,77,779,88,100,967,43.9545
SAN DIEGO,Mar 2015,CACF,2015,HIGHER LEARNING ACADEMY INC,CHILD_SNACK_AM,22,62,7,8,77,920,104,119,1143,51.9545
SAN DIEGO,Mar 2015,CACF,2015,HIGHER LEARNING ACADEMY INC,CHILD_SUPPER,22,62,7,8,77,858,97,110,1065,48.4091
SAN DIEGO,Apr 2015,CACF,2015,HIGHER LEARNING ACADEMY INC,CHILD_LUNCH,22,62,7,8,77,694,78,90,862,39.1818
SAN DIEGO,Apr 2015,CACF,2015,HIGHER LEARNING ACADEMY INC,CHILD_SNACK_AM,22,62,7,8,77,815,92,105,1012,46
SAN DIEGO,Apr 2015,CACF,2015,HIGHER LEARNING ACADEMY INC,CHILD_SUPPER,22,62,7,8,77,796,90,103,989,44.9545
SAN DIEGO,May 2015,CACF,2015,HIGHER LEARNING ACADEMY INC,CHILD_LUNCH,20,62,7,8,77,631,71,82,784,39.2
SAN DIEGO,May 2015,CACF,2015,HIGHER LEARNING ACADEMY INC,CHILD_SNACK_AM,20,62,7,8,77,705,80,90,875,43.75
SAN DIEGO,May 2015,CACF,2015,HIGHER LEARNING ACADEMY INC,CHILD_SUPPER,20,62,7,8,77,734,83,94,911,45.55
SAN DIEGO,Jun 2015,CACF,2015,HIGHER LEARNING ACADEMY INC,CHILD_LUNCH,22,62,7,8,77,784,89,101,974,44.2727
SAN DIEGO,Jun 2015,CACF,2015,HIGHER LEARNING ACADEMY INC,CHILD_SNACK_AM,22,62,7,8,77,871,98,113,1082,49.1818
SAN DIEGO,Jun 2015,CACF,2015,HIGHER LEARNING ACADEMY INC,CHILD_SUPPER,22,62,7,8,77,840,95,108,1043,47.4091
SAN DIEGO,Jul 2015,CACF,2015,HIGHER LEARNING ACADEMY INC,CHILD_LUNCH,23,62,7,8,77,1051,119,135,1305,56.7391
SAN DIEGO,Jul 2015,CACF,2015,HIGHER LEARNING ACADEMY INC,CHILD_SNACK_AM,23,62,7,8,77,913,103,118,1134,49.3043
SAN DIEGO,Jul 2015,CACF,2015,HIGHER LEARNING ACADEMY INC,CHILD_SUPPER,23,62,7,8,77,1023,115,132,1270,55.2174
SAN DIEGO,Aug 2015,CACF,2015,HIGHER LEARNING ACADEMY INC,CHILD_LUNCH,21,62,7,8,77,817,92,106,1015,48.3333
SAN DIEGO,Aug 2015,CACF,2015,HIGHER LEARNING ACADEMY INC,CHILD_SNACK_AM,21,62,7,8,77,792,89,102,983,46.8095
SAN DIEGO,Aug 2015,CACF,2015,HIGHER LEARNING ACADEMY INC,CHILD_SUPPER,21,62,7,8,77,850,96,110,1056,50.2857
SAN DIEGO,Sep 2015,CACF,2015,HIGHER LEARNING ACADEMY INC,CHILD_LUNCH,21,62,7,8,77,655,74,84,813,38.7143
SAN DIEGO,Sep 2015,CACF,2015,HIGHER LEARNING ACADEMY INC,CHILD_SNACK_AM,21,62,7,8,77,675,76,87,838,39.9048
SAN DIEGO,Sep 2015,CACF,2015,HIGHER LEARNING ACADEMY INC,CHILD_SUPPER,21,62,7,8,77,762,86,98,946,45.0476
SAN DIEGO,Oct 2014,CACF,2015,HORIZONS ADHC CENTER INC,ADULT_BREAKFAST,23,255,0,6,261,3073,0,72,3145,136.7391
SAN DIEGO,Oct 2014,CACF,2015,HORIZONS ADHC CENTER INC,ADULT_LUNCH,23,255,0,6,261,3404,0,80,3484,151.4783
SAN DIEGO,Oct 2014,CACF,2015,HORIZONS ADHC CENTER INC,ADULT_SNACK_AM,23,255,0,6,261,331,0,8,339,14.7391
SAN DIEGO,Oct 2014,CACF,2015,HORIZONS ADHC CENTER INC,ADULT_SNACK_PM,23,255,0,6,261,1350,0,32,1382,60.087
SAN DIEGO,Nov 2014,CACF,2015,HORIZONS ADHC CENTER INC,ADULT_BREAKFAST,19,255,0,6,261,2520,0,59,2579,135.7368
SAN DIEGO,Nov 2014,CACF,2015,HORIZONS ADHC CENTER INC,ADULT_LUNCH,19,255,0,6,261,2747,0,65,2812,148
SAN DIEGO,Nov 2014,CACF,2015,HORIZONS ADHC CENTER INC,ADULT_SNACK_AM,19,255,0,6,261,228,0,5,233,12.2632
SAN DIEGO,Nov 2014,CACF,2015,HORIZONS ADHC CENTER INC,ADULT_SNACK_PM,19,255,0,6,261,990,0,23,1013,53.3158
SAN DIEGO,Dec 2014,CACF,2015,HORIZONS ADHC CENTER INC,ADULT_BREAKFAST,22,255,0,6,261,2702,0,64,2766,125.7273
SAN DIEGO,Dec 2014,CACF,2015,HORIZONS ADHC CENTER INC,ADULT_LUNCH,22,255,0,6,261,2889,0,68,2957,134.4091
SAN DIEGO,Dec 2014,CACF,2015,HORIZONS ADHC CENTER INC,ADULT_SNACK_AM,22,255,0,6,261,187,0,4,191,8.6818
SAN DIEGO,Dec 2014,CACF,2015,HORIZONS ADHC CENTER INC,ADULT_SNACK_PM,22,255,0,6,261,987,0,23,1010,45.9091
SAN DIEGO,Jan 2015,CACF,2015,HORIZONS ADHC CENTER INC,ADULT_BREAKFAST,21,255,0,6,261,2780,0,65,2845,135.4762
SAN DIEGO,Jan 2015,CACF,2015,HORIZONS ADHC CENTER INC,ADULT_LUNCH,21,255,0,6,261,2990,0,70,3060,145.7143
SAN DIEGO,Jan 2015,CACF,2015,HORIZONS ADHC CENTER INC,ADULT_SNACK_AM,21,255,0,6,261,210,0,5,215,10.2381
SAN DIEGO,Jan 2015,CACF,2015,HORIZONS ADHC CENTER INC,ADULT_SNACK_PM,21,255,0,6,261,1140,0,27,1167,55.5714
SAN DIEGO,Feb 2015,CACF,2015,HORIZONS ADHC CENTER INC,ADULT_BREAKFAST,20,255,0,6,261,2738,0,64,2802,140.1
SAN DIEGO,Feb 2015,CACF,2015,HORIZONS ADHC CENTER INC,ADULT_LUNCH,20,255,0,6,261,2940,0,69,3009,150.45
SAN DIEGO,Feb 2015,CACF,2015,HORIZONS ADHC CENTER INC,ADULT_SNACK_AM,20,255,0,6,261,202,0,5,207,10.35
SAN DIEGO,Feb 2015,CACF,2015,HORIZONS ADHC CENTER INC,ADULT_SNACK_PM,20,255,0,6,261,1087,0,26,1113,55.65
SAN DIEGO,Mar 2015,CACF,2015,HORIZONS ADHC CENTER INC,ADULT_BREAKFAST,22,255,0,6,261,2997,0,71,3068,139.4545
SAN DIEGO,Mar 2015,CACF,2015,HORIZONS ADHC CENTER INC,ADULT_LUNCH,22,255,0,6,261,3196,0,75,3271,148.6818
SAN DIEGO,Mar 2015,CACF,2015,HORIZONS ADHC CENTER INC,ADULT_SNACK_AM,22,255,0,6,261,198,0,5,203,9.2273
SAN DIEGO,Mar 2015,CACF,2015,HORIZONS ADHC CENTER INC,ADULT_SNACK_PM,22,255,0,6,261,1213,0,29,1242,56.4545
SAN DIEGO,Apr 2015,CACF,2015,HORIZONS ADHC CENTER INC,ADULT_BREAKFAST,22,255,0,6,261,2918,0,69,2987,135.7727
SAN DIEGO,Apr 2015,CACF,2015,HORIZONS ADHC CENTER INC,ADULT_LUNCH,22,255,0,6,261,3181,0,75,3256,148
SAN DIEGO,Apr 2015,CACF,2015,HORIZONS ADHC CENTER INC,ADULT_SNACK_AM,22,255,0,6,261,257,0,6,263,11.9545
SAN DIEGO,Apr 2015,CACF,2015,HORIZONS ADHC CENTER INC,ADULT_SNACK_PM,22,255,0,6,261,1195,0,28,1223,55.5909
SAN DIEGO,May 2015,CACF,2015,HORIZONS ADHC CENTER INC,ADULT_BREAKFAST,21,255,0,6,261,2656,0,63,2719,129.4762
SAN DIEGO,May 2015,CACF,2015,HORIZONS ADHC CENTER INC,ADULT_LUNCH,21,255,0,6,261,3036,0,71,3107,147.9524
SAN DIEGO,May 2015,CACF,2015,HORIZONS ADHC CENTER INC,ADULT_SNACK_AM,21,255,0,6,261,379,0,9,388,18.4762
SAN DIEGO,May 2015,CACF,2015,HORIZONS ADHC CENTER INC,ADULT_SNACK_PM,21,255,0,6,261,1263,0,30,1293,61.5714
SAN DIEGO,Jun 2015,CACF,2015,HORIZONS ADHC CENTER INC,ADULT_BREAKFAST,22,255,0,6,261,2964,0,70,3034,137.9091
SAN DIEGO,Jun 2015,CACF,2015,HORIZONS ADHC CENTER INC,ADULT_LUNCH,22,255,0,6,261,3261,0,77,3338,151.7273
SAN DIEGO,Jun 2015,CACF,2015,HORIZONS ADHC CENTER INC,ADULT_SNACK_AM,22,255,0,6,261,297,0,7,304,13.8182
SAN DIEGO,Jun 2015,CACF,2015,HORIZONS ADHC CENTER INC,ADULT_SNACK_PM,22,255,0,6,261,1335,0,31,1366,62.0909
SAN DIEGO,Jul 2015,CACF,2015,HORIZONS ADHC CENTER INC,ADULT_BREAKFAST,23,255,0,6,261,2992,0,70,3062,133.1304
SAN DIEGO,Jul 2015,CACF,2015,HORIZONS ADHC CENTER INC,ADULT_LUNCH,23,255,0,6,261,3216,0,76,3292,143.1304
SAN DIEGO,Jul 2015,CACF,2015,HORIZONS ADHC CENTER INC,ADULT_SNACK_AM,23,255,0,6,261,367,0,9,376,16.3478
SAN DIEGO,Jul 2015,CACF,2015,HORIZONS ADHC CENTER INC,ADULT_SNACK_PM,23,255,0,6,261,1372,0,32,1404,61.0435
SAN DIEGO,Aug 2015,CACF,2015,HORIZONS ADHC CENTER INC,ADULT_BREAKFAST,21,255,0,6,261,2711,0,64,2775,132.1429
SAN DIEGO,Aug 2015,CACF,2015,HORIZONS ADHC CENTER INC,ADULT_LUNCH,21,255,0,6,261,3060,0,72,3132,149.1429
SAN DIEGO,Aug 2015,CACF,2015,HORIZONS ADHC CENTER INC,ADULT_SNACK_AM,21,255,0,6,261,349,0,8,357,17
SAN DIEGO,Aug 2015,CACF,2015,HORIZONS ADHC CENTER INC,ADULT_SNACK_PM,21,255,0,6,261,1264,0,30,1294,61.619
SAN DIEGO,Sep 2015,CACF,2015,HORIZONS ADHC CENTER INC,ADULT_BREAKFAST,22,255,0,6,261,2823,0,66,2889,131.3182
SAN DIEGO,Sep 2015,CACF,2015,HORIZONS ADHC CENTER INC,ADULT_LUNCH,22,255,0,6,261,3222,0,76,3298,149.9091
SAN DIEGO,Sep 2015,CACF,2015,HORIZONS ADHC CENTER INC,ADULT_SNACK_AM,22,255,0,6,261,400,0,9,409,18.5909
SAN DIEGO,Sep 2015,CACF,2015,HORIZONS ADHC CENTER INC,ADULT_SNACK_PM,22,255,0,6,261,1387,0,33,1420,64.5455
SAN DIEGO,Oct 2014,CACF,2015,J GELT CORPORATION CASA PACIFICA ADHC,ADULT_BREAKFAST,23,176,0,3,179,866,0,15,881,38.3043
SAN DIEGO,Oct 2014,CACF,2015,J GELT CORPORATION CASA PACIFICA ADHC,ADULT_LUNCH,23,176,0,3,179,2800,0,48,2848,123.8261
SAN DIEGO,Oct 2014,CACF,2015,J GELT CORPORATION CASA PACIFICA ADHC,ADULT_SNACK_AM,23,176,0,3,179,789,0,13,802,34.8696
SAN DIEGO,Oct 2014,CACF,2015,J GELT CORPORATION CASA PACIFICA ADHC,ADULT_SNACK_PM,23,176,0,3,179,1112,0,19,1131,49.1739
SAN DIEGO,Nov 2014,CACF,2015,J GELT CORPORATION CASA PACIFICA ADHC,ADULT_BREAKFAST,19,176,0,3,179,700,0,12,712,37.4737
SAN DIEGO,Nov 2014,CACF,2015,J GELT CORPORATION CASA PACIFICA ADHC,ADULT_LUNCH,19,176,0,3,179,2311,0,39,2350,123.6842
SAN DIEGO,Nov 2014,CACF,2015,J GELT CORPORATION CASA PACIFICA ADHC,ADULT_SNACK_AM,19,176,0,3,179,698,0,12,710,37.3684
SAN DIEGO,Nov 2014,CACF,2015,J GELT CORPORATION CASA PACIFICA ADHC,ADULT_SNACK_PM,19,176,0,3,179,893,0,15,908,47.7895
SAN DIEGO,Dec 2014,CACF,2015,J GELT CORPORATION CASA PACIFICA ADHC,ADULT_BREAKFAST,22,176,0,3,179,813,0,14,827,37.5909
SAN DIEGO,Dec 2014,CACF,2015,J GELT CORPORATION CASA PACIFICA ADHC,ADULT_LUNCH,22,176,0,3,179,2571,0,44,2615,118.8636
SAN DIEGO,Dec 2014,CACF,2015,J GELT CORPORATION CASA PACIFICA ADHC,ADULT_SNACK_AM,22,176,0,3,179,730,0,12,742,33.7273
SAN DIEGO,Dec 2014,CACF,2015,J GELT CORPORATION CASA PACIFICA ADHC,ADULT_SNACK_PM,22,176,0,3,179,955,0,16,971,44.1364
SAN DIEGO,Jan 2015,CACF,2015,J GELT CORPORATION CASA PACIFICA ADHC,ADULT_BREAKFAST,21,176,0,3,179,859,0,15,874,41.619
SAN DIEGO,Jan 2015,CACF,2015,J GELT CORPORATION CASA PACIFICA ADHC,ADULT_LUNCH,21,176,0,3,179,2490,0,43,2533,120.619
SAN DIEGO,Jan 2015,CACF,2015,J GELT CORPORATION CASA PACIFICA ADHC,ADULT_SNACK_AM,21,176,0,3,179,692,0,12,704,33.5238
SAN DIEGO,Jan 2015,CACF,2015,J GELT CORPORATION CASA PACIFICA ADHC,ADULT_SNACK_PM,21,176,0,3,179,930,0,16,946,45.0476
SAN DIEGO,Feb 2015,CACF,2015,J GELT CORPORATION CASA PACIFICA ADHC,ADULT_BREAKFAST,20,176,0,3,179,899,0,15,914,45.7
SAN DIEGO,Feb 2015,CACF,2015,J GELT CORPORATION CASA PACIFICA ADHC,ADULT_LUNCH,20,176,0,3,179,2282,0,39,2321,116.05
SAN DIEGO,Feb 2015,CACF,2015,J GELT CORPORATION CASA PACIFICA ADHC,ADULT_SNACK_AM,20,176,0,3,179,534,0,9,543,27.15
SAN DIEGO,Feb 2015,CACF,2015,J GELT CORPORATION CASA PACIFICA ADHC,ADULT_SNACK_PM,20,176,0,3,179,872,0,15,887,44.35
SAN DIEGO,Mar 2015,CACF,2015,J GELT CORPORATION CASA PACIFICA ADHC,ADULT_BREAKFAST,22,176,0,3,179,915,0,16,931,42.3182
SAN DIEGO,Mar 2015,CACF,2015,J GELT CORPORATION CASA PACIFICA ADHC,ADULT_LUNCH,22,176,0,3,179,2483,0,42,2525,114.7727
SAN DIEGO,Mar 2015,CACF,2015,J GELT CORPORATION CASA PACIFICA ADHC,ADULT_SNACK_AM,22,176,0,3,179,660,0,11,671,30.5
SAN DIEGO,Mar 2015,CACF,2015,J GELT CORPORATION CASA PACIFICA ADHC,ADULT_SNACK_PM,22,176,0,3,179,1018,0,17,1035,47.0455
SAN DIEGO,Apr 2015,CACF,2015,J GELT CORPORATION CASA PACIFICA ADHC,ADULT_BREAKFAST,22,176,0,3,179,1015,0,17,1032,46.9091
SAN DIEGO,Apr 2015,CACF,2015,J GELT CORPORATION CASA PACIFICA ADHC,ADULT_LUNCH,22,176,0,3,179,2618,0,45,2663,121.0455
SAN DIEGO,Apr 2015,CACF,2015,J GELT CORPORATION CASA PACIFICA ADHC,ADULT_SNACK_AM,22,176,0,3,179,655,0,11,666,30.2727
SAN DIEGO,Apr 2015,CACF,2015,J GELT CORPORATION CASA PACIFICA ADHC,ADULT_SNACK_PM,22,176,0,3,179,1024,0,18,1042,47.3636
SAN DIEGO,May 2015,CACF,2015,J GELT CORPORATION CASA PACIFICA ADHC,ADULT_BREAKFAST,20,176,0,3,179,958,0,16,974,48.7
SAN DIEGO,May 2015,CACF,2015,J GELT CORPORATION CASA PACIFICA ADHC,ADULT_LUNCH,20,176,0,3,179,2525,0,43,2568,128.4
SAN DIEGO,May 2015,CACF,2015,J GELT CORPORATION CASA PACIFICA ADHC,ADULT_SNACK_AM,20,176,0,3,179,611,0,10,621,31.05
SAN DIEGO,May 2015,CACF,2015,J GELT CORPORATION CASA PACIFICA ADHC,ADULT_SNACK_PM,20,176,0,3,179,1003,0,17,1020,51
SAN DIEGO,Jun 2015,CACF,2015,J GELT CORPORATION CASA PACIFICA ADHC,ADULT_BREAKFAST,22,176,0,3,179,1320,0,23,1343,61.0455
SAN DIEGO,Jun 2015,CACF,2015,J GELT CORPORATION CASA PACIFICA ADHC,ADULT_LUNCH,22,176,0,3,179,2858,0,49,2907,132.1364
SAN DIEGO,Jun 2015,CACF,2015,J GELT CORPORATION CASA PACIFICA ADHC,ADULT_SNACK_AM,22,176,0,3,179,483,0,8,491,22.3182
SAN DIEGO,Jun 2015,CACF,2015,J GELT CORPORATION CASA PACIFICA ADHC,ADULT_SNACK_PM,22,176,0,3,179,1160,0,20,1180,53.6364
SAN DIEGO,Jul 2015,CACF,2015,J GELT CORPORATION CASA PACIFICA ADHC,ADULT_BREAKFAST,22,176,0,3,179,1535,0,26,1561,70.9545
SAN DIEGO,Jul 2015,CACF,2015,J GELT CORPORATION CASA PACIFICA ADHC,ADULT_LUNCH,22,176,0,3,179,3023,0,52,3075,139.7727
SAN DIEGO,Jul 2015,CACF,2015,J GELT CORPORATION CASA PACIFICA ADHC,ADULT_SNACK_AM,22,176,0,3,179,401,0,7,408,18.5455
SAN DIEGO,Jul 2015,CACF,2015,J GELT CORPORATION CASA PACIFICA ADHC,ADULT_SNACK_PM,22,176,0,3,179,1175,0,20,1195,54.3182
SAN DIEGO,Aug 2015,CACF,2015,J GELT CORPORATION CASA PACIFICA ADHC,ADULT_BREAKFAST,21,176,0,3,179,1388,0,24,1412,67.2381
SAN DIEGO,Aug 2015,CACF,2015,J GELT CORPORATION CASA PACIFICA ADHC,ADULT_LUNCH,21,176,0,3,179,2893,0,49,2942,140.0952
SAN DIEGO,Aug 2015,CACF,2015,J GELT CORPORATION CASA PACIFICA ADHC,ADULT_SNACK_AM,21,176,0,3,179,544,0,9,553,26.3333
SAN DIEGO,Aug 2015,CACF,2015,J GELT CORPORATION CASA PACIFICA ADHC,ADULT_SNACK_PM,21,176,0,3,179,1100,0,19,1119,53.2857
SAN DIEGO,Sep 2015,CACF,2015,J GELT CORPORATION CASA PACIFICA ADHC,ADULT_BREAKFAST,21,176,0,3,179,1297,0,22,1319,62.8095
SAN DIEGO,Sep 2015,CACF,2015,J GELT CORPORATION CASA PACIFICA ADHC,ADULT_LUNCH,21,176,0,3,179,3076,0,53,3129,149
SAN DIEGO,Sep 2015,CACF,2015,J GELT CORPORATION CASA PACIFICA ADHC,ADULT_SNACK_AM,21,176,0,3,179,722,0,12,734,34.9524
SAN DIEGO,Sep 2015,CACF,2015,J GELT CORPORATION CASA PACIFICA ADHC,ADULT_SNACK_PM,21,176,0,3,179,1145,0,20,1165,55.4762
SAN DIEGO,Oct 2014,CACF,2015,Julian Union Elementary School District,ATRISK_CHILD_SNACK_NT,23,308,0,0,308,1167,0,0,1167,50.7391
SAN DIEGO,Oct 2014,CACF,2015,Julian Union Elementary School District,ATRISK_CHILD_SUPPER,23,308,0,0,308,2171,0,0,2171,94.3913
SAN DIEGO,Nov 2014,CACF,2015,Julian Union Elementary School District,ATRISK_CHILD_SNACK_NT,13,306,0,0,306,587,0,0,587,45.1538
SAN DIEGO,Nov 2014,CACF,2015,Julian Union Elementary School District,ATRISK_CHILD_SUPPER,13,306,0,0,306,1155,0,0,1155,88.8462
SAN DIEGO,Dec 2014,CACF,2015,Julian Union Elementary School District,ATRISK_CHILD_SNACK_NT,15,305,0,0,305,581,0,0,581,38.7333
SAN DIEGO,Dec 2014,CACF,2015,Julian Union Elementary School District,ATRISK_CHILD_SUPPER,15,305,0,0,305,1173,0,0,1173,78.2
SAN DIEGO,Jan 2015,CACF,2015,Julian Union Elementary School District,ATRISK_CHILD_SNACK_NT,14,320,0,0,320,689,0,0,689,49.2143
SAN DIEGO,Jan 2015,CACF,2015,Julian Union Elementary School District,ATRISK_CHILD_SUPPER,14,320,0,0,320,1437,0,0,1437,102.6429
SAN DIEGO,Feb 2015,CACF,2015,Julian Union Elementary School District,ATRISK_CHILD_SNACK_NT,18,320,0,0,320,1062,0,0,1062,59
SAN DIEGO,Feb 2015,CACF,2015,Julian Union Elementary School District,ATRISK_CHILD_SUPPER,18,320,0,0,320,1686,0,0,1686,93.6667
SAN DIEGO,Mar 2015,CACF,2015,Julian Union Elementary School District,ATRISK_CHILD_SNACK_NT,20,322,0,0,322,1103,0,0,1103,55.15
SAN DIEGO,Mar 2015,CACF,2015,Julian Union Elementary School District,ATRISK_CHILD_SUPPER,20,322,0,0,322,1344,0,0,1344,67.2
SAN DIEGO,Apr 2015,CACF,2015,Julian Union Elementary School District,ATRISK_CHILD_SNACK_NT,17,328,0,0,328,938,0,0,938,55.1765
SAN DIEGO,Apr 2015,CACF,2015,Julian Union Elementary School District,ATRISK_CHILD_SUPPER,17,328,0,0,328,1306,0,0,1306,76.8235
SAN DIEGO,May 2015,CACF,2015,Julian Union Elementary School District,ATRISK_CHILD_SNACK_NT,21,330,0,0,330,877,0,0,877,41.7619
SAN DIEGO,May 2015,CACF,2015,Julian Union Elementary School District,ATRISK_CHILD_SUPPER,21,330,0,0,330,1143,0,0,1143,54.4286
SAN DIEGO,Jun 2015,CACF,2015,Julian Union Elementary School District,ATRISK_CHILD_SNACK_NT,5,329,0,0,329,200,0,0,200,40
SAN DIEGO,Jun 2015,CACF,2015,Julian Union Elementary School District,ATRISK_CHILD_SUPPER,5,329,0,0,329,692,0,0,692,138.4
SAN DIEGO,Aug 2015,CACF,2015,Julian Union Elementary School District,ATRISK_CHILD_SNACK_NT,15,320,0,0,320,877,0,0,877,58.4667
SAN DIEGO,Aug 2015,CACF,2015,Julian Union Elementary School District,ATRISK_CHILD_SUPPER,15,320,0,0,320,938,0,0,938,62.5333
SAN DIEGO,Sep 2015,CACF,2015,Julian Union Elementary School District,ATRISK_CHILD_SNACK_NT,21,315,0,0,315,1604,0,0,1604,76.381
SAN DIEGO,Sep 2015,CACF,2015,Julian Union Elementary School District,ATRISK_CHILD_SUPPER,21,315,0,0,315,1657,0,0,1657,78.9048
SAN DIEGO,Oct 2014,CACF,2015,LA JOLLA BAND OF LUISENO,ATRISK_CHILD_SUPPER,17,40,0,0,40,374,0,0,374,22
SAN DIEGO,Nov 2014,CACF,2015,LA JOLLA BAND OF LUISENO,ATRISK_CHILD_SUPPER,11,40,0,0,40,225,0,0,225,20.4545
SAN DIEGO,Dec 2014,CACF,2015,LA JOLLA BAND OF LUISENO,ATRISK_CHILD_SUPPER,6,40,0,0,40,120,0,0,120,20
SAN DIEGO,Jan 2015,CACF,2015,LA JOLLA BAND OF LUISENO,ATRISK_CHILD_SUPPER,16,40,0,0,40,461,0,0,461,28.8125
SAN DIEGO,Feb 2015,CACF,2015,LA JOLLA BAND OF LUISENO,ATRISK_CHILD_SUPPER,12,40,0,0,40,314,0,0,314,26.1667
SAN DIEGO,Mar 2015,CACF,2015,LA JOLLA BAND OF LUISENO,ATRISK_CHILD_SUPPER,18,45,0,0,45,450,0,0,450,25
SAN DIEGO,Apr 2015,CACF,2015,LA JOLLA BAND OF LUISENO,ATRISK_CHILD_SUPPER,14,30,0,0,30,290,0,0,290,20.7143
SAN DIEGO,May 2015,CACF,2015,LA JOLLA BAND OF LUISENO,ATRISK_CHILD_SUPPER,14,40,0,0,40,400,0,0,400,28.5714
SAN DIEGO,Sep 2015,CACF,2015,LA JOLLA BAND OF LUISENO,ATRISK_CHILD_SUPPER,13,40,0,0,40,327,0,0,327,25.1538
SAN DIEGO,Oct 2014,CACF,2015,La Mesa-Spring Valley School District,ATRISK_CHILD_SNACK,13,1288,0,0,1288,2017,0,0,2017,155.1538
SAN DIEGO,Oct 2014,CACF,2015,La Mesa-Spring Valley School District,ATRISK_CHILD_SUPPER,13,1288,0,0,1288,10435,0,0,10435,802.6923
SAN DIEGO,Nov 2014,CACF,2015,La Mesa-Spring Valley School District,ATRISK_CHILD_SNACK,14,1215,0,0,1215,2310,0,0,2310,165
SAN DIEGO,Nov 2014,CACF,2015,La Mesa-Spring Valley School District,ATRISK_CHILD_SUPPER,14,1215,0,0,1215,10983,0,0,10983,784.5
SAN DIEGO,Dec 2014,CACF,2015,La Mesa-Spring Valley School District,ATRISK_CHILD_SNACK,15,1317,0,0,1317,2165,0,0,2165,144.3333
SAN DIEGO,Dec 2014,CACF,2015,La Mesa-Spring Valley School District,ATRISK_CHILD_SUPPER,15,1317,0,0,1317,12909,0,0,12909,860.6
SAN DIEGO,Jan 2015,CACF,2015,La Mesa-Spring Valley School District,ATRISK_CHILD_SNACK,19,1287,0,0,1287,2605,0,0,2605,137.1053
SAN DIEGO,Jan 2015,CACF,2015,La Mesa-Spring Valley School District,ATRISK_CHILD_SUPPER,19,1287,0,0,1287,16063,0,0,16063,845.4211
SAN DIEGO,Feb 2015,CACF,2015,La Mesa-Spring Valley School District,ATRISK_CHILD_SNACK,18,7893,0,0,7893,2592,0,0,2592,144
SAN DIEGO,Feb 2015,CACF,2015,La Mesa-Spring Valley School District,ATRISK_CHILD_SUPPER,18,7893,0,0,7893,15342,0,0,15342,852.3333
SAN DIEGO,Mar 2015,CACF,2015,La Mesa-Spring Valley School District,ATRISK_CHILD_SNACK,20,1297,0,0,1297,2952,0,0,2952,147.6
SAN DIEGO,Mar 2015,CACF,2015,La Mesa-Spring Valley School District,ATRISK_CHILD_SUPPER,20,1297,0,0,1297,17092,0,0,17092,854.6
SAN DIEGO,Apr 2015,CACF,2015,La Mesa-Spring Valley School District,ATRISK_CHILD_SNACK,14,1297,0,0,1297,2104,0,0,2104,150.2857
SAN DIEGO,Apr 2015,CACF,2015,La Mesa-Spring Valley School District,ATRISK_CHILD_SUPPER,14,1297,0,0,1297,12130,0,0,12130,866.4286
SAN DIEGO,May 2015,CACF,2015,La Mesa-Spring Valley School District,ATRISK_CHILD_SNACK,20,1297,0,0,1297,2962,0,0,2962,148.1
SAN DIEGO,May 2015,CACF,2015,La Mesa-Spring Valley School District,ATRISK_CHILD_SUPPER,20,1297,0,0,1297,17201,0,0,17201,860.05
SAN DIEGO,Jun 2015,CACF,2015,La Mesa-Spring Valley School District,ATRISK_CHILD_SNACK,22,1297,0,0,1297,2140,0,0,2140,97.2727
SAN DIEGO,Jun 2015,CACF,2015,La Mesa-Spring Valley School District,ATRISK_CHILD_SUPPER,22,1297,0,0,1297,11760,0,0,11760,534.5455
SAN DIEGO,Aug 2015,CACF,2015,La Mesa-Spring Valley School District,ATRISK_CHILD_SNACK,13,1233,0,0,1233,2278,0,0,2278,175.2308
SAN DIEGO,Aug 2015,CACF,2015,La Mesa-Spring Valley School District,ATRISK_CHILD_SUPPER,13,1233,0,0,1233,10179,0,0,10179,783
SAN DIEGO,Sep 2015,CACF,2015,La Mesa-Spring Valley School District,ATRISK_CHILD_SNACK,20,1310,0,0,1310,3574,0,0,3574,178.7
SAN DIEGO,Sep 2015,CACF,2015,La Mesa-Spring Valley School District,ATRISK_CHILD_SUPPER,20,1310,0,0,1310,18035,0,0,18035,901.75
SAN DIEGO,Oct 2014,CACF,2015,Lakeside Union Elementary School District,ATRISK_CHILD_SUPPER,23,683,0,0,683,10978,0,0,10978,477.3043
SAN DIEGO,Nov 2014,CACF,2015,Lakeside Union Elementary School District,ATRISK_CHILD_SUPPER,14,637,0,0,637,6740,0,0,6740,481.4286
SAN DIEGO,Dec 2014,CACF,2015,Lakeside Union Elementary School District,ATRISK_CHILD_SUPPER,15,592,0,0,592,6544,0,0,6544,436.2667
SAN DIEGO,Jan 2015,CACF,2015,Lakeside Union Elementary School District,ATRISK_CHILD_SUPPER,18,610,0,0,610,8390,0,0,8390,466.1111
SAN DIEGO,Feb 2015,CACF,2015,Lakeside Union Elementary School District,ATRISK_CHILD_SUPPER,18,580,0,0,580,8149,0,0,8149,452.7222
SAN DIEGO,Mar 2015,CACF,2015,Lakeside Union Elementary School District,ATRISK_CHILD_SUPPER,20,582,0,0,582,8774,0,0,8774,438.7
SAN DIEGO,Apr 2015,CACF,2015,Lakeside Union Elementary School District,ATRISK_CHILD_SUPPER,14,555,0,0,555,6411,0,0,6411,457.9286
SAN DIEGO,May 2015,CACF,2015,Lakeside Union Elementary School District,ATRISK_CHILD_SUPPER,20,569,0,0,569,8706,0,0,8706,435.3
SAN DIEGO,Jun 2015,CACF,2015,Lakeside Union Elementary School District,ATRISK_CHILD_SUPPER,15,457,0,0,457,5478,0,0,5478,365.2
SAN DIEGO,Sep 2015,CACF,2015,Lakeside Union Elementary School District,ATRISK_CHILD_SUPPER,21,647,0,0,647,10247,0,0,10247,487.9524
SAN DIEGO,Oct 2014,CACF,2015,Lemon Grove School District,ATRISK_CHILD_SUPPER,23,801,0,0,801,13561,0,0,13561,589.6087
SAN DIEGO,Nov 2014,CACF,2015,Lemon Grove School District,ATRISK_CHILD_SUPPER,14,801,0,0,801,8568,0,0,8568,612
SAN DIEGO,Dec 2014,CACF,2015,Lemon Grove School District,ATRISK_CHILD_SUPPER,15,801,0,0,801,9526,0,0,9526,635.0667
SAN DIEGO,Jan 2015,CACF,2015,Lemon Grove School District,ATRISK_CHILD_SUPPER,19,801,0,0,801,11797,0,0,11797,620.8947
SAN DIEGO,Feb 2015,CACF,2015,Lemon Grove School District,ATRISK_CHILD_SUPPER,18,832,0,0,832,11267,0,0,11267,625.9444
SAN DIEGO,Mar 2015,CACF,2015,Lemon Grove School District,ATRISK_CHILD_SUPPER,22,832,0,0,832,13026,0,0,13026,592.0909
SAN DIEGO,Apr 2015,CACF,2015,Lemon Grove School District,ATRISK_CHILD_SUPPER,22,812,0,0,812,8712,0,0,8712,396
SAN DIEGO,May 2015,CACF,2015,Lemon Grove School District,ATRISK_CHILD_SUPPER,20,812,0,0,812,11623,0,0,11623,581.15
SAN DIEGO,Jun 2015,CACF,2015,Lemon Grove School District,ATRISK_CHILD_SUPPER,8,812,0,0,812,4381,0,0,4381,547.625
SAN DIEGO,Aug 2015,CACF,2015,Lemon Grove School District,ATRISK_CHILD_SUPPER,9,785,0,0,785,4804,0,0,4804,533.7778
SAN DIEGO,Sep 2015,CACF,2015,Lemon Grove School District,ATRISK_CHILD_SUPPER,21,785,0,0,785,11247,0,0,11247,535.5714
SAN DIEGO,Oct 2014,CACF,2015,LIFEBRIDGE CHURCH,CHILD_LUNCH,23,0,0,115,115,0,0,1623,1623,70.5652
SAN DIEGO,Oct 2014,CACF,2015,LIFEBRIDGE CHURCH,CHILD_SNACK_AM,23,0,0,115,115,0,0,1795,1795,78.0435
SAN DIEGO,Oct 2014,CACF,2015,LIFEBRIDGE CHURCH,CHILD_SNACK_PM,23,0,0,115,115,0,0,1381,1381,60.0435
SAN DIEGO,Nov 2014,CACF,2015,LIFEBRIDGE CHURCH,CHILD_LUNCH,18,0,0,115,115,0,0,1243,1243,69.0556
SAN DIEGO,Nov 2014,CACF,2015,LIFEBRIDGE CHURCH,CHILD_SNACK_AM,18,0,0,115,115,0,0,1341,1341,74.5
SAN DIEGO,Nov 2014,CACF,2015,LIFEBRIDGE CHURCH,CHILD_SNACK_PM,18,0,0,115,115,0,0,1024,1024,56.8889
SAN DIEGO,Dec 2014,CACF,2015,LIFEBRIDGE CHURCH,CHILD_LUNCH,17,0,0,115,115,0,0,1202,1202,70.7059
SAN DIEGO,Dec 2014,CACF,2015,LIFEBRIDGE CHURCH,CHILD_SNACK_AM,17,0,0,115,115,0,0,1284,1284,75.5294
SAN DIEGO,Dec 2014,CACF,2015,LIFEBRIDGE CHURCH,CHILD_SNACK_PM,17,0,0,115,115,0,0,1012,1012,59.5294
SAN DIEGO,Jan 2015,CACF,2015,LIFEBRIDGE CHURCH,CHILD_LUNCH,20,0,0,115,115,0,0,1537,1537,76.85
SAN DIEGO,Jan 2015,CACF,2015,LIFEBRIDGE CHURCH,CHILD_SNACK_AM,20,0,0,115,115,0,0,1610,1610,80.5
SAN DIEGO,Jan 2015,CACF,2015,LIFEBRIDGE CHURCH,CHILD_SNACK_PM,20,0,0,115,115,0,0,1293,1293,64.65
SAN DIEGO,Feb 2015,CACF,2015,LIFEBRIDGE CHURCH,CHILD_LUNCH,19,0,0,115,115,0,0,1477,1477,77.7368
SAN DIEGO,Feb 2015,CACF,2015,LIFEBRIDGE CHURCH,CHILD_SNACK_AM,19,0,0,115,115,0,0,1543,1543,81.2105
SAN DIEGO,Feb 2015,CACF,2015,LIFEBRIDGE CHURCH,CHILD_SNACK_PM,19,0,0,115,115,0,0,1199,1199,63.1053
SAN DIEGO,Mar 2015,CACF,2015,LIFEBRIDGE CHURCH,CHILD_LUNCH,22,0,0,115,115,0,0,1874,1874,85.1818
SAN DIEGO,Mar 2015,CACF,2015,LIFEBRIDGE CHURCH,CHILD_SNACK_AM,22,0,0,115,115,0,0,1948,1948,88.5455
SAN DIEGO,Mar 2015,CACF,2015,LIFEBRIDGE CHURCH,CHILD_SNACK_PM,22,0,0,115,115,0,0,1520,1520,69.0909
SAN DIEGO,Apr 2015,CACF,2015,LIFEBRIDGE CHURCH,CHILD_LUNCH,21,0,0,115,115,0,0,1677,1677,79.8571
SAN DIEGO,Apr 2015,CACF,2015,LIFEBRIDGE CHURCH,CHILD_SNACK_AM,21,0,0,115,115,0,0,1850,1850,88.0952
SAN DIEGO,Apr 2015,CACF,2015,LIFEBRIDGE CHURCH,CHILD_SNACK_PM,21,0,0,115,115,0,0,1476,1476,70.2857
SAN DIEGO,May 2015,CACF,2015,LIFEBRIDGE CHURCH,CHILD_LUNCH,20,0,0,115,115,0,0,1708,1708,85.4
SAN DIEGO,May 2015,CACF,2015,LIFEBRIDGE CHURCH,CHILD_SNACK_AM,20,0,0,115,115,0,0,1849,1849,92.45
SAN DIEGO,May 2015,CACF,2015,LIFEBRIDGE CHURCH,CHILD_SNACK_PM,20,0,0,115,115,0,0,1474,1474,73.7
SAN DIEGO,Jun 2015,CACF,2015,LIFEBRIDGE CHURCH,CHILD_LUNCH,22,0,0,115,115,0,0,1394,1394,63.3636
SAN DIEGO,Jun 2015,CACF,2015,LIFEBRIDGE CHURCH,CHILD_SNACK_AM,22,0,0,115,115,0,0,1574,1574,71.5455
SAN DIEGO,Jun 2015,CACF,2015,LIFEBRIDGE CHURCH,CHILD_SNACK_PM,22,0,0,115,115,0,0,1241,1241,56.4091
SAN DIEGO,Jul 2015,CACF,2015,LIFEBRIDGE CHURCH,CHILD_LUNCH,23,0,0,115,115,0,0,1196,1196,52
SAN DIEGO,Jul 2015,CACF,2015,LIFEBRIDGE CHURCH,CHILD_SNACK_AM,23,0,0,115,115,0,0,1326,1326,57.6522
SAN DIEGO,Jul 2015,CACF,2015,LIFEBRIDGE CHURCH,CHILD_SNACK_PM,23,0,0,115,115,0,0,1006,1006,43.7391
SAN DIEGO,Aug 2015,CACF,2015,LIFEBRIDGE CHURCH,CHILD_LUNCH,18,0,0,115,115,0,0,1132,1132,62.8889
SAN DIEGO,Aug 2015,CACF,2015,LIFEBRIDGE CHURCH,CHILD_SNACK_AM,18,0,0,115,115,0,0,1189,1189,66.0556
SAN DIEGO,Aug 2015,CACF,2015,LIFEBRIDGE CHURCH,CHILD_SNACK_PM,18,0,0,115,115,0,0,982,982,54.5556
SAN DIEGO,Sep 2015,CACF,2015,LIFEBRIDGE CHURCH,CHILD_LUNCH,21,0,0,115,115,0,0,1629,1629,77.5714
SAN DIEGO,Sep 2015,CACF,2015,LIFEBRIDGE CHURCH,CHILD_SNACK_AM,21,0,0,115,115,0,0,1695,1695,80.7143
SAN DIEGO,Sep 2015,CACF,2015,LIFEBRIDGE CHURCH,CHILD_SNACK_PM,21,0,0,115,115,0,0,1410,1410,67.1429
SAN DIEGO,Oct 2014,CACF,2015,LINERS CORP ,ADULT_LUNCH,23,122,0,2,124,1794,0,29,1823,79.2609
SAN DIEGO,Oct 2014,CACF,2015,LINERS CORP ,ADULT_SNACK_AM,23,122,0,2,124,1792,0,29,1821,79.1739
SAN DIEGO,Nov 2014,CACF,2015,LINERS CORP ,ADULT_LUNCH,18,122,0,2,124,1436,0,24,1460,81.1111
SAN DIEGO,Nov 2014,CACF,2015,LINERS CORP ,ADULT_SNACK_AM,18,122,0,2,124,1436,0,24,1460,81.1111
SAN DIEGO,Dec 2014,CACF,2015,LINERS CORP ,ADULT_LUNCH,20,117,0,1,118,1578,0,14,1592,79.6
SAN DIEGO,Dec 2014,CACF,2015,LINERS CORP ,ADULT_SNACK_AM,20,117,0,1,118,1570,0,13,1583,79.15
SAN DIEGO,Jan 2015,CACF,2015,LINERS CORP ,ADULT_LUNCH,21,120,0,1,121,1400,0,12,1412,67.2381
SAN DIEGO,Jan 2015,CACF,2015,LINERS CORP ,ADULT_SNACK_AM,21,120,0,1,121,1373,0,11,1384,65.9048
SAN DIEGO,Feb 2015,CACF,2015,LINERS CORP ,ADULT_LUNCH,20,113,0,1,114,1482,0,13,1495,74.75
SAN DIEGO,Feb 2015,CACF,2015,LINERS CORP ,ADULT_SNACK_AM,20,113,0,1,114,1465,0,13,1478,73.9
SAN DIEGO,Feb 2015,CACF,2015,LINERS CORP ,ADULT_SNACK_PM,20,113,0,1,114,420,0,4,424,21.2
SAN DIEGO,Mar 2015,CACF,2015,LINERS CORP ,ADULT_BREAKFAST,22,123,0,2,125,635,0,10,645,29.3182
SAN DIEGO,Mar 2015,CACF,2015,LINERS CORP ,ADULT_LUNCH,22,123,0,2,125,1618,0,26,1644,74.7273
SAN DIEGO,Mar 2015,CACF,2015,LINERS CORP ,ADULT_SNACK_AM,22,123,0,2,125,932,0,15,947,43.0455
SAN DIEGO,Mar 2015,CACF,2015,LINERS CORP ,ADULT_SNACK_PM,22,123,0,2,125,1021,0,17,1038,47.1818
SAN DIEGO,Apr 2015,CACF,2015,LINERS CORP ,ADULT_BREAKFAST,22,124,0,1,125,1297,0,10,1307,59.4091
SAN DIEGO,Apr 2015,CACF,2015,LINERS CORP ,ADULT_LUNCH,22,124,0,1,125,1575,0,13,1588,72.1818
SAN DIEGO,Apr 2015,CACF,2015,LINERS CORP ,ADULT_SNACK_PM,22,124,0,1,125,1016,0,8,1024,46.5455
SAN DIEGO,May 2015,CACF,2015,LINERS CORP ,ADULT_BREAKFAST,20,122,0,7,129,1201,0,69,1270,63.5
SAN DIEGO,May 2015,CACF,2015,LINERS CORP ,ADULT_LUNCH,20,122,0,7,129,1458,0,84,1542,77.1
SAN DIEGO,May 2015,CACF,2015,LINERS CORP ,ADULT_SNACK_PM,20,122,0,7,129,787,0,45,832,41.6
SAN DIEGO,Jun 2015,CACF,2015,LINERS CORP ,ADULT_BREAKFAST,22,120,0,7,127,1447,0,84,1531,69.5909
SAN DIEGO,Jun 2015,CACF,2015,LINERS CORP ,ADULT_LUNCH,22,120,0,7,127,1678,0,98,1776,80.7273
SAN DIEGO,Jun 2015,CACF,2015,LINERS CORP ,ADULT_SNACK_PM,22,120,0,7,127,1008,0,59,1067,48.5
SAN DIEGO,Jul 2015,CACF,2015,LINERS CORP ,ADULT_BREAKFAST,22,120,0,7,127,1338,0,78,1416,64.3636
SAN DIEGO,Jul 2015,CACF,2015,LINERS CORP ,ADULT_LUNCH,22,120,0,7,127,1649,0,96,1745,79.3182
SAN DIEGO,Jul 2015,CACF,2015,LINERS CORP ,ADULT_SNACK_PM,22,120,0,7,127,1020,0,59,1079,49.0455
SAN DIEGO,Aug 2015,CACF,2015,LINERS CORP ,ADULT_BREAKFAST,21,121,0,6,127,1346,0,67,1413,67.2857
SAN DIEGO,Aug 2015,CACF,2015,LINERS CORP ,ADULT_LUNCH,21,121,0,6,127,1550,0,77,1627,77.4762
SAN DIEGO,Aug 2015,CACF,2015,LINERS CORP ,ADULT_SNACK_PM,21,121,0,6,127,885,0,44,929,44.2381
SAN DIEGO,Sep 2015,CACF,2015,LINERS CORP ,ADULT_BREAKFAST,21,122,0,4,126,1458,0,48,1506,71.7143
SAN DIEGO,Sep 2015,CACF,2015,LINERS CORP ,ADULT_LUNCH,21,122,0,4,126,1650,0,54,1704,81.1429
SAN DIEGO,Sep 2015,CACF,2015,LINERS CORP ,ADULT_SNACK_PM,21,122,0,4,126,930,0,30,960,45.7143
SAN DIEGO,Oct 2014,CACF,2015,LOVING CARE ADHC LIMITED ,ADULT_BREAKFAST,23,123,0,0,123,1524,0,0,1524,66.2609
SAN DIEGO,Oct 2014,CACF,2015,LOVING CARE ADHC LIMITED ,ADULT_LUNCH,23,123,0,0,123,1524,0,0,1524,66.2609
SAN DIEGO,Oct 2014,CACF,2015,LOVING CARE ADHC LIMITED ,ADULT_SNACK_AM,23,123,0,0,123,1525,0,0,1525,66.3043
SAN DIEGO,Nov 2014,CACF,2015,LOVING CARE ADHC LIMITED ,ADULT_BREAKFAST,20,123,0,0,123,1348,0,0,1348,67.4
SAN DIEGO,Nov 2014,CACF,2015,LOVING CARE ADHC LIMITED ,ADULT_LUNCH,20,123,0,0,123,1348,0,0,1348,67.4
SAN DIEGO,Nov 2014,CACF,2015,LOVING CARE ADHC LIMITED ,ADULT_SNACK_AM,20,123,0,0,123,1347,0,0,1347,67.35
SAN DIEGO,Dec 2014,CACF,2015,LOVING CARE ADHC LIMITED ,ADULT_BREAKFAST,22,123,0,0,123,1469,0,0,1469,66.7727
SAN DIEGO,Dec 2014,CACF,2015,LOVING CARE ADHC LIMITED ,ADULT_LUNCH,22,123,0,0,123,1469,0,0,1469,66.7727
SAN DIEGO,Dec 2014,CACF,2015,LOVING CARE ADHC LIMITED ,ADULT_SNACK_AM,22,123,0,0,123,1469,0,0,1469,66.7727
SAN DIEGO,Jan 2015,CACF,2015,LOVING CARE ADHC LIMITED ,ADULT_BREAKFAST,21,123,0,0,123,1297,0,0,1297,61.7619
SAN DIEGO,Jan 2015,CACF,2015,LOVING CARE ADHC LIMITED ,ADULT_LUNCH,21,123,0,0,123,1297,0,0,1297,61.7619
SAN DIEGO,Jan 2015,CACF,2015,LOVING CARE ADHC LIMITED ,ADULT_SNACK_AM,21,123,0,0,123,1297,0,0,1297,61.7619
SAN DIEGO,Feb 2015,CACF,2015,LOVING CARE ADHC LIMITED ,ADULT_BREAKFAST,20,123,0,0,123,1323,0,0,1323,66.15
SAN DIEGO,Feb 2015,CACF,2015,LOVING CARE ADHC LIMITED ,ADULT_LUNCH,20,123,0,0,123,1323,0,0,1323,66.15
SAN DIEGO,Feb 2015,CACF,2015,LOVING CARE ADHC LIMITED ,ADULT_SNACK_AM,20,123,0,0,123,1323,0,0,1323,66.15
SAN DIEGO,Mar 2015,CACF,2015,LOVING CARE ADHC LIMITED ,ADULT_BREAKFAST,22,123,0,0,123,1464,0,0,1464,66.5455
SAN DIEGO,Mar 2015,CACF,2015,LOVING CARE ADHC LIMITED ,ADULT_LUNCH,22,123,0,0,123,1464,0,0,1464,66.5455
SAN DIEGO,Mar 2015,CACF,2015,LOVING CARE ADHC LIMITED ,ADULT_SNACK_AM,22,123,0,0,123,1464,0,0,1464,66.5455
SAN DIEGO,Apr 2015,CACF,2015,LOVING CARE ADHC LIMITED ,ADULT_BREAKFAST,22,123,0,0,123,1577,0,0,1577,71.6818
SAN DIEGO,Apr 2015,CACF,2015,LOVING CARE ADHC LIMITED ,ADULT_LUNCH,22,123,0,0,123,1576,0,0,1576,71.6364
SAN DIEGO,Apr 2015,CACF,2015,LOVING CARE ADHC LIMITED ,ADULT_SNACK_AM,22,123,0,0,123,1576,0,0,1576,71.6364
SAN DIEGO,May 2015,CACF,2015,LOVING CARE ADHC LIMITED ,ADULT_BREAKFAST,21,123,0,0,123,1455,0,0,1455,69.2857
SAN DIEGO,May 2015,CACF,2015,LOVING CARE ADHC LIMITED ,ADULT_LUNCH,21,123,0,0,123,1455,0,0,1455,69.2857
SAN DIEGO,May 2015,CACF,2015,LOVING CARE ADHC LIMITED ,ADULT_SNACK_AM,21,123,0,0,123,1455,0,0,1455,69.2857
SAN DIEGO,Jun 2015,CACF,2015,LOVING CARE ADHC LIMITED ,ADULT_BREAKFAST,22,123,0,0,123,1586,0,0,1586,72.0909
SAN DIEGO,Jun 2015,CACF,2015,LOVING CARE ADHC LIMITED ,ADULT_LUNCH,22,123,0,0,123,1585,0,0,1585,72.0455
SAN DIEGO,Jun 2015,CACF,2015,LOVING CARE ADHC LIMITED ,ADULT_SNACK_AM,22,123,0,0,123,1586,0,0,1586,72.0909
SAN DIEGO,Jul 2015,CACF,2015,LOVING CARE ADHC LIMITED ,ADULT_BREAKFAST,23,123,0,0,123,1588,0,0,1588,69.0435
SAN DIEGO,Jul 2015,CACF,2015,LOVING CARE ADHC LIMITED ,ADULT_LUNCH,23,123,0,0,123,1585,0,0,1585,68.913
SAN DIEGO,Jul 2015,CACF,2015,LOVING CARE ADHC LIMITED ,ADULT_SNACK_AM,23,123,0,0,123,1588,0,0,1588,69.0435
SAN DIEGO,Aug 2015,CACF,2015,LOVING CARE ADHC LIMITED ,ADULT_BREAKFAST,21,123,0,0,123,1601,0,0,1601,76.2381
SAN DIEGO,Aug 2015,CACF,2015,LOVING CARE ADHC LIMITED ,ADULT_LUNCH,21,123,0,0,123,1601,0,0,1601,76.2381
SAN DIEGO,Aug 2015,CACF,2015,LOVING CARE ADHC LIMITED ,ADULT_SNACK_AM,21,123,0,0,123,1601,0,0,1601,76.2381
SAN DIEGO,Sep 2015,CACF,2015,LOVING CARE ADHC LIMITED ,ADULT_BREAKFAST,22,123,0,0,123,1647,0,0,1647,74.8636
SAN DIEGO,Sep 2015,CACF,2015,LOVING CARE ADHC LIMITED ,ADULT_LUNCH,22,123,0,0,123,1644,0,0,1644,74.7273
SAN DIEGO,Sep 2015,CACF,2015,LOVING CARE ADHC LIMITED ,ADULT_SNACK_AM,22,123,0,0,123,1645,0,0,1645,74.7727
SAN DIEGO,Oct 2014,CACF,2015,MARANGELYS KIDS INC KIDDIE ACADEMY CHILD CARE CTR,CHILD_BREAKFAST,23,76,5,43,124,987,65,559,1611,70.0435
SAN DIEGO,Oct 2014,CACF,2015,MARANGELYS KIDS INC KIDDIE ACADEMY CHILD CARE CTR,CHILD_LUNCH,23,76,5,43,124,1219,80,690,1989,86.4783
SAN DIEGO,Oct 2014,CACF,2015,MARANGELYS KIDS INC KIDDIE ACADEMY CHILD CARE CTR,CHILD_SNACK_PM,23,76,5,43,124,1084,71,614,1769,76.913
SAN DIEGO,Oct 2014,CACF,2015,MARANGELYS KIDS INC KIDDIE ACADEMY CHILD CARE CTR,OSCH_CHILD_BREAKFAST,23,67,11,20,98,616,101,184,901,39.1739
SAN DIEGO,Oct 2014,CACF,2015,MARANGELYS KIDS INC KIDDIE ACADEMY CHILD CARE CTR,OSCH_CHILD_LUNCH,23,67,11,20,98,118,19,36,173,7.5217
SAN DIEGO,Oct 2014,CACF,2015,MARANGELYS KIDS INC KIDDIE ACADEMY CHILD CARE CTR,OSCH_CHILD_SNACK_PM,23,67,11,20,98,1049,172,313,1534,66.6957
SAN DIEGO,Nov 2014,CACF,2015,MARANGELYS KIDS INC KIDDIE ACADEMY CHILD CARE CTR,CHILD_BREAKFAST,19,76,5,43,124,812,53,460,1325,69.7368
SAN DIEGO,Nov 2014,CACF,2015,MARANGELYS KIDS INC KIDDIE ACADEMY CHILD CARE CTR,CHILD_LUNCH,19,76,5,43,124,973,64,550,1587,83.5263
SAN DIEGO,Nov 2014,CACF,2015,MARANGELYS KIDS INC KIDDIE ACADEMY CHILD CARE CTR,CHILD_SNACK_PM,19,76,5,43,124,880,58,498,1436,75.5789
SAN DIEGO,Nov 2014,CACF,2015,MARANGELYS KIDS INC KIDDIE ACADEMY CHILD CARE CTR,OSCH_CHILD_BREAKFAST,19,67,11,20,98,497,82,148,727,38.2632
SAN DIEGO,Nov 2014,CACF,2015,MARANGELYS KIDS INC KIDDIE ACADEMY CHILD CARE CTR,OSCH_CHILD_LUNCH,19,67,11,20,98,217,36,65,318,16.7368
SAN DIEGO,Nov 2014,CACF,2015,MARANGELYS KIDS INC KIDDIE ACADEMY CHILD CARE CTR,OSCH_CHILD_SNACK_PM,19,67,11,20,98,720,118,215,1053,55.4211
SAN DIEGO,Dec 2014,CACF,2015,MARANGELYS KIDS INC KIDDIE ACADEMY CHILD CARE CTR,CHILD_BREAKFAST,22,76,5,43,124,803,53,454,1310,59.5455
SAN DIEGO,Dec 2014,CACF,2015,MARANGELYS KIDS INC KIDDIE ACADEMY CHILD CARE CTR,CHILD_LUNCH,22,76,5,43,124,1025,67,581,1673,76.0455
SAN DIEGO,Dec 2014,CACF,2015,MARANGELYS KIDS INC KIDDIE ACADEMY CHILD CARE CTR,CHILD_SNACK_PM,22,76,5,43,124,937,62,529,1528,69.4545
SAN DIEGO,Dec 2014,CACF,2015,MARANGELYS KIDS INC KIDDIE ACADEMY CHILD CARE CTR,OSCH_CHILD_BREAKFAST,22,67,11,20,98,529,87,158,774,35.1818
SAN DIEGO,Dec 2014,CACF,2015,MARANGELYS KIDS INC KIDDIE ACADEMY CHILD CARE CTR,OSCH_CHILD_LUNCH,22,67,11,20,98,236,39,70,345,15.6818
SAN DIEGO,Dec 2014,CACF,2015,MARANGELYS KIDS INC KIDDIE ACADEMY CHILD CARE CTR,OSCH_CHILD_SNACK_PM,22,67,11,20,98,831,136,249,1216,55.2727
SAN DIEGO,Jan 2015,CACF,2015,MARANGELYS KIDS INC KIDDIE ACADEMY CHILD CARE CTR,CHILD_BREAKFAST,21,76,5,43,124,776,51,439,1266,60.2857
SAN DIEGO,Jan 2015,CACF,2015,MARANGELYS KIDS INC KIDDIE ACADEMY CHILD CARE CTR,CHILD_LUNCH,21,76,5,43,124,1005,66,568,1639,78.0476
SAN DIEGO,Jan 2015,CACF,2015,MARANGELYS KIDS INC KIDDIE ACADEMY CHILD CARE CTR,CHILD_SNACK_PM,21,76,5,43,124,886,58,502,1446,68.8571
SAN DIEGO,Jan 2015,CACF,2015,MARANGELYS KIDS INC KIDDIE ACADEMY CHILD CARE CTR,OSCH_CHILD_BREAKFAST,21,67,11,20,98,427,70,128,625,29.7619
SAN DIEGO,Jan 2015,CACF,2015,MARANGELYS KIDS INC KIDDIE ACADEMY CHILD CARE CTR,OSCH_CHILD_LUNCH,21,67,11,20,98,139,23,41,203,9.6667
SAN DIEGO,Jan 2015,CACF,2015,MARANGELYS KIDS INC KIDDIE ACADEMY CHILD CARE CTR,OSCH_CHILD_SNACK_PM,21,67,11,20,98,848,139,254,1241,59.0952
SAN DIEGO,Feb 2015,CACF,2015,MARANGELYS KIDS INC KIDDIE ACADEMY CHILD CARE CTR,CHILD_BREAKFAST,20,76,5,43,124,732,48,415,1195,59.75
SAN DIEGO,Feb 2015,CACF,2015,MARANGELYS KIDS INC KIDDIE ACADEMY CHILD CARE CTR,CHILD_LUNCH,20,76,5,43,124,943,62,533,1538,76.9
SAN DIEGO,Feb 2015,CACF,2015,MARANGELYS KIDS INC KIDDIE ACADEMY CHILD CARE CTR,CHILD_SNACK_PM,20,76,5,43,124,843,55,477,1375,68.75
SAN DIEGO,Feb 2015,CACF,2015,MARANGELYS KIDS INC KIDDIE ACADEMY CHILD CARE CTR,OSCH_CHILD_BREAKFAST,20,67,11,20,98,464,76,139,679,33.95
SAN DIEGO,Feb 2015,CACF,2015,MARANGELYS KIDS INC KIDDIE ACADEMY CHILD CARE CTR,OSCH_CHILD_LUNCH,20,67,11,20,98,198,32,59,289,14.45
SAN DIEGO,Feb 2015,CACF,2015,MARANGELYS KIDS INC KIDDIE ACADEMY CHILD CARE CTR,OSCH_CHILD_SNACK_PM,20,67,11,20,98,777,127,232,1136,56.8
SAN DIEGO,Mar 2015,CACF,2015,MARANGELYS KIDS INC KIDDIE ACADEMY CHILD CARE CTR,CHILD_BREAKFAST,22,76,5,43,124,857,56,486,1399,63.5909
SAN DIEGO,Mar 2015,CACF,2015,MARANGELYS KIDS INC KIDDIE ACADEMY CHILD CARE CTR,CHILD_LUNCH,22,76,5,43,124,1131,74,641,1846,83.9091
SAN DIEGO,Mar 2015,CACF,2015,MARANGELYS KIDS INC KIDDIE ACADEMY CHILD CARE CTR,CHILD_SNACK_PM,22,76,5,43,124,1023,67,579,1669,75.8636
SAN DIEGO,Mar 2015,CACF,2015,MARANGELYS KIDS INC KIDDIE ACADEMY CHILD CARE CTR,OSCH_CHILD_BREAKFAST,22,67,11,20,98,463,76,138,677,30.7727
SAN DIEGO,Mar 2015,CACF,2015,MARANGELYS KIDS INC KIDDIE ACADEMY CHILD CARE CTR,OSCH_CHILD_LUNCH,22,67,11,20,98,121,20,36,177,8.0455
SAN DIEGO,Mar 2015,CACF,2015,MARANGELYS KIDS INC KIDDIE ACADEMY CHILD CARE CTR,OSCH_CHILD_SNACK_PM,22,67,11,20,98,973,160,290,1423,64.6818
SAN DIEGO,Apr 2015,CACF,2015,MARANGELYS KIDS INC KIDDIE ACADEMY CHILD CARE CTR,CHILD_BREAKFAST,22,76,5,43,124,924,61,523,1508,68.5455
SAN DIEGO,Apr 2015,CACF,2015,MARANGELYS KIDS INC KIDDIE ACADEMY CHILD CARE CTR,CHILD_LUNCH,22,76,5,43,124,1211,80,685,1976,89.8182
SAN DIEGO,Apr 2015,CACF,2015,MARANGELYS KIDS INC KIDDIE ACADEMY CHILD CARE CTR,CHILD_SNACK_PM,22,76,5,43,124,1075,71,608,1754,79.7273
SAN DIEGO,Apr 2015,CACF,2015,MARANGELYS KIDS INC KIDDIE ACADEMY CHILD CARE CTR,OSCH_CHILD_BREAKFAST,22,67,11,20,98,529,87,157,773,35.1364
SAN DIEGO,Apr 2015,CACF,2015,MARANGELYS KIDS INC KIDDIE ACADEMY CHILD CARE CTR,OSCH_CHILD_LUNCH,22,67,11,20,98,219,36,66,321,14.5909
SAN DIEGO,Apr 2015,CACF,2015,MARANGELYS KIDS INC KIDDIE ACADEMY CHILD CARE CTR,OSCH_CHILD_SNACK_PM,22,67,11,20,98,931,153,278,1362,61.9091
SAN DIEGO,May 2015,CACF,2015,MARANGELYS KIDS INC KIDDIE ACADEMY CHILD CARE CTR,CHILD_BREAKFAST,20,76,5,43,124,813,53,461,1327,66.35
SAN DIEGO,May 2015,CACF,2015,MARANGELYS KIDS INC KIDDIE ACADEMY CHILD CARE CTR,CHILD_LUNCH,20,76,5,43,124,1077,71,610,1758,87.9
SAN DIEGO,May 2015,CACF,2015,MARANGELYS KIDS INC KIDDIE ACADEMY CHILD CARE CTR,CHILD_SNACK_PM,20,76,5,43,124,940,62,532,1534,76.7
SAN DIEGO,May 2015,CACF,2015,MARANGELYS KIDS INC KIDDIE ACADEMY CHILD CARE CTR,OSCH_CHILD_BREAKFAST,20,67,11,20,98,440,72,131,643,32.15
SAN DIEGO,May 2015,CACF,2015,MARANGELYS KIDS INC KIDDIE ACADEMY CHILD CARE CTR,OSCH_CHILD_LUNCH,20,67,11,20,98,109,18,33,160,8
SAN DIEGO,May 2015,CACF,2015,MARANGELYS KIDS INC KIDDIE ACADEMY CHILD CARE CTR,OSCH_CHILD_SNACK_PM,20,67,11,20,98,855,140,256,1251,62.55
SAN DIEGO,Jun 2015,CACF,2015,MARANGELYS KIDS INC KIDDIE ACADEMY CHILD CARE CTR,CHILD_BREAKFAST,22,76,5,43,124,876,58,495,1429,64.9545
SAN DIEGO,Jun 2015,CACF,2015,MARANGELYS KIDS INC KIDDIE ACADEMY CHILD CARE CTR,CHILD_LUNCH,22,76,5,43,124,1176,77,665,1918,87.1818
SAN DIEGO,Jun 2015,CACF,2015,MARANGELYS KIDS INC KIDDIE ACADEMY CHILD CARE CTR,CHILD_SNACK_PM,22,76,5,43,124,1023,67,579,1669,75.8636
SAN DIEGO,Jun 2015,CACF,2015,MARANGELYS KIDS INC KIDDIE ACADEMY CHILD CARE CTR,OSCH_CHILD_BREAKFAST,22,67,11,20,98,586,96,175,857,38.9545
SAN DIEGO,Jun 2015,CACF,2015,MARANGELYS KIDS INC KIDDIE ACADEMY CHILD CARE CTR,OSCH_CHILD_LUNCH,22,67,11,20,98,511,84,153,748,34
SAN DIEGO,Jun 2015,CACF,2015,MARANGELYS KIDS INC KIDDIE ACADEMY CHILD CARE CTR,OSCH_CHILD_SNACK_PM,22,67,11,20,98,740,122,221,1083,49.2273
SAN DIEGO,Jul 2015,CACF,2015,MARANGELYS KIDS INC KIDDIE ACADEMY CHILD CARE CTR,CHILD_BREAKFAST,22,76,5,43,124,818,54,462,1334,60.6364
SAN DIEGO,Jul 2015,CACF,2015,MARANGELYS KIDS INC KIDDIE ACADEMY CHILD CARE CTR,CHILD_LUNCH,22,76,5,43,124,1071,70,606,1747,79.4091
SAN DIEGO,Jul 2015,CACF,2015,MARANGELYS KIDS INC KIDDIE ACADEMY CHILD CARE CTR,CHILD_SNACK_PM,22,76,5,43,124,963,63,546,1572,71.4545
SAN DIEGO,Jul 2015,CACF,2015,MARANGELYS KIDS INC KIDDIE ACADEMY CHILD CARE CTR,OSCH_CHILD_BREAKFAST,22,67,11,20,98,671,110,201,982,44.6364
SAN DIEGO,Jul 2015,CACF,2015,MARANGELYS KIDS INC KIDDIE ACADEMY CHILD CARE CTR,OSCH_CHILD_LUNCH,22,67,11,20,98,636,104,190,930,42.2727
SAN DIEGO,Jul 2015,CACF,2015,MARANGELYS KIDS INC KIDDIE ACADEMY CHILD CARE CTR,OSCH_CHILD_SNACK_PM,22,67,11,20,98,776,127,232,1135,51.5909
SAN DIEGO,Aug 2015,CACF,2015,MARANGELYS KIDS INC KIDDIE ACADEMY CHILD CARE CTR,CHILD_BREAKFAST,21,76,5,43,124,721,47,408,1176,56
SAN DIEGO,Aug 2015,CACF,2015,MARANGELYS KIDS INC KIDDIE ACADEMY CHILD CARE CTR,CHILD_LUNCH,21,76,5,43,124,888,58,503,1449,69
SAN DIEGO,Aug 2015,CACF,2015,MARANGELYS KIDS INC KIDDIE ACADEMY CHILD CARE CTR,CHILD_SNACK_PM,21,76,5,43,124,826,54,468,1348,64.1905
SAN DIEGO,Aug 2015,CACF,2015,MARANGELYS KIDS INC KIDDIE ACADEMY CHILD CARE CTR,OSCH_CHILD_BREAKFAST,21,67,11,20,98,679,111,203,993,47.2857
SAN DIEGO,Aug 2015,CACF,2015,MARANGELYS KIDS INC KIDDIE ACADEMY CHILD CARE CTR,OSCH_CHILD_LUNCH,21,67,11,20,98,366,60,110,536,25.5238
SAN DIEGO,Aug 2015,CACF,2015,MARANGELYS KIDS INC KIDDIE ACADEMY CHILD CARE CTR,OSCH_CHILD_SNACK_PM,21,67,11,20,98,918,151,274,1343,63.9524
SAN DIEGO,Sep 2015,CACF,2015,MARANGELYS KIDS INC KIDDIE ACADEMY CHILD CARE CTR,CHILD_BREAKFAST,21,76,5,43,124,723,48,409,1180,56.1905
SAN DIEGO,Sep 2015,CACF,2015,MARANGELYS KIDS INC KIDDIE ACADEMY CHILD CARE CTR,CHILD_LUNCH,21,76,5,43,124,846,56,478,1380,65.7143
SAN DIEGO,Sep 2015,CACF,2015,MARANGELYS KIDS INC KIDDIE ACADEMY CHILD CARE CTR,CHILD_SNACK_PM,21,76,5,43,124,794,52,449,1295,61.6667
SAN DIEGO,Sep 2015,CACF,2015,MARANGELYS KIDS INC KIDDIE ACADEMY CHILD CARE CTR,OSCH_CHILD_BREAKFAST,21,67,11,20,98,686,113,205,1004,47.8095
SAN DIEGO,Sep 2015,CACF,2015,MARANGELYS KIDS INC KIDDIE ACADEMY CHILD CARE CTR,OSCH_CHILD_LUNCH,21,67,11,20,98,148,24,45,217,10.3333
SAN DIEGO,Sep 2015,CACF,2015,MARANGELYS KIDS INC KIDDIE ACADEMY CHILD CARE CTR,OSCH_CHILD_SNACK_PM,21,67,11,20,98,1168,192,349,1709,81.381
SAN DIEGO,Oct 2014,CACF,2015,Marine Corps Air Station,ATRISK_CHILD_SNACK,22,117,0,0,117,2216,0,0,2216,100.7273
SAN DIEGO,Oct 2014,CACF,2015,Marine Corps Air Station,CHILD_BREAKFAST,22,0,3,26,29,0,52,447,499,22.6818
SAN DIEGO,Oct 2014,CACF,2015,Marine Corps Air Station,CHILD_LUNCH,22,0,3,26,29,0,60,524,584,26.5455
SAN DIEGO,Oct 2014,CACF,2015,Marine Corps Air Station,CHILD_SNACK_PM,22,0,3,26,29,0,52,447,499,22.6818
SAN DIEGO,Nov 2014,CACF,2015,Marine Corps Air Station,ATRISK_CHILD_LUNCH,18,175,0,0,175,170,0,0,170,9.4444
SAN DIEGO,Nov 2014,CACF,2015,Marine Corps Air Station,ATRISK_CHILD_SNACK,18,175,0,0,175,1608,0,0,1608,89.3333
SAN DIEGO,Nov 2014,CACF,2015,Marine Corps Air Station,CHILD_BREAKFAST,18,0,3,26,29,0,39,343,382,21.2222
SAN DIEGO,Nov 2014,CACF,2015,Marine Corps Air Station,CHILD_LUNCH,18,0,3,26,29,0,47,403,450,25
SAN DIEGO,Nov 2014,CACF,2015,Marine Corps Air Station,CHILD_SNACK_PM,18,0,3,26,29,0,37,322,359,19.9444
SAN DIEGO,Dec 2014,CACF,2015,Marine Corps Air Station,ATRISK_CHILD_LUNCH,21,112,0,0,112,277,0,0,277,13.1905
SAN DIEGO,Dec 2014,CACF,2015,Marine Corps Air Station,ATRISK_CHILD_SNACK,21,112,0,0,112,1659,0,0,1659,79
SAN DIEGO,Dec 2014,CACF,2015,Marine Corps Air Station,CHILD_BREAKFAST,21,0,3,26,29,0,42,363,405,19.2857
SAN DIEGO,Dec 2014,CACF,2015,Marine Corps Air Station,CHILD_LUNCH,21,0,3,26,29,0,51,439,490,23.3333
SAN DIEGO,Dec 2014,CACF,2015,Marine Corps Air Station,CHILD_SNACK_PM,21,0,3,26,29,0,45,392,437,20.8095
SAN DIEGO,Jan 2015,CACF,2015,Marine Corps Air Station,ATRISK_CHILD_LUNCH,20,120,0,0,120,35,0,0,35,1.75
SAN DIEGO,Jan 2015,CACF,2015,Marine Corps Air Station,ATRISK_CHILD_SNACK,20,120,0,0,120,1773,0,0,1773,88.65
SAN DIEGO,Jan 2015,CACF,2015,Marine Corps Air Station,CHILD_BREAKFAST,20,0,3,26,29,0,35,305,340,17
SAN DIEGO,Jan 2015,CACF,2015,Marine Corps Air Station,CHILD_LUNCH,20,0,3,26,29,0,47,408,455,22.75
SAN DIEGO,Jan 2015,CACF,2015,Marine Corps Air Station,CHILD_SNACK_PM,20,0,3,26,29,0,47,412,459,22.95
SAN DIEGO,Feb 2015,CACF,2015,Marine Corps Air Station,ATRISK_CHILD_SNACK,19,105,0,0,105,1710,0,0,1710,90
SAN DIEGO,Feb 2015,CACF,2015,Marine Corps Air Station,CHILD_BREAKFAST,19,0,3,26,29,0,35,308,343,18.0526
SAN DIEGO,Feb 2015,CACF,2015,Marine Corps Air Station,CHILD_LUNCH,19,0,3,26,29,0,48,414,462,24.3158
SAN DIEGO,Feb 2015,CACF,2015,Marine Corps Air Station,CHILD_SNACK_PM,19,0,3,26,29,0,44,384,428,22.5263
SAN DIEGO,Mar 2015,CACF,2015,Marine Corps Air Station,ATRISK_CHILD_SNACK,22,103,0,0,103,1950,0,0,1950,88.6364
SAN DIEGO,Mar 2015,CACF,2015,Marine Corps Air Station,CHILD_BREAKFAST,22,0,3,26,29,0,47,409,456,20.7273
SAN DIEGO,Mar 2015,CACF,2015,Marine Corps Air Station,CHILD_LUNCH,22,0,3,26,29,0,57,496,553,25.1364
SAN DIEGO,Mar 2015,CACF,2015,Marine Corps Air Station,CHILD_SNACK_PM,22,0,3,26,29,0,52,453,505,22.9545
SAN DIEGO,Apr 2015,CACF,2015,Marine Corps Air Station,ATRISK_CHILD_SNACK,22,88,0,0,88,1777,0,0,1777,80.7727
SAN DIEGO,Apr 2015,CACF,2015,Marine Corps Air Station,CHILD_BREAKFAST,22,0,3,26,29,0,48,419,467,21.2273
SAN DIEGO,Apr 2015,CACF,2015,Marine Corps Air Station,CHILD_LUNCH,22,0,3,26,29,0,59,513,572,26
SAN DIEGO,Apr 2015,CACF,2015,Marine Corps Air Station,CHILD_SNACK_PM,22,0,3,26,29,0,54,473,527,23.9545
SAN DIEGO,May 2015,CACF,2015,Marine Corps Air Station,ATRISK_CHILD_SNACK,20,105,0,0,105,1762,0,0,1762,88.1
SAN DIEGO,May 2015,CACF,2015,Marine Corps Air Station,CHILD_BREAKFAST,20,0,3,26,29,0,47,412,459,22.95
SAN DIEGO,May 2015,CACF,2015,Marine Corps Air Station,CHILD_LUNCH,20,0,3,26,29,0,55,479,534,26.7
SAN DIEGO,May 2015,CACF,2015,Marine Corps Air Station,CHILD_SNACK_PM,20,0,3,26,29,0,51,442,493,24.65
SAN DIEGO,Jun 2015,CACF,2015,Marine Corps Air Station,ATRISK_CHILD_LUNCH,21,121,0,0,121,304,0,0,304,14.4762
SAN DIEGO,Jun 2015,CACF,2015,Marine Corps Air Station,ATRISK_CHILD_SNACK,21,121,0,0,121,1844,0,0,1844,87.8095
SAN DIEGO,Jun 2015,CACF,2015,Marine Corps Air Station,CHILD_BREAKFAST,21,0,3,26,29,0,44,383,427,20.3333
SAN DIEGO,Jun 2015,CACF,2015,Marine Corps Air Station,CHILD_LUNCH,21,0,3,26,29,0,57,493,550,26.1905
SAN DIEGO,Jun 2015,CACF,2015,Marine Corps Air Station,CHILD_SNACK_PM,21,0,3,26,29,0,54,471,525,25
SAN DIEGO,Jul 2015,CACF,2015,Marine Corps Air Station,CHILD_BREAKFAST,24,0,3,26,29,0,37,317,354,14.75
SAN DIEGO,Jul 2015,CACF,2015,Marine Corps Air Station,CHILD_LUNCH,24,0,3,26,29,0,55,476,531,22.125
SAN DIEGO,Jul 2015,CACF,2015,Marine Corps Air Station,CHILD_SNACK_PM,24,0,3,26,29,0,49,428,477,19.875
SAN DIEGO,Jul 2015,CACF,2015,Marine Corps Air Station,OSCH_CHILD_BREAKFAST,22,0,2,65,67,0,22,705,727,33.0455
SAN DIEGO,Jul 2015,CACF,2015,Marine Corps Air Station,OSCH_CHILD_LUNCH,22,0,2,65,67,0,44,1430,1474,67
SAN DIEGO,Jul 2015,CACF,2015,Marine Corps Air Station,OSCH_CHILD_SNACK_PM,22,0,2,65,67,0,44,1430,1474,67
SAN DIEGO,Aug 2015,CACF,2015,Marine Corps Air Station,CHILD_BREAKFAST,21,0,3,26,29,0,39,343,382,18.1905
SAN DIEGO,Aug 2015,CACF,2015,Marine Corps Air Station,CHILD_LUNCH,21,0,3,26,29,0,50,430,480,22.8571
SAN DIEGO,Aug 2015,CACF,2015,Marine Corps Air Station,CHILD_SNACK_PM,21,0,3,26,29,0,49,424,473,22.5238
SAN DIEGO,Aug 2015,CACF,2015,Marine Corps Air Station,OSCH_CHILD_BREAKFAST,21,0,3,87,90,0,58,1675,1733,82.5238
SAN DIEGO,Aug 2015,CACF,2015,Marine Corps Air Station,OSCH_CHILD_LUNCH,21,0,3,87,90,0,63,1821,1884,89.7143
SAN DIEGO,Aug 2015,CACF,2015,Marine Corps Air Station,OSCH_CHILD_SNACK_PM,21,0,3,87,90,0,58,1686,1744,83.0476
SAN DIEGO,Sep 2015,CACF,2015,Marine Corps Air Station,ATRISK_CHILD_SNACK,17,161,0,0,161,1972,0,0,1972,116
SAN DIEGO,Sep 2015,CACF,2015,Marine Corps Air Station,CHILD_BREAKFAST,21,0,4,30,34,0,42,313,355,16.9048
SAN DIEGO,Sep 2015,CACF,2015,Marine Corps Air Station,CHILD_LUNCH,21,0,4,30,34,0,56,421,477,22.7143
SAN DIEGO,Sep 2015,CACF,2015,Marine Corps Air Station,CHILD_SNACK_PM,21,0,4,30,34,0,40,303,343,16.3333
SAN DIEGO,Sep 2015,CACF,2015,Marine Corps Air Station,OSCH_CHILD_BREAKFAST,4,0,3,87,90,0,4,124,128,32
SAN DIEGO,Sep 2015,CACF,2015,Marine Corps Air Station,OSCH_CHILD_LUNCH,4,0,3,87,90,0,8,238,246,61.5
SAN DIEGO,Sep 2015,CACF,2015,Marine Corps Air Station,OSCH_CHILD_SNACK_PM,4,0,3,87,90,0,9,259,268,67
SAN DIEGO,Oct 2014,CACF,2015,Marine Corps Community Services,CHILD_BREAKFAST,22,26,43,566,635,362,599,7881,8842,401.9091
SAN DIEGO,Oct 2014,CACF,2015,Marine Corps Community Services,CHILD_LUNCH,22,26,43,566,635,436,722,9500,10658,484.4545
SAN DIEGO,Oct 2014,CACF,2015,Marine Corps Community Services,CHILD_SNACK_AM,22,26,43,566,635,25,41,534,600,27.2727
SAN DIEGO,Oct 2014,CACF,2015,Marine Corps Community Services,CHILD_SNACK_PM,22,26,43,566,635,410,679,8947,10036,456.1818
SAN DIEGO,Oct 2014,CACF,2015,Marine Corps Community Services,OSCH_CHILD_BREAKFAST,22,4,10,181,195,23,56,1019,1098,49.9091
SAN DIEGO,Oct 2014,CACF,2015,Marine Corps Community Services,OSCH_CHILD_LUNCH,22,4,10,181,195,2,6,112,120,5.4545
SAN DIEGO,Oct 2014,CACF,2015,Marine Corps Community Services,OSCH_CHILD_SNACK_PM,22,4,10,181,195,65,161,2922,3148,143.0909
SAN DIEGO,Nov 2014,CACF,2015,Marine Corps Community Services,CHILD_BREAKFAST,18,26,43,566,635,283,469,6173,6925,384.7222
SAN DIEGO,Nov 2014,CACF,2015,Marine Corps Community Services,CHILD_LUNCH,18,26,43,566,635,325,538,7091,7954,441.8889
SAN DIEGO,Nov 2014,CACF,2015,Marine Corps Community Services,CHILD_SNACK_AM,18,26,43,566,635,14,23,305,342,19
SAN DIEGO,Nov 2014,CACF,2015,Marine Corps Community Services,CHILD_SNACK_PM,18,26,43,566,635,309,511,6732,7552,419.5556
SAN DIEGO,Nov 2014,CACF,2015,Marine Corps Community Services,OSCH_CHILD_BREAKFAST,18,4,10,181,195,18,44,802,864,48
SAN DIEGO,Nov 2014,CACF,2015,Marine Corps Community Services,OSCH_CHILD_LUNCH,18,4,10,181,195,9,22,390,421,23.3889
SAN DIEGO,Nov 2014,CACF,2015,Marine Corps Community Services,OSCH_CHILD_SNACK_PM,18,4,10,181,195,46,114,2067,2227,123.7222
SAN DIEGO,Dec 2014,CACF,2015,Marine Corps Community Services,CHILD_BREAKFAST,21,26,43,566,635,323,535,7041,7899,376.1429
SAN DIEGO,Dec 2014,CACF,2015,Marine Corps Community Services,CHILD_LUNCH,21,26,43,566,635,383,633,8340,9356,445.5238
SAN DIEGO,Dec 2014,CACF,2015,Marine Corps Community Services,CHILD_SNACK_AM,21,26,43,566,635,19,32,415,466,22.1905
SAN DIEGO,Dec 2014,CACF,2015,Marine Corps Community Services,CHILD_SNACK_PM,21,26,43,566,635,353,585,7700,8638,411.3333
SAN DIEGO,Dec 2014,CACF,2015,Marine Corps Community Services,OSCH_CHILD_BREAKFAST,21,4,10,181,195,18,45,807,870,41.4286
SAN DIEGO,Dec 2014,CACF,2015,Marine Corps Community Services,OSCH_CHILD_LUNCH,21,4,10,181,195,8,20,371,399,19
SAN DIEGO,Dec 2014,CACF,2015,Marine Corps Community Services,OSCH_CHILD_SNACK_PM,21,4,10,181,195,51,128,2319,2498,118.9524
SAN DIEGO,Jan 2015,CACF,2015,Marine Corps Community Services,CHILD_BREAKFAST,20,26,43,566,635,351,582,7657,8590,429.5
SAN DIEGO,Jan 2015,CACF,2015,Marine Corps Community Services,CHILD_LUNCH,20,26,43,566,635,400,663,8723,9786,489.3
SAN DIEGO,Jan 2015,CACF,2015,Marine Corps Community Services,CHILD_SNACK_AM,20,26,43,566,635,21,34,449,504,25.2
SAN DIEGO,Jan 2015,CACF,2015,Marine Corps Community Services,CHILD_SNACK_PM,20,26,43,566,635,379,627,8256,9262,463.1
SAN DIEGO,Jan 2015,CACF,2015,Marine Corps Community Services,OSCH_CHILD_BREAKFAST,20,4,10,181,195,17,43,782,842,42.1
SAN DIEGO,Jan 2015,CACF,2015,Marine Corps Community Services,OSCH_CHILD_LUNCH,20,4,10,181,195,4,11,193,208,10.4
SAN DIEGO,Jan 2015,CACF,2015,Marine Corps Community Services,OSCH_CHILD_SNACK_PM,20,4,10,181,195,58,146,2648,2852,142.6
SAN DIEGO,Feb 2015,CACF,2015,Marine Corps Community Services,CHILD_BREAKFAST,19,26,43,566,635,339,562,7399,8300,436.8421
SAN DIEGO,Feb 2015,CACF,2015,Marine Corps Community Services,CHILD_LUNCH,19,26,43,566,635,383,635,8356,9374,493.3684
SAN DIEGO,Feb 2015,CACF,2015,Marine Corps Community Services,CHILD_SNACK_AM,19,26,43,566,635,26,43,559,628,33.0526
SAN DIEGO,Feb 2015,CACF,2015,Marine Corps Community Services,CHILD_SNACK_PM,19,26,43,566,635,365,604,7959,8928,469.8947
SAN DIEGO,Feb 2015,CACF,2015,Marine Corps Community Services,OSCH_CHILD_BREAKFAST,19,4,10,181,195,16,40,731,787,41.4211
SAN DIEGO,Feb 2015,CACF,2015,Marine Corps Community Services,OSCH_CHILD_LUNCH,19,4,10,181,195,8,20,358,386,20.3158
SAN DIEGO,Feb 2015,CACF,2015,Marine Corps Community Services,OSCH_CHILD_SNACK_PM,19,4,10,181,195,50,125,2266,2441,128.4737
SAN DIEGO,Mar 2015,CACF,2015,Marine Corps Community Services,CHILD_BREAKFAST,22,26,43,566,635,388,642,8460,9490,431.3636
SAN DIEGO,Mar 2015,CACF,2015,Marine Corps Community Services,CHILD_LUNCH,22,26,43,566,635,448,742,9773,10963,498.3182
SAN DIEGO,Mar 2015,CACF,2015,Marine Corps Community Services,CHILD_SNACK_AM,22,26,43,566,635,31,51,678,760,34.5455
SAN DIEGO,Mar 2015,CACF,2015,Marine Corps Community Services,CHILD_SNACK_PM,22,26,43,566,635,426,706,9293,10425,473.8636
SAN DIEGO,Mar 2015,CACF,2015,Marine Corps Community Services,OSCH_CHILD_BREAKFAST,22,4,10,181,195,18,44,797,859,39.0455
SAN DIEGO,Mar 2015,CACF,2015,Marine Corps Community Services,OSCH_CHILD_LUNCH,22,4,10,181,195,7,19,335,361,16.4091
SAN DIEGO,Mar 2015,CACF,2015,Marine Corps Community Services,OSCH_CHILD_SNACK_PM,22,4,10,181,195,55,137,2483,2675,121.5909
SAN DIEGO,Apr 2015,CACF,2015,Marine Corps Community Services,CHILD_BREAKFAST,22,26,43,566,635,390,645,8499,9534,433.3636
SAN DIEGO,Apr 2015,CACF,2015,Marine Corps Community Services,CHILD_LUNCH,22,26,43,566,635,446,738,9715,10899,495.4091
SAN DIEGO,Apr 2015,CACF,2015,Marine Corps Community Services,CHILD_SNACK_AM,22,26,43,566,635,30,49,652,731,33.2273
SAN DIEGO,Apr 2015,CACF,2015,Marine Corps Community Services,CHILD_SNACK_PM,22,26,43,566,635,416,689,9074,10179,462.6818
SAN DIEGO,Apr 2015,CACF,2015,Marine Corps Community Services,OSCH_CHILD_BREAKFAST,22,4,10,181,195,16,40,719,775,35.2273
SAN DIEGO,Apr 2015,CACF,2015,Marine Corps Community Services,OSCH_CHILD_LUNCH,22,4,10,181,195,7,18,332,357,16.2273
SAN DIEGO,Apr 2015,CACF,2015,Marine Corps Community Services,OSCH_CHILD_SNACK_PM,22,4,10,181,195,53,133,2398,2584,117.4545
SAN DIEGO,May 2015,CACF,2015,Marine Corps Community Services,CHILD_BREAKFAST,20,26,43,566,635,370,612,8059,9041,452.05
SAN DIEGO,May 2015,CACF,2015,Marine Corps Community Services,CHILD_LUNCH,20,26,43,566,635,425,703,9252,10380,519
SAN DIEGO,May 2015,CACF,2015,Marine Corps Community Services,CHILD_SNACK_AM,20,26,43,566,635,25,42,549,616,30.8
SAN DIEGO,May 2015,CACF,2015,Marine Corps Community Services,CHILD_SNACK_PM,20,26,43,566,635,399,661,8706,9766,488.3
SAN DIEGO,May 2015,CACF,2015,Marine Corps Community Services,OSCH_CHILD_BREAKFAST,20,4,10,181,195,14,35,632,681,34.05
SAN DIEGO,May 2015,CACF,2015,Marine Corps Community Services,OSCH_CHILD_LUNCH,20,4,10,181,195,5,12,216,233,11.65
SAN DIEGO,May 2015,CACF,2015,Marine Corps Community Services,OSCH_CHILD_SNACK_PM,20,4,10,181,195,56,139,2521,2716,135.8
SAN DIEGO,Jun 2015,CACF,2015,Marine Corps Community Services,CHILD_BREAKFAST,22,26,43,566,635,337,557,7335,8229,374.0455
SAN DIEGO,Jun 2015,CACF,2015,Marine Corps Community Services,CHILD_LUNCH,22,26,43,566,635,391,648,8527,9566,434.8182
SAN DIEGO,Jun 2015,CACF,2015,Marine Corps Community Services,CHILD_SNACK_AM,22,26,43,566,635,8,13,166,187,8.5
SAN DIEGO,Jun 2015,CACF,2015,Marine Corps Community Services,CHILD_SNACK_PM,22,26,43,566,635,374,618,8141,9133,415.1364
SAN DIEGO,Jun 2015,CACF,2015,Marine Corps Community Services,OSCH_CHILD_BREAKFAST,22,4,10,181,195,51,128,2320,2499,113.5909
SAN DIEGO,Jun 2015,CACF,2015,Marine Corps Community Services,OSCH_CHILD_LUNCH,22,4,10,181,195,64,161,2918,3143,142.8636
SAN DIEGO,Jun 2015,CACF,2015,Marine Corps Community Services,OSCH_CHILD_SNACK_PM,22,4,10,181,195,61,152,2752,2965,134.7727
SAN DIEGO,Jul 2015,CACF,2015,Marine Corps Community Services,CHILD_BREAKFAST,22,26,43,566,635,299,496,6525,7320,332.7273
SAN DIEGO,Jul 2015,CACF,2015,Marine Corps Community Services,CHILD_LUNCH,22,26,43,566,635,346,572,7533,8451,384.1364
SAN DIEGO,Jul 2015,CACF,2015,Marine Corps Community Services,CHILD_SNACK_PM,22,26,43,566,635,330,547,7199,8076,367.0909
SAN DIEGO,Jul 2015,CACF,2015,Marine Corps Community Services,OSCH_CHILD_BREAKFAST,22,4,10,181,195,50,124,2243,2417,109.8636
SAN DIEGO,Jul 2015,CACF,2015,Marine Corps Community Services,OSCH_CHILD_LUNCH,22,4,10,181,195,61,152,2749,2962,134.6364
SAN DIEGO,Jul 2015,CACF,2015,Marine Corps Community Services,OSCH_CHILD_SNACK_PM,22,4,10,181,195,57,142,2574,2773,126.0455
SAN DIEGO,Aug 2015,CACF,2015,Marine Corps Community Services,CHILD_BREAKFAST,21,26,43,566,635,295,489,6440,7224,344
SAN DIEGO,Aug 2015,CACF,2015,Marine Corps Community Services,CHILD_LUNCH,21,26,43,566,635,344,569,7498,8411,400.5238
SAN DIEGO,Aug 2015,CACF,2015,Marine Corps Community Services,CHILD_SNACK_AM,21,26,43,566,635,4,6,84,94,4.4762
SAN DIEGO,Aug 2015,CACF,2015,Marine Corps Community Services,CHILD_SNACK_PM,21,26,43,566,635,329,545,7180,8054,383.5238
SAN DIEGO,Aug 2015,CACF,2015,Marine Corps Community Services,OSCH_CHILD_BREAKFAST,21,4,10,181,195,30,74,1338,1442,68.6667
SAN DIEGO,Aug 2015,CACF,2015,Marine Corps Community Services,OSCH_CHILD_LUNCH,21,4,10,181,195,30,75,1358,1463,69.6667
SAN DIEGO,Aug 2015,CACF,2015,Marine Corps Community Services,OSCH_CHILD_SNACK_PM,21,4,10,181,195,51,129,2327,2507,119.381
SAN DIEGO,Sep 2015,CACF,2015,Marine Corps Community Services,CHILD_BREAKFAST,21,26,43,566,635,323,534,7038,7895,375.9524
SAN DIEGO,Sep 2015,CACF,2015,Marine Corps Community Services,CHILD_LUNCH,21,26,43,566,635,366,606,7980,8952,426.2857
SAN DIEGO,Sep 2015,CACF,2015,Marine Corps Community Services,CHILD_SNACK_AM,21,26,43,566,635,16,27,355,398,18.9524
SAN DIEGO,Sep 2015,CACF,2015,Marine Corps Community Services,CHILD_SNACK_PM,21,26,43,566,635,337,558,7340,8235,392.1429
SAN DIEGO,Sep 2015,CACF,2015,Marine Corps Community Services,OSCH_CHILD_BREAKFAST,21,4,10,181,195,18,46,827,891,42.4286
SAN DIEGO,Sep 2015,CACF,2015,Marine Corps Community Services,OSCH_CHILD_LUNCH,21,4,10,181,195,11,27,497,535,25.4762
SAN DIEGO,Sep 2015,CACF,2015,Marine Corps Community Services,OSCH_CHILD_SNACK_PM,21,4,10,181,195,61,153,2769,2983,142.0476
SAN DIEGO,Oct 2014,CACF,2015,MARTHA'S VILLAGE & KITCHEN INC ,ES_CHILD_BREAKFAST,31,1930,0,0,1930,1070,0,0,1070,34.5161
SAN DIEGO,Oct 2014,CACF,2015,MARTHA'S VILLAGE & KITCHEN INC ,ES_CHILD_LUNCH,31,1930,0,0,1930,899,0,0,899,29
SAN DIEGO,Oct 2014,CACF,2015,MARTHA'S VILLAGE & KITCHEN INC ,ES_CHILD_SUPPER,31,1930,0,0,1930,1024,0,0,1024,33.0323
SAN DIEGO,Nov 2014,CACF,2015,MARTHA'S VILLAGE & KITCHEN INC ,ES_CHILD_BREAKFAST,30,1490,0,0,1490,847,0,0,847,28.2333
SAN DIEGO,Nov 2014,CACF,2015,MARTHA'S VILLAGE & KITCHEN INC ,ES_CHILD_LUNCH,30,1490,0,0,1490,669,0,0,669,22.3
SAN DIEGO,Nov 2014,CACF,2015,MARTHA'S VILLAGE & KITCHEN INC ,ES_CHILD_SUPPER,30,1490,0,0,1490,774,0,0,774,25.8
SAN DIEGO,Dec 2014,CACF,2015,MARTHA'S VILLAGE & KITCHEN INC ,ES_CHILD_BREAKFAST,31,33,0,0,33,852,0,0,852,27.4839
SAN DIEGO,Dec 2014,CACF,2015,MARTHA'S VILLAGE & KITCHEN INC ,ES_CHILD_LUNCH,31,33,0,0,33,650,0,0,650,20.9677
SAN DIEGO,Dec 2014,CACF,2015,MARTHA'S VILLAGE & KITCHEN INC ,ES_CHILD_SUPPER,31,33,0,0,33,732,0,0,732,23.6129
SAN DIEGO,Jan 2015,CACF,2015,MARTHA'S VILLAGE & KITCHEN INC ,ES_CHILD_BREAKFAST,31,2350,0,0,2350,1196,0,0,1196,38.5806
SAN DIEGO,Jan 2015,CACF,2015,MARTHA'S VILLAGE & KITCHEN INC ,ES_CHILD_LUNCH,31,2350,0,0,2350,1042,0,0,1042,33.6129
SAN DIEGO,Jan 2015,CACF,2015,MARTHA'S VILLAGE & KITCHEN INC ,ES_CHILD_SUPPER,31,2350,0,0,2350,809,0,0,809,26.0968
SAN DIEGO,Feb 2015,CACF,2015,MARTHA'S VILLAGE & KITCHEN INC ,ES_CHILD_BREAKFAST,28,1332,0,0,1332,751,0,0,751,26.8214
SAN DIEGO,Feb 2015,CACF,2015,MARTHA'S VILLAGE & KITCHEN INC ,ES_CHILD_LUNCH,28,1332,0,0,1332,519,0,0,519,18.5357
SAN DIEGO,Feb 2015,CACF,2015,MARTHA'S VILLAGE & KITCHEN INC ,ES_CHILD_SUPPER,28,1332,0,0,1332,709,0,0,709,25.3214
SAN DIEGO,Mar 2015,CACF,2015,MARTHA'S VILLAGE & KITCHEN INC ,ES_CHILD_BREAKFAST,31,2787,0,0,2787,1515,0,0,1515,48.871
SAN DIEGO,Mar 2015,CACF,2015,MARTHA'S VILLAGE & KITCHEN INC ,ES_CHILD_LUNCH,31,2787,0,0,2787,1457,0,0,1457,47
SAN DIEGO,Mar 2015,CACF,2015,MARTHA'S VILLAGE & KITCHEN INC ,ES_CHILD_SUPPER,31,2787,0,0,2787,973,0,0,973,31.3871
SAN DIEGO,Apr 2015,CACF,2015,MARTHA'S VILLAGE & KITCHEN INC ,ES_CHILD_BREAKFAST,30,68,0,0,68,1318,0,0,1318,43.9333
SAN DIEGO,Apr 2015,CACF,2015,MARTHA'S VILLAGE & KITCHEN INC ,ES_CHILD_LUNCH,30,68,0,0,68,1447,0,0,1447,48.2333
SAN DIEGO,Apr 2015,CACF,2015,MARTHA'S VILLAGE & KITCHEN INC ,ES_CHILD_SUPPER,30,68,0,0,68,1003,0,0,1003,33.4333
SAN DIEGO,May 2015,CACF,2015,MARTHA'S VILLAGE & KITCHEN INC ,ES_CHILD_BREAKFAST,31,65,0,0,65,1511,0,0,1511,48.7419
SAN DIEGO,May 2015,CACF,2015,MARTHA'S VILLAGE & KITCHEN INC ,ES_CHILD_LUNCH,31,65,0,0,65,1540,0,0,1540,49.6774
SAN DIEGO,May 2015,CACF,2015,MARTHA'S VILLAGE & KITCHEN INC ,ES_CHILD_SUPPER,31,65,0,0,65,1161,0,0,1161,37.4516
SAN DIEGO,Jun 2015,CACF,2015,MARTHA'S VILLAGE & KITCHEN INC ,ES_CHILD_BREAKFAST,30,69,0,0,69,1367,0,0,1367,45.5667
SAN DIEGO,Jun 2015,CACF,2015,MARTHA'S VILLAGE & KITCHEN INC ,ES_CHILD_LUNCH,30,69,0,0,69,1553,0,0,1553,51.7667
SAN DIEGO,Jun 2015,CACF,2015,MARTHA'S VILLAGE & KITCHEN INC ,ES_CHILD_SUPPER,30,69,0,0,69,1146,0,0,1146,38.2
SAN DIEGO,Jul 2015,CACF,2015,MARTHA'S VILLAGE & KITCHEN INC ,ES_CHILD_BREAKFAST,31,80,0,0,80,1546,0,0,1546,49.871
SAN DIEGO,Jul 2015,CACF,2015,MARTHA'S VILLAGE & KITCHEN INC ,ES_CHILD_LUNCH,31,80,0,0,80,1695,0,0,1695,54.6774
SAN DIEGO,Jul 2015,CACF,2015,MARTHA'S VILLAGE & KITCHEN INC ,ES_CHILD_SUPPER,31,80,0,0,80,1160,0,0,1160,37.4194
SAN DIEGO,Aug 2015,CACF,2015,MARTHA'S VILLAGE & KITCHEN INC ,ES_CHILD_BREAKFAST,31,87,0,0,87,2022,0,0,2022,65.2258
SAN DIEGO,Aug 2015,CACF,2015,MARTHA'S VILLAGE & KITCHEN INC ,ES_CHILD_LUNCH,31,87,0,0,87,2029,0,0,2029,65.4516
SAN DIEGO,Aug 2015,CACF,2015,MARTHA'S VILLAGE & KITCHEN INC ,ES_CHILD_SUPPER,31,87,0,0,87,1571,0,0,1571,50.6774
SAN DIEGO,Sep 2015,CACF,2015,MARTHA'S VILLAGE & KITCHEN INC ,ES_CHILD_BREAKFAST,30,106,0,0,106,1771,0,0,1771,59.0333
SAN DIEGO,Sep 2015,CACF,2015,MARTHA'S VILLAGE & KITCHEN INC ,ES_CHILD_LUNCH,30,106,0,0,106,1759,0,0,1759,58.6333
SAN DIEGO,Sep 2015,CACF,2015,MARTHA'S VILLAGE & KITCHEN INC ,ES_CHILD_SUPPER,30,106,0,0,106,1385,0,0,1385,46.1667
SAN DIEGO,Oct 2014,CACF,2015,METROPOLITAN AREA ADVISORY COMMITTEE-MAAC-PROJ HEADSTART,CHILD_BREAKFAST,21,283,0,0,283,5144,0,0,5144,244.9524
SAN DIEGO,Oct 2014,CACF,2015,METROPOLITAN AREA ADVISORY COMMITTEE-MAAC-PROJ HEADSTART,HS_CHILD_BREAKFAST,22,1807,0,0,1807,12904,0,0,12904,586.5455
SAN DIEGO,Oct 2014,CACF,2015,METROPOLITAN AREA ADVISORY COMMITTEE-MAAC-PROJ HEADSTART,HS_CHILD_LUNCH,22,1807,0,0,1807,25852,0,0,25852,1175.0909
SAN DIEGO,Oct 2014,CACF,2015,METROPOLITAN AREA ADVISORY COMMITTEE-MAAC-PROJ HEADSTART,HS_CHILD_SNACK_PM,22,1807,0,0,1807,15563,0,0,15563,707.4091
SAN DIEGO,Nov 2014,CACF,2015,METROPOLITAN AREA ADVISORY COMMITTEE-MAAC-PROJ HEADSTART,CHILD_BREAKFAST,13,364,0,0,364,4084,0,0,4084,314.1538
SAN DIEGO,Nov 2014,CACF,2015,METROPOLITAN AREA ADVISORY COMMITTEE-MAAC-PROJ HEADSTART,HS_CHILD_BREAKFAST,15,1807,0,0,1807,6712,0,0,6712,447.4667
SAN DIEGO,Nov 2014,CACF,2015,METROPOLITAN AREA ADVISORY COMMITTEE-MAAC-PROJ HEADSTART,HS_CHILD_LUNCH,15,1807,0,0,1807,15268,0,0,15268,1017.8667
SAN DIEGO,Nov 2014,CACF,2015,METROPOLITAN AREA ADVISORY COMMITTEE-MAAC-PROJ HEADSTART,HS_CHILD_SNACK_PM,15,1807,0,0,1807,9210,0,0,9210,614
SAN DIEGO,Dec 2014,CACF,2015,METROPOLITAN AREA ADVISORY COMMITTEE-MAAC-PROJ HEADSTART,CHILD_BREAKFAST,13,364,0,0,364,4155,0,0,4155,319.6154
SAN DIEGO,Dec 2014,CACF,2015,METROPOLITAN AREA ADVISORY COMMITTEE-MAAC-PROJ HEADSTART,HS_CHILD_BREAKFAST,13,1807,0,0,1807,7016,0,0,7016,539.6923
SAN DIEGO,Dec 2014,CACF,2015,METROPOLITAN AREA ADVISORY COMMITTEE-MAAC-PROJ HEADSTART,HS_CHILD_LUNCH,13,1807,0,0,1807,15826,0,0,15826,1217.3846
SAN DIEGO,Dec 2014,CACF,2015,METROPOLITAN AREA ADVISORY COMMITTEE-MAAC-PROJ HEADSTART,HS_CHILD_SNACK_PM,13,1807,0,0,1807,9353,0,0,9353,719.4615
SAN DIEGO,Jan 2015,CACF,2015,METROPOLITAN AREA ADVISORY COMMITTEE-MAAC-PROJ HEADSTART,CHILD_BREAKFAST,16,364,0,0,364,4973,0,0,4973,310.8125
SAN DIEGO,Jan 2015,CACF,2015,METROPOLITAN AREA ADVISORY COMMITTEE-MAAC-PROJ HEADSTART,HS_CHILD_BREAKFAST,16,1807,0,0,1807,8139,0,0,8139,508.6875
SAN DIEGO,Jan 2015,CACF,2015,METROPOLITAN AREA ADVISORY COMMITTEE-MAAC-PROJ HEADSTART,HS_CHILD_LUNCH,16,1807,0,0,1807,18816,0,0,18816,1176
SAN DIEGO,Jan 2015,CACF,2015,METROPOLITAN AREA ADVISORY COMMITTEE-MAAC-PROJ HEADSTART,HS_CHILD_SNACK_PM,16,1807,0,0,1807,11392,0,0,11392,712
SAN DIEGO,Feb 2015,CACF,2015,METROPOLITAN AREA ADVISORY COMMITTEE-MAAC-PROJ HEADSTART,CHILD_BREAKFAST,16,364,0,0,364,5227,0,0,5227,326.6875
SAN DIEGO,Feb 2015,CACF,2015,METROPOLITAN AREA ADVISORY COMMITTEE-MAAC-PROJ HEADSTART,HS_CHILD_BREAKFAST,17,1858,0,0,1858,8697,0,0,8697,511.5882
SAN DIEGO,Feb 2015,CACF,2015,METROPOLITAN AREA ADVISORY COMMITTEE-MAAC-PROJ HEADSTART,HS_CHILD_LUNCH,17,1858,0,0,1858,19811,0,0,19811,1165.3529
SAN DIEGO,Feb 2015,CACF,2015,METROPOLITAN AREA ADVISORY COMMITTEE-MAAC-PROJ HEADSTART,HS_CHILD_SNACK_PM,17,1858,0,0,1858,12031,0,0,12031,707.7059
SAN DIEGO,Mar 2015,CACF,2015,METROPOLITAN AREA ADVISORY COMMITTEE-MAAC-PROJ HEADSTART,CHILD_BREAKFAST,17,364,0,0,364,5520,0,0,5520,324.7059
SAN DIEGO,Mar 2015,CACF,2015,METROPOLITAN AREA ADVISORY COMMITTEE-MAAC-PROJ HEADSTART,HS_CHILD_BREAKFAST,17,1858,0,0,1858,8482,0,0,8482,498.9412
SAN DIEGO,Mar 2015,CACF,2015,METROPOLITAN AREA ADVISORY COMMITTEE-MAAC-PROJ HEADSTART,HS_CHILD_LUNCH,17,1858,0,0,1858,20127,0,0,20127,1183.9412
SAN DIEGO,Mar 2015,CACF,2015,METROPOLITAN AREA ADVISORY COMMITTEE-MAAC-PROJ HEADSTART,HS_CHILD_SNACK_PM,17,1858,0,0,1858,12412,0,0,12412,730.1176
SAN DIEGO,Apr 2015,CACF,2015,METROPOLITAN AREA ADVISORY COMMITTEE-MAAC-PROJ HEADSTART,CHILD_BREAKFAST,17,364,0,0,364,5590,0,0,5590,328.8235
SAN DIEGO,Apr 2015,CACF,2015,METROPOLITAN AREA ADVISORY COMMITTEE-MAAC-PROJ HEADSTART,HS_CHILD_BREAKFAST,17,1858,0,0,1858,9017,0,0,9017,530.4118
SAN DIEGO,Apr 2015,CACF,2015,METROPOLITAN AREA ADVISORY COMMITTEE-MAAC-PROJ HEADSTART,HS_CHILD_LUNCH,17,1858,0,0,1858,20939,0,0,20939,1231.7059
SAN DIEGO,Apr 2015,CACF,2015,METROPOLITAN AREA ADVISORY COMMITTEE-MAAC-PROJ HEADSTART,HS_CHILD_SNACK_PM,17,1858,0,0,1858,12841,0,0,12841,755.3529
SAN DIEGO,May 2015,CACF,2015,METROPOLITAN AREA ADVISORY COMMITTEE-MAAC-PROJ HEADSTART,CHILD_BREAKFAST,18,364,0,0,364,5842,0,0,5842,324.5556
SAN DIEGO,May 2015,CACF,2015,METROPOLITAN AREA ADVISORY COMMITTEE-MAAC-PROJ HEADSTART,HS_CHILD_BREAKFAST,18,1858,0,0,1858,6991,0,0,6991,388.3889
SAN DIEGO,May 2015,CACF,2015,METROPOLITAN AREA ADVISORY COMMITTEE-MAAC-PROJ HEADSTART,HS_CHILD_LUNCH,18,1858,0,0,1858,18034,0,0,18034,1001.8889
SAN DIEGO,May 2015,CACF,2015,METROPOLITAN AREA ADVISORY COMMITTEE-MAAC-PROJ HEADSTART,HS_CHILD_SNACK_PM,18,1858,0,0,1858,11510,0,0,11510,639.4444
SAN DIEGO,Jun 2015,CACF,2015,METROPOLITAN AREA ADVISORY COMMITTEE-MAAC-PROJ HEADSTART,CHILD_BREAKFAST,14,364,0,0,364,4127,0,0,4127,294.7857
SAN DIEGO,Jun 2015,CACF,2015,METROPOLITAN AREA ADVISORY COMMITTEE-MAAC-PROJ HEADSTART,HS_CHILD_BREAKFAST,18,1858,0,0,1858,1455,0,0,1455,80.8333
SAN DIEGO,Jun 2015,CACF,2015,METROPOLITAN AREA ADVISORY COMMITTEE-MAAC-PROJ HEADSTART,HS_CHILD_LUNCH,18,1858,0,0,1858,5907,0,0,5907,328.1667
SAN DIEGO,Jun 2015,CACF,2015,METROPOLITAN AREA ADVISORY COMMITTEE-MAAC-PROJ HEADSTART,HS_CHILD_SNACK_PM,18,1858,0,0,1858,4945,0,0,4945,274.7222
SAN DIEGO,Jul 2015,CACF,2015,METROPOLITAN AREA ADVISORY COMMITTEE-MAAC-PROJ HEADSTART,HS_CHILD_BREAKFAST,14,1858,0,0,1858,987,0,0,987,70.5
SAN DIEGO,Jul 2015,CACF,2015,METROPOLITAN AREA ADVISORY COMMITTEE-MAAC-PROJ HEADSTART,HS_CHILD_LUNCH,14,1858,0,0,1858,1070,0,0,1070,76.4286
SAN DIEGO,Jul 2015,CACF,2015,METROPOLITAN AREA ADVISORY COMMITTEE-MAAC-PROJ HEADSTART,HS_CHILD_SNACK_PM,14,1858,0,0,1858,754,0,0,754,53.8571
SAN DIEGO,Aug 2015,CACF,2015,METROPOLITAN AREA ADVISORY COMMITTEE-MAAC-PROJ HEADSTART,CHILD_BREAKFAST,20,364,0,0,364,1818,0,0,1818,90.9
SAN DIEGO,Aug 2015,CACF,2015,METROPOLITAN AREA ADVISORY COMMITTEE-MAAC-PROJ HEADSTART,HS_CHILD_BREAKFAST,20,1858,0,0,1858,1717,0,0,1717,85.85
SAN DIEGO,Aug 2015,CACF,2015,METROPOLITAN AREA ADVISORY COMMITTEE-MAAC-PROJ HEADSTART,HS_CHILD_LUNCH,20,1858,0,0,1858,3638,0,0,3638,181.9
SAN DIEGO,Aug 2015,CACF,2015,METROPOLITAN AREA ADVISORY COMMITTEE-MAAC-PROJ HEADSTART,HS_CHILD_SNACK_PM,20,1858,0,0,1858,2980,0,0,2980,149
SAN DIEGO,Sep 2015,CACF,2015,METROPOLITAN AREA ADVISORY COMMITTEE-MAAC-PROJ HEADSTART,CHILD_BREAKFAST,12,337,0,0,337,3465,0,0,3465,288.75
SAN DIEGO,Sep 2015,CACF,2015,METROPOLITAN AREA ADVISORY COMMITTEE-MAAC-PROJ HEADSTART,HS_CHILD_BREAKFAST,19,1858,0,0,1858,5330,0,0,5330,280.5263
SAN DIEGO,Sep 2015,CACF,2015,METROPOLITAN AREA ADVISORY COMMITTEE-MAAC-PROJ HEADSTART,HS_CHILD_LUNCH,19,1858,0,0,1858,11755,0,0,11755,618.6842
SAN DIEGO,Sep 2015,CACF,2015,METROPOLITAN AREA ADVISORY COMMITTEE-MAAC-PROJ HEADSTART,HS_CHILD_SNACK_PM,19,1858,0,0,1858,7600,0,0,7600,400
SAN DIEGO,Oct 2014,CACF,2015,"Navy Region Southwest, Child and Youth Programs",ATRISK_CHILD_SNACK,22,567,0,0,567,12178,0,0,12178,553.5455
SAN DIEGO,Oct 2014,CACF,2015,"Navy Region Southwest, Child and Youth Programs",CHILD_BREAKFAST,22,67,135,2338,2540,1060,2132,36964,40156,1825.2727
SAN DIEGO,Oct 2014,CACF,2015,"Navy Region Southwest, Child and Youth Programs",CHILD_LUNCH,22,67,135,2338,2540,1243,2500,43336,47079,2139.9545
SAN DIEGO,Oct 2014,CACF,2015,"Navy Region Southwest, Child and Youth Programs",CHILD_SNACK_PM,22,67,135,2338,2540,1128,2270,39343,42741,1942.7727
SAN DIEGO,Oct 2014,DCH,2015,"Navy Region Southwest, Child and Youth Programs",DCH_BREAKFAST,24,0,0,0,0,5123,0,0,5123,213.4583
SAN DIEGO,Oct 2014,DCH,2015,"Navy Region Southwest, Child and Youth Programs",DCH_BREAKFAST,,0,0,0,0,0,13,304,317,0
SAN DIEGO,Oct 2014,DCH,2015,"Navy Region Southwest, Child and Youth Programs",DCH_BREAKFAST,22,0,0,0,0,0,0,0,0,0
SAN DIEGO,Oct 2014,DCH,2015,"Navy Region Southwest, Child and Youth Programs",DCH_BREAKFAST,16,0,0,0,0,0,0,0,0,0
SAN DIEGO,Oct 2014,DCH,2015,"Navy Region Southwest, Child and Youth Programs",DCH_LUNCH,24,0,0,0,0,5636,0,0,5636,234.8333
SAN DIEGO,Oct 2014,DCH,2015,"Navy Region Southwest, Child and Youth Programs",DCH_LUNCH,,0,0,0,0,0,14,392,406,0
SAN DIEGO,Oct 2014,DCH,2015,"Navy Region Southwest, Child and Youth Programs",DCH_LUNCH,22,0,0,0,0,0,0,0,0,0
SAN DIEGO,Oct 2014,DCH,2015,"Navy Region Southwest, Child and Youth Programs",DCH_LUNCH,16,0,0,0,0,0,0,0,0,0
SAN DIEGO,Oct 2014,DCH,2015,"Navy Region Southwest, Child and Youth Programs",DCH_SNACK_AM,24,0,0,0,0,2842,0,0,2842,118.4167
SAN DIEGO,Oct 2014,DCH,2015,"Navy Region Southwest, Child and Youth Programs",DCH_SNACK_AM,,0,0,0,0,0,14,276,290,0
SAN DIEGO,Oct 2014,DCH,2015,"Navy Region Southwest, Child and Youth Programs",DCH_SNACK_AM,22,0,0,0,0,0,0,0,0,0
SAN DIEGO,Oct 2014,DCH,2015,"Navy Region Southwest, Child and Youth Programs",DCH_SNACK_AM,16,0,0,0,0,0,0,0,0,0
SAN DIEGO,Oct 2014,DCH,2015,"Navy Region Southwest, Child and Youth Programs",DCH_SNACK_NT,24,0,0,0,0,35,0,0,35,1.4583
SAN DIEGO,Oct 2014,DCH,2015,"Navy Region Southwest, Child and Youth Programs",DCH_SNACK_NT,22,0,0,0,0,0,0,0,0,0
SAN DIEGO,Oct 2014,DCH,2015,"Navy Region Southwest, Child and Youth Programs",DCH_SNACK_NT,16,0,0,0,0,0,0,0,0,0
SAN DIEGO,Oct 2014,DCH,2015,"Navy Region Southwest, Child and Youth Programs",DCH_SNACK_PM,24,0,0,0,0,3624,0,0,3624,151
SAN DIEGO,Oct 2014,DCH,2015,"Navy Region Southwest, Child and Youth Programs",DCH_SNACK_PM,,0,0,0,0,0,1,230,231,0
SAN DIEGO,Oct 2014,DCH,2015,"Navy Region Southwest, Child and Youth Programs",DCH_SNACK_PM,22,0,0,0,0,0,0,0,0,0
SAN DIEGO,Oct 2014,DCH,2015,"Navy Region Southwest, Child and Youth Programs",DCH_SNACK_PM,16,0,0,0,0,0,0,0,0,0
SAN DIEGO,Oct 2014,DCH,2015,"Navy Region Southwest, Child and Youth Programs",DCH_SUPPER,24,0,0,0,0,258,0,0,258,10.75
SAN DIEGO,Oct 2014,DCH,2015,"Navy Region Southwest, Child and Youth Programs",DCH_SUPPER,22,0,0,0,0,0,0,0,0,0
SAN DIEGO,Oct 2014,DCH,2015,"Navy Region Southwest, Child and Youth Programs",DCH_SUPPER,16,0,0,0,0,0,0,0,0,0
SAN DIEGO,Oct 2014,CACF,2015,"Navy Region Southwest, Child and Youth Programs",OSCH_CHILD_BREAKFAST,22,5,2,69,76,4,2,58,64,2.9091
SAN DIEGO,Oct 2014,CACF,2015,"Navy Region Southwest, Child and Youth Programs",OSCH_CHILD_LUNCH,22,5,2,69,76,10,4,134,148,6.7273
SAN DIEGO,Oct 2014,CACF,2015,"Navy Region Southwest, Child and Youth Programs",OSCH_CHILD_SNACK_PM,22,5,2,69,76,85,34,1172,1291,58.6818
SAN DIEGO,Nov 2014,CACF,2015,"Navy Region Southwest, Child and Youth Programs",ATRISK_CHILD_LUNCH,18,9539,0,0,9539,192,0,0,192,10.6667
SAN DIEGO,Nov 2014,CACF,2015,"Navy Region Southwest, Child and Youth Programs",ATRISK_CHILD_SNACK,18,9539,0,0,9539,9539,0,0,9539,529.9444
SAN DIEGO,Nov 2014,CACF,2015,"Navy Region Southwest, Child and Youth Programs",CHILD_BREAKFAST,18,67,135,2338,2540,833,1675,29040,31548,1752.6667
SAN DIEGO,Nov 2014,CACF,2015,"Navy Region Southwest, Child and Youth Programs",CHILD_LUNCH,18,67,135,2338,2540,944,1899,32928,35771,1987.2778
SAN DIEGO,Nov 2014,CACF,2015,"Navy Region Southwest, Child and Youth Programs",CHILD_SNACK_PM,18,67,135,2338,2540,834,1677,29063,31574,1754.1111
SAN DIEGO,Nov 2014,DCH,2015,"Navy Region Southwest, Child and Youth Programs",DCH_BREAKFAST,19,0,0,0,0,3837,0,0,3837,201.9474
SAN DIEGO,Nov 2014,DCH,2015,"Navy Region Southwest, Child and Youth Programs",DCH_BREAKFAST,,0,0,0,0,0,0,223,223,0
SAN DIEGO,Nov 2014,DCH,2015,"Navy Region Southwest, Child and Youth Programs",DCH_BREAKFAST,21,0,0,0,0,0,0,0,0,0
SAN DIEGO,Nov 2014,DCH,2015,"Navy Region Southwest, Child and Youth Programs",DCH_LUNCH,19,0,0,0,0,4232,0,0,4232,222.7368
SAN DIEGO,Nov 2014,DCH,2015,"Navy Region Southwest, Child and Youth Programs",DCH_LUNCH,,0,0,0,0,0,0,282,282,0
SAN DIEGO,Nov 2014,DCH,2015,"Navy Region Southwest, Child and Youth Programs",DCH_LUNCH,21,0,0,0,0,0,0,0,0,0
SAN DIEGO,Nov 2014,DCH,2015,"Navy Region Southwest, Child and Youth Programs",DCH_SNACK_AM,19,0,0,0,0,2214,0,0,2214,116.5263
SAN DIEGO,Nov 2014,DCH,2015,"Navy Region Southwest, Child and Youth Programs",DCH_SNACK_AM,,0,0,0,0,0,0,201,201,0
SAN DIEGO,Nov 2014,DCH,2015,"Navy Region Southwest, Child and Youth Programs",DCH_SNACK_AM,21,0,0,0,0,0,0,0,0,0
SAN DIEGO,Nov 2014,DCH,2015,"Navy Region Southwest, Child and Youth Programs",DCH_SNACK_NT,19,0,0,0,0,35,0,0,35,1.8421
SAN DIEGO,Nov 2014,DCH,2015,"Navy Region Southwest, Child and Youth Programs",DCH_SNACK_NT,21,0,0,0,0,0,0,0,0,0
SAN DIEGO,Nov 2014,DCH,2015,"Navy Region Southwest, Child and Youth Programs",DCH_SNACK_PM,19,0,0,0,0,2615,0,0,2615,137.6316
SAN DIEGO,Nov 2014,DCH,2015,"Navy Region Southwest, Child and Youth Programs",DCH_SNACK_PM,,0,0,0,0,0,0,135,135,0
SAN DIEGO,Nov 2014,DCH,2015,"Navy Region Southwest, Child and Youth Programs",DCH_SNACK_PM,21,0,0,0,0,0,0,0,0,0
SAN DIEGO,Nov 2014,DCH,2015,"Navy Region Southwest, Child and Youth Programs",DCH_SUPPER,19,0,0,0,0,244,0,0,244,12.8421
SAN DIEGO,Nov 2014,DCH,2015,"Navy Region Southwest, Child and Youth Programs",DCH_SUPPER,21,0,0,0,0,0,0,0,0,0
SAN DIEGO,Nov 2014,CACF,2015,"Navy Region Southwest, Child and Youth Programs",OSCH_CHILD_BREAKFAST,18,5,2,69,76,6,2,79,87,4.8333
SAN DIEGO,Nov 2014,CACF,2015,"Navy Region Southwest, Child and Youth Programs",OSCH_CHILD_LUNCH,18,5,2,69,76,12,5,161,178,9.8889
SAN DIEGO,Nov 2014,CACF,2015,"Navy Region Southwest, Child and Youth Programs",OSCH_CHILD_SNACK_PM,18,5,2,69,76,66,26,906,998,55.4444
SAN DIEGO,Dec 2014,CACF,2015,"Navy Region Southwest, Child and Youth Programs",ATRISK_CHILD_LUNCH,21,470,0,0,470,93,0,0,93,4.4286
SAN DIEGO,Dec 2014,CACF,2015,"Navy Region Southwest, Child and Youth Programs",ATRISK_CHILD_SNACK,21,470,0,0,470,9490,0,0,9490,451.9048
SAN DIEGO,Dec 2014,CACF,2015,"Navy Region Southwest, Child and Youth Programs",CHILD_BREAKFAST,21,67,135,2338,2540,862,1734,30066,32662,1555.3333
SAN DIEGO,Dec 2014,CACF,2015,"Navy Region Southwest, Child and Youth Programs",CHILD_LUNCH,21,67,135,2338,2540,1032,2076,35987,39095,1861.6667
SAN DIEGO,Dec 2014,CACF,2015,"Navy Region Southwest, Child and Youth Programs",CHILD_SNACK_PM,21,67,135,2338,2540,919,1849,32057,34825,1658.3333
SAN DIEGO,Dec 2014,DCH,2015,"Navy Region Southwest, Child and Youth Programs",DCH_BREAKFAST,21,0,0,0,0,4216,0,0,4216,200.7619
SAN DIEGO,Dec 2014,DCH,2015,"Navy Region Southwest, Child and Youth Programs",DCH_BREAKFAST,,0,0,0,0,0,0,224,224,0
SAN DIEGO,Dec 2014,DCH,2015,"Navy Region Southwest, Child and Youth Programs",DCH_BREAKFAST,21,0,0,0,0,0,0,0,0,0
SAN DIEGO,Dec 2014,DCH,2015,"Navy Region Southwest, Child and Youth Programs",DCH_LUNCH,21,0,0,0,0,4715,0,0,4715,224.5238
SAN DIEGO,Dec 2014,DCH,2015,"Navy Region Southwest, Child and Youth Programs",DCH_LUNCH,,0,0,0,0,0,0,281,281,0
SAN DIEGO,Dec 2014,DCH,2015,"Navy Region Southwest, Child and Youth Programs",DCH_LUNCH,21,0,0,0,0,0,0,0,0,0
SAN DIEGO,Dec 2014,DCH,2015,"Navy Region Southwest, Child and Youth Programs",DCH_SNACK_AM,21,0,0,0,0,2718,0,0,2718,129.4286
SAN DIEGO,Dec 2014,DCH,2015,"Navy Region Southwest, Child and Youth Programs",DCH_SNACK_AM,,0,0,0,0,0,0,219,219,0
SAN DIEGO,Dec 2014,DCH,2015,"Navy Region Southwest, Child and Youth Programs",DCH_SNACK_AM,21,0,0,0,0,0,0,0,0,0
SAN DIEGO,Dec 2014,DCH,2015,"Navy Region Southwest, Child and Youth Programs",DCH_SNACK_NT,21,0,0,0,0,11,0,0,11,0.5238
SAN DIEGO,Dec 2014,DCH,2015,"Navy Region Southwest, Child and Youth Programs",DCH_SNACK_NT,21,0,0,0,0,0,0,0,0,0
SAN DIEGO,Dec 2014,DCH,2015,"Navy Region Southwest, Child and Youth Programs",DCH_SNACK_PM,21,0,0,0,0,2768,0,0,2768,131.8095
SAN DIEGO,Dec 2014,DCH,2015,"Navy Region Southwest, Child and Youth Programs",DCH_SNACK_PM,,0,0,0,0,0,0,164,164,0
SAN DIEGO,Dec 2014,DCH,2015,"Navy Region Southwest, Child and Youth Programs",DCH_SNACK_PM,21,0,0,0,0,0,0,0,0,0
SAN DIEGO,Dec 2014,DCH,2015,"Navy Region Southwest, Child and Youth Programs",DCH_SUPPER,21,0,0,0,0,192,0,0,192,9.1429
SAN DIEGO,Dec 2014,DCH,2015,"Navy Region Southwest, Child and Youth Programs",DCH_SUPPER,21,0,0,0,0,0,0,0,0,0
SAN DIEGO,Dec 2014,CACF,2015,"Navy Region Southwest, Child and Youth Programs",OSCH_CHILD_BREAKFAST,21,5,2,69,76,6,2,78,86,4.0952
SAN DIEGO,Dec 2014,CACF,2015,"Navy Region Southwest, Child and Youth Programs",OSCH_CHILD_LUNCH,21,5,2,69,76,4,2,53,59,2.8095
SAN DIEGO,Dec 2014,CACF,2015,"Navy Region Southwest, Child and Youth Programs",OSCH_CHILD_SNACK_PM,21,5,2,69,76,48,19,656,723,34.4286
SAN DIEGO,Jan 2015,CACF,2015,"Navy Region Southwest, Child and Youth Programs",ATRISK_CHILD_LUNCH,20,521,0,0,521,11,0,0,11,0.55
SAN DIEGO,Jan 2015,CACF,2015,"Navy Region Southwest, Child and Youth Programs",ATRISK_CHILD_SNACK,20,521,0,0,521,9311,0,0,9311,465.55
SAN DIEGO,Jan 2015,CACF,2015,"Navy Region Southwest, Child and Youth Programs",CHILD_BREAKFAST,20,67,135,2338,2540,929,1868,32375,35172,1758.6
SAN DIEGO,Jan 2015,CACF,2015,"Navy Region Southwest, Child and Youth Programs",CHILD_LUNCH,20,67,135,2338,2540,1075,2162,37485,40722,2036.1
SAN DIEGO,Jan 2015,CACF,2015,"Navy Region Southwest, Child and Youth Programs",CHILD_SNACK_PM,20,67,135,2338,2540,947,1905,33032,35884,1794.2
SAN DIEGO,Jan 2015,DCH,2015,"Navy Region Southwest, Child and Youth Programs",DCH_BREAKFAST,22,0,0,0,0,4433,0,0,4433,201.5
SAN DIEGO,Jan 2015,DCH,2015,"Navy Region Southwest, Child and Youth Programs",DCH_BREAKFAST,,0,0,0,0,0,0,305,305,0
SAN DIEGO,Jan 2015,DCH,2015,"Navy Region Southwest, Child and Youth Programs",DCH_BREAKFAST,19,0,0,0,0,0,0,0,0,0
SAN DIEGO,Jan 2015,DCH,2015,"Navy Region Southwest, Child and Youth Programs",DCH_LUNCH,22,0,0,0,0,4948,0,0,4948,224.9091
SAN DIEGO,Jan 2015,DCH,2015,"Navy Region Southwest, Child and Youth Programs",DCH_LUNCH,,0,0,0,0,0,0,344,344,0
SAN DIEGO,Jan 2015,DCH,2015,"Navy Region Southwest, Child and Youth Programs",DCH_LUNCH,19,0,0,0,0,0,0,0,0,0
SAN DIEGO,Jan 2015,DCH,2015,"Navy Region Southwest, Child and Youth Programs",DCH_SNACK_AM,22,0,0,0,0,2747,0,0,2747,124.8636
SAN DIEGO,Jan 2015,DCH,2015,"Navy Region Southwest, Child and Youth Programs",DCH_SNACK_AM,,0,0,0,0,0,0,227,227,0
SAN DIEGO,Jan 2015,DCH,2015,"Navy Region Southwest, Child and Youth Programs",DCH_SNACK_AM,19,0,0,0,0,0,0,0,0,0
SAN DIEGO,Jan 2015,DCH,2015,"Navy Region Southwest, Child and Youth Programs",DCH_SNACK_PM,22,0,0,0,0,3129,0,0,3129,142.2273
SAN DIEGO,Jan 2015,DCH,2015,"Navy Region Southwest, Child and Youth Programs",DCH_SNACK_PM,,0,0,0,0,0,0,213,213,0
SAN DIEGO,Jan 2015,DCH,2015,"Navy Region Southwest, Child and Youth Programs",DCH_SNACK_PM,19,0,0,0,0,0,0,0,0,0
SAN DIEGO,Jan 2015,DCH,2015,"Navy Region Southwest, Child and Youth Programs",DCH_SUPPER,22,0,0,0,0,161,0,0,161,7.3182
SAN DIEGO,Jan 2015,DCH,2015,"Navy Region Southwest, Child and Youth Programs",DCH_SUPPER,19,0,0,0,0,0,0,0,0,0
SAN DIEGO,Jan 2015,CACF,2015,"Navy Region Southwest, Child and Youth Programs",OSCH_CHILD_BREAKFAST,20,5,2,69,76,1,0,7,8,0.4
SAN DIEGO,Jan 2015,CACF,2015,"Navy Region Southwest, Child and Youth Programs",OSCH_CHILD_LUNCH,20,5,2,69,76,1,0,18,19,0.95
SAN DIEGO,Jan 2015,CACF,2015,"Navy Region Southwest, Child and Youth Programs",OSCH_CHILD_SNACK_PM,20,5,2,69,76,61,24,841,926,46.3
SAN DIEGO,Feb 2015,CACF,2015,"Navy Region Southwest, Child and Youth Programs",ATRISK_CHILD_LUNCH,19,592,0,0,592,23,0,0,23,1.2105
SAN DIEGO,Feb 2015,CACF,2015,"Navy Region Southwest, Child and Youth Programs",ATRISK_CHILD_SNACK,19,592,0,0,592,10910,0,0,10910,574.2105
SAN DIEGO,Feb 2015,CACF,2015,"Navy Region Southwest, Child and Youth Programs",CHILD_BREAKFAST,19,67,135,2338,2540,972,1954,33879,36805,1937.1053
SAN DIEGO,Feb 2015,CACF,2015,"Navy Region Southwest, Child and Youth Programs",CHILD_LUNCH,19,67,135,2338,2540,1093,2199,38112,41404,2179.1579
SAN DIEGO,Feb 2015,CACF,2015,"Navy Region Southwest, Child and Youth Programs",CHILD_SNACK_PM,19,67,135,2338,2540,990,1991,34505,37486,1972.9474
SAN DIEGO,Feb 2015,DCH,2015,"Navy Region Southwest, Child and Youth Programs",DCH_BREAKFAST,20,0,0,0,0,4712,0,0,4712,235.6
SAN DIEGO,Feb 2015,DCH,2015,"Navy Region Southwest, Child and Youth Programs",DCH_BREAKFAST,,0,0,0,0,0,0,296,296,0
SAN DIEGO,Feb 2015,DCH,2015,"Navy Region Southwest, Child and Youth Programs",DCH_BREAKFAST,20,0,0,0,0,0,0,0,0,0
SAN DIEGO,Feb 2015,DCH,2015,"Navy Region Southwest, Child and Youth Programs",DCH_LUNCH,20,0,0,0,0,5152,0,0,5152,257.6
SAN DIEGO,Feb 2015,DCH,2015,"Navy Region Southwest, Child and Youth Programs",DCH_LUNCH,,0,0,0,0,0,0,324,324,0
SAN DIEGO,Feb 2015,DCH,2015,"Navy Region Southwest, Child and Youth Programs",DCH_LUNCH,20,0,0,0,0,0,0,0,0,0
SAN DIEGO,Feb 2015,DCH,2015,"Navy Region Southwest, Child and Youth Programs",DCH_SNACK_AM,20,0,0,0,0,2737,0,0,2737,136.85
SAN DIEGO,Feb 2015,DCH,2015,"Navy Region Southwest, Child and Youth Programs",DCH_SNACK_AM,,0,0,0,0,0,0,262,262,0
SAN DIEGO,Feb 2015,DCH,2015,"Navy Region Southwest, Child and Youth Programs",DCH_SNACK_AM,20,0,0,0,0,0,0,0,0,0
SAN DIEGO,Feb 2015,DCH,2015,"Navy Region Southwest, Child and Youth Programs",DCH_SNACK_NT,20,0,0,0,0,15,0,0,15,0.75
SAN DIEGO,Feb 2015,DCH,2015,"Navy Region Southwest, Child and Youth Programs",DCH_SNACK_NT,20,0,0,0,0,0,0,0,0,0
SAN DIEGO,Feb 2015,DCH,2015,"Navy Region Southwest, Child and Youth Programs",DCH_SNACK_PM,20,0,0,0,0,3510,0,0,3510,175.5
SAN DIEGO,Feb 2015,DCH,2015,"Navy Region Southwest, Child and Youth Programs",DCH_SNACK_PM,,0,0,0,0,0,0,200,200,0
SAN DIEGO,Feb 2015,DCH,2015,"Navy Region Southwest, Child and Youth Programs",DCH_SNACK_PM,20,0,0,0,0,0,0,0,0,0
SAN DIEGO,Feb 2015,DCH,2015,"Navy Region Southwest, Child and Youth Programs",DCH_SUPPER,20,0,0,0,0,182,0,0,182,9.1
SAN DIEGO,Feb 2015,DCH,2015,"Navy Region Southwest, Child and Youth Programs",DCH_SUPPER,20,0,0,0,0,0,0,0,0,0
SAN DIEGO,Feb 2015,CACF,2015,"Navy Region Southwest, Child and Youth Programs",OSCH_CHILD_BREAKFAST,19,5,2,69,76,1,0,8,9,0.4737
SAN DIEGO,Feb 2015,CACF,2015,"Navy Region Southwest, Child and Youth Programs",OSCH_CHILD_LUNCH,19,5,2,69,76,4,1,49,54,2.8421
SAN DIEGO,Feb 2015,CACF,2015,"Navy Region Southwest, Child and Youth Programs",OSCH_CHILD_SNACK_PM,19,5,2,69,76,60,24,829,913,48.0526
SAN DIEGO,Mar 2015,CACF,2015,"Navy Region Southwest, Child and Youth Programs",ATRISK_CHILD_LUNCH,22,12288,0,0,12288,34,0,0,34,1.5455
SAN DIEGO,Mar 2015,CACF,2015,"Navy Region Southwest, Child and Youth Programs",ATRISK_CHILD_SNACK,22,12288,0,0,12288,12288,0,0,12288,558.5455
SAN DIEGO,Mar 2015,CACF,2015,"Navy Region Southwest, Child and Youth Programs",CHILD_BREAKFAST,22,67,135,2338,2540,1115,2242,38868,42225,1919.3182
SAN DIEGO,Mar 2015,CACF,2015,"Navy Region Southwest, Child and Youth Programs",CHILD_LUNCH,22,67,135,2338,2540,1273,2561,44389,48223,2191.9545
SAN DIEGO,Mar 2015,CACF,2015,"Navy Region Southwest, Child and Youth Programs",CHILD_SNACK_PM,22,67,135,2338,2540,1110,2233,38705,42048,1911.2727
SAN DIEGO,Mar 2015,DCH,2015,"Navy Region Southwest, Child and Youth Programs",DCH_BREAKFAST,23,0,0,0,0,5041,0,0,5041,219.1739
SAN DIEGO,Mar 2015,DCH,2015,"Navy Region Southwest, Child and Youth Programs",DCH_BREAKFAST,,0,0,0,0,0,0,287,287,0
SAN DIEGO,Mar 2015,DCH,2015,"Navy Region Southwest, Child and Youth Programs",DCH_BREAKFAST,22,0,0,0,0,0,0,0,0,0
SAN DIEGO,Mar 2015,DCH,2015,"Navy Region Southwest, Child and Youth Programs",DCH_LUNCH,23,0,0,0,0,5779,0,0,5779,251.2609
SAN DIEGO,Mar 2015,DCH,2015,"Navy Region Southwest, Child and Youth Programs",DCH_LUNCH,,0,0,0,0,0,0,302,302,0
SAN DIEGO,Mar 2015,DCH,2015,"Navy Region Southwest, Child and Youth Programs",DCH_LUNCH,22,0,0,0,0,0,0,0,0,0
SAN DIEGO,Mar 2015,DCH,2015,"Navy Region Southwest, Child and Youth Programs",DCH_SNACK_AM,23,0,0,0,0,3234,0,0,3234,140.6087
SAN DIEGO,Mar 2015,DCH,2015,"Navy Region Southwest, Child and Youth Programs",DCH_SNACK_AM,,0,0,0,0,0,0,302,302,0
SAN DIEGO,Mar 2015,DCH,2015,"Navy Region Southwest, Child and Youth Programs",DCH_SNACK_AM,22,0,0,0,0,0,0,0,0,0
SAN DIEGO,Mar 2015,DCH,2015,"Navy Region Southwest, Child and Youth Programs",DCH_SNACK_NT,23,0,0,0,0,20,0,0,20,0.8696
SAN DIEGO,Mar 2015,DCH,2015,"Navy Region Southwest, Child and Youth Programs",DCH_SNACK_NT,22,0,0,0,0,0,0,0,0,0
SAN DIEGO,Mar 2015,DCH,2015,"Navy Region Southwest, Child and Youth Programs",DCH_SNACK_PM,23,0,0,0,0,3593,0,0,3593,156.2174
SAN DIEGO,Mar 2015,DCH,2015,"Navy Region Southwest, Child and Youth Programs",DCH_SNACK_PM,,0,0,0,0,0,0,137,137,0
SAN DIEGO,Mar 2015,DCH,2015,"Navy Region Southwest, Child and Youth Programs",DCH_SNACK_PM,22,0,0,0,0,0,0,0,0,0
SAN DIEGO,Mar 2015,DCH,2015,"Navy Region Southwest, Child and Youth Programs",DCH_SUPPER,23,0,0,0,0,205,0,0,205,8.913
SAN DIEGO,Mar 2015,DCH,2015,"Navy Region Southwest, Child and Youth Programs",DCH_SUPPER,22,0,0,0,0,0,0,0,0,0
SAN DIEGO,Mar 2015,CACF,2015,"Navy Region Southwest, Child and Youth Programs",OSCH_CHILD_BREAKFAST,22,5,2,69,76,4,1,50,55,2.5
SAN DIEGO,Mar 2015,CACF,2015,"Navy Region Southwest, Child and Youth Programs",OSCH_CHILD_LUNCH,22,5,2,69,76,12,5,160,177,8.0455
SAN DIEGO,Mar 2015,CACF,2015,"Navy Region Southwest, Child and Youth Programs",OSCH_CHILD_SNACK_PM,22,5,2,69,76,47,19,645,711,32.3182
SAN DIEGO,Apr 2015,CACF,2015,"Navy Region Southwest, Child and Youth Programs",ATRISK_CHILD_LUNCH,22,562,0,0,562,210,0,0,210,9.5455
SAN DIEGO,Apr 2015,CACF,2015,"Navy Region Southwest, Child and Youth Programs",ATRISK_CHILD_SNACK,22,562,0,0,562,9528,0,0,9528,433.0909
SAN DIEGO,Apr 2015,CACF,2015,"Navy Region Southwest, Child and Youth Programs",CHILD_BREAKFAST,22,67,135,2338,2540,1100,2213,38371,41684,1894.7273
SAN DIEGO,Apr 2015,CACF,2015,"Navy Region Southwest, Child and Youth Programs",CHILD_LUNCH,22,67,135,2338,2540,1251,2517,43624,47392,2154.1818
SAN DIEGO,Apr 2015,CACF,2015,"Navy Region Southwest, Child and Youth Programs",CHILD_SNACK_PM,22,67,135,2338,2540,1151,2315,40137,43603,1981.9545
SAN DIEGO,Apr 2015,DCH,2015,"Navy Region Southwest, Child and Youth Programs",DCH_BREAKFAST,22,0,0,0,0,5038,0,0,5038,229
SAN DIEGO,Apr 2015,DCH,2015,"Navy Region Southwest, Child and Youth Programs",DCH_BREAKFAST,,0,0,0,0,0,0,243,243,0
SAN DIEGO,Apr 2015,DCH,2015,"Navy Region Southwest, Child and Youth Programs",DCH_BREAKFAST,22,0,0,0,0,0,0,0,0,0
SAN DIEGO,Apr 2015,DCH,2015,"Navy Region Southwest, Child and Youth Programs",DCH_LUNCH,22,0,0,0,0,5820,0,0,5820,264.5455
SAN DIEGO,Apr 2015,DCH,2015,"Navy Region Southwest, Child and Youth Programs",DCH_LUNCH,,0,0,0,0,0,0,243,243,0
SAN DIEGO,Apr 2015,DCH,2015,"Navy Region Southwest, Child and Youth Programs",DCH_LUNCH,22,0,0,0,0,0,0,0,0,0
SAN DIEGO,Apr 2015,DCH,2015,"Navy Region Southwest, Child and Youth Programs",DCH_SNACK_AM,22,0,0,0,0,3245,0,0,3245,147.5
SAN DIEGO,Apr 2015,DCH,2015,"Navy Region Southwest, Child and Youth Programs",DCH_SNACK_AM,,0,0,0,0,0,0,234,234,0
SAN DIEGO,Apr 2015,DCH,2015,"Navy Region Southwest, Child and Youth Programs",DCH_SNACK_AM,22,0,0,0,0,0,0,0,0,0
SAN DIEGO,Apr 2015,DCH,2015,"Navy Region Southwest, Child and Youth Programs",DCH_SNACK_NT,22,0,0,0,0,16,0,0,16,0.7273
SAN DIEGO,Apr 2015,DCH,2015,"Navy Region Southwest, Child and Youth Programs",DCH_SNACK_NT,22,0,0,0,0,0,0,0,0,0
SAN DIEGO,Apr 2015,DCH,2015,"Navy Region Southwest, Child and Youth Programs",DCH_SNACK_PM,22,0,0,0,0,3393,0,0,3393,154.2273
SAN DIEGO,Apr 2015,DCH,2015,"Navy Region Southwest, Child and Youth Programs",DCH_SNACK_PM,,0,0,0,0,0,0,117,117,0
SAN DIEGO,Apr 2015,DCH,2015,"Navy Region Southwest, Child and Youth Programs",DCH_SNACK_PM,22,0,0,0,0,0,0,0,0,0
SAN DIEGO,Apr 2015,DCH,2015,"Navy Region Southwest, Child and Youth Programs",DCH_SUPPER,22,0,0,0,0,190,0,0,190,8.6364
SAN DIEGO,Apr 2015,DCH,2015,"Navy Region Southwest, Child and Youth Programs",DCH_SUPPER,22,0,0,0,0,0,0,0,0,0
SAN DIEGO,Apr 2015,CACF,2015,"Navy Region Southwest, Child and Youth Programs",OSCH_CHILD_BREAKFAST,22,5,2,69,76,3,1,40,44,2
SAN DIEGO,Apr 2015,CACF,2015,"Navy Region Southwest, Child and Youth Programs",OSCH_CHILD_LUNCH,22,5,2,69,76,7,3,101,111,5.0455
SAN DIEGO,Apr 2015,CACF,2015,"Navy Region Southwest, Child and Youth Programs",OSCH_CHILD_SNACK_PM,22,5,2,69,76,53,21,736,810,36.8182
SAN DIEGO,May 2015,CACF,2015,"Navy Region Southwest, Child and Youth Programs",ATRISK_CHILD_SNACK,20,565,0,0,565,11033,0,0,11033,551.65
SAN DIEGO,May 2015,CACF,2015,"Navy Region Southwest, Child and Youth Programs",CHILD_BREAKFAST,20,67,135,2338,2540,987,1984,34400,37371,1868.55
SAN DIEGO,May 2015,CACF,2015,"Navy Region Southwest, Child and Youth Programs",CHILD_LUNCH,20,67,135,2338,2540,1122,2258,39138,42518,2125.9
SAN DIEGO,May 2015,CACF,2015,"Navy Region Southwest, Child and Youth Programs",CHILD_SNACK_PM,20,67,135,2338,2540,1019,2049,35517,38585,1929.25
SAN DIEGO,May 2015,DCH,2015,"Navy Region Southwest, Child and Youth Programs",DCH_BREAKFAST,21,0,0,0,0,4351,0,0,4351,207.1905
SAN DIEGO,May 2015,DCH,2015,"Navy Region Southwest, Child and Youth Programs",DCH_BREAKFAST,,0,0,0,0,0,0,319,319,0
SAN DIEGO,May 2015,DCH,2015,"Navy Region Southwest, Child and Youth Programs",DCH_BREAKFAST,21,0,0,0,0,0,0,0,0,0
SAN DIEGO,May 2015,DCH,2015,"Navy Region Southwest, Child and Youth Programs",DCH_LUNCH,21,0,0,0,0,4945,0,0,4945,235.4762
SAN DIEGO,May 2015,DCH,2015,"Navy Region Southwest, Child and Youth Programs",DCH_LUNCH,,0,0,0,0,0,0,293,293,0
SAN DIEGO,May 2015,DCH,2015,"Navy Region Southwest, Child and Youth Programs",DCH_LUNCH,21,0,0,0,0,0,0,0,0,0
SAN DIEGO,May 2015,DCH,2015,"Navy Region Southwest, Child and Youth Programs",DCH_SNACK_AM,21,0,0,0,0,2712,0,0,2712,129.1429
SAN DIEGO,May 2015,DCH,2015,"Navy Region Southwest, Child and Youth Programs",DCH_SNACK_AM,,0,0,0,0,0,0,287,287,0
SAN DIEGO,May 2015,DCH,2015,"Navy Region Southwest, Child and Youth Programs",DCH_SNACK_AM,21,0,0,0,0,0,0,0,0,0
SAN DIEGO,May 2015,DCH,2015,"Navy Region Southwest, Child and Youth Programs",DCH_SNACK_NT,21,0,0,0,0,11,0,0,11,0.5238
SAN DIEGO,May 2015,DCH,2015,"Navy Region Southwest, Child and Youth Programs",DCH_SNACK_NT,21,0,0,0,0,0,0,0,0,0
SAN DIEGO,May 2015,DCH,2015,"Navy Region Southwest, Child and Youth Programs",DCH_SNACK_PM,21,0,0,0,0,3049,0,0,3049,145.1905
SAN DIEGO,May 2015,DCH,2015,"Navy Region Southwest, Child and Youth Programs",DCH_SNACK_PM,,0,0,0,0,0,0,111,111,0
SAN DIEGO,May 2015,DCH,2015,"Navy Region Southwest, Child and Youth Programs",DCH_SNACK_PM,21,0,0,0,0,0,0,0,0,0
SAN DIEGO,May 2015,DCH,2015,"Navy Region Southwest, Child and Youth Programs",DCH_SUPPER,21,0,0,0,0,150,0,0,150,7.1429
SAN DIEGO,May 2015,DCH,2015,"Navy Region Southwest, Child and Youth Programs",DCH_SUPPER,21,0,0,0,0,0,0,0,0,0
SAN DIEGO,May 2015,CACF,2015,"Navy Region Southwest, Child and Youth Programs",OSCH_CHILD_SNACK_PM,20,5,2,69,76,60,24,834,918,45.9
SAN DIEGO,Jun 2015,CACF,2015,"Navy Region Southwest, Child and Youth Programs",ATRISK_CHILD_LUNCH,22,180,0,0,180,40,0,0,40,1.8182
SAN DIEGO,Jun 2015,CACF,2015,"Navy Region Southwest, Child and Youth Programs",ATRISK_CHILD_SNACK,22,180,0,0,180,2988,0,0,2988,135.8182
SAN DIEGO,Jun 2015,CACF,2015,"Navy Region Southwest, Child and Youth Programs",CHILD_BREAKFAST,22,67,135,2338,2540,1017,2046,35463,38526,1751.1818
SAN DIEGO,Jun 2015,CACF,2015,"Navy Region Southwest, Child and Youth Programs",CHILD_LUNCH,22,67,135,2338,2540,1178,2370,41086,44634,2028.8182
SAN DIEGO,Jun 2015,CACF,2015,"Navy Region Southwest, Child and Youth Programs",CHILD_SNACK_PM,22,67,135,2338,2540,1068,2147,37225,40440,1838.1818
SAN DIEGO,Jun 2015,DCH,2015,"Navy Region Southwest, Child and Youth Programs",DCH_BREAKFAST,22,0,0,0,0,4135,0,0,4135,187.9545
SAN DIEGO,Jun 2015,DCH,2015,"Navy Region Southwest, Child and Youth Programs",DCH_BREAKFAST,,0,0,0,0,0,0,293,293,0
SAN DIEGO,Jun 2015,DCH,2015,"Navy Region Southwest, Child and Youth Programs",DCH_BREAKFAST,22,0,0,0,0,0,0,0,0,0
SAN DIEGO,Jun 2015,DCH,2015,"Navy Region Southwest, Child and Youth Programs",DCH_LUNCH,22,0,0,0,0,5000,0,0,5000,227.2727
SAN DIEGO,Jun 2015,DCH,2015,"Navy Region Southwest, Child and Youth Programs",DCH_LUNCH,,0,0,0,0,0,0,280,280,0
SAN DIEGO,Jun 2015,DCH,2015,"Navy Region Southwest, Child and Youth Programs",DCH_LUNCH,22,0,0,0,0,0,0,0,0,0
SAN DIEGO,Jun 2015,DCH,2015,"Navy Region Southwest, Child and Youth Programs",DCH_SNACK_AM,22,0,0,0,0,2632,0,0,2632,119.6364
SAN DIEGO,Jun 2015,DCH,2015,"Navy Region Southwest, Child and Youth Programs",DCH_SNACK_AM,,0,0,0,0,0,0,275,275,0
SAN DIEGO,Jun 2015,DCH,2015,"Navy Region Southwest, Child and Youth Programs",DCH_SNACK_AM,22,0,0,0,0,0,0,0,0,0
SAN DIEGO,Jun 2015,DCH,2015,"Navy Region Southwest, Child and Youth Programs",DCH_SNACK_NT,22,0,0,0,0,17,0,0,17,0.7727
SAN DIEGO,Jun 2015,DCH,2015,"Navy Region Southwest, Child and Youth Programs",DCH_SNACK_NT,22,0,0,0,0,0,0,0,0,0
SAN DIEGO,Jun 2015,DCH,2015,"Navy Region Southwest, Child and Youth Programs",DCH_SNACK_PM,22,0,0,0,0,2869,0,0,2869,130.4091
SAN DIEGO,Jun 2015,DCH,2015,"Navy Region Southwest, Child and Youth Programs",DCH_SNACK_PM,,0,0,0,0,0,0,90,90,0
SAN DIEGO,Jun 2015,DCH,2015,"Navy Region Southwest, Child and Youth Programs",DCH_SNACK_PM,22,0,0,0,0,0,0,0,0,0
SAN DIEGO,Jun 2015,DCH,2015,"Navy Region Southwest, Child and Youth Programs",DCH_SUPPER,22,0,0,0,0,244,0,0,244,11.0909
SAN DIEGO,Jun 2015,DCH,2015,"Navy Region Southwest, Child and Youth Programs",DCH_SUPPER,22,0,0,0,0,0,0,0,0,0
SAN DIEGO,Jun 2015,CACF,2015,"Navy Region Southwest, Child and Youth Programs",OSCH_CHILD_BREAKFAST,22,5,2,69,76,32,13,447,492,22.3636
SAN DIEGO,Jun 2015,CACF,2015,"Navy Region Southwest, Child and Youth Programs",OSCH_CHILD_LUNCH,22,5,2,69,76,54,22,746,822,37.3636
SAN DIEGO,Jun 2015,CACF,2015,"Navy Region Southwest, Child and Youth Programs",OSCH_CHILD_SNACK_PM,22,5,2,69,76,74,30,1020,1124,51.0909
SAN DIEGO,Jul 2015,CACF,2015,"Navy Region Southwest, Child and Youth Programs",CHILD_BREAKFAST,22,67,135,2338,2540,961,1932,33500,36393,1654.2273
SAN DIEGO,Jul 2015,CACF,2015,"Navy Region Southwest, Child and Youth Programs",CHILD_LUNCH,22,67,135,2338,2540,1107,2227,38615,41949,1906.7727
SAN DIEGO,Jul 2015,CACF,2015,"Navy Region Southwest, Child and Youth Programs",CHILD_SNACK_PM,22,67,135,2338,2540,1009,2029,35169,38207,1736.6818
SAN DIEGO,Jul 2015,DCH,2015,"Navy Region Southwest, Child and Youth Programs",DCH_BREAKFAST,23,0,0,0,0,4036,0,0,4036,175.4783
SAN DIEGO,Jul 2015,DCH,2015,"Navy Region Southwest, Child and Youth Programs",DCH_BREAKFAST,,0,0,0,0,0,0,160,160,0
SAN DIEGO,Jul 2015,DCH,2015,"Navy Region Southwest, Child and Youth Programs",DCH_BREAKFAST,22,0,0,0,0,0,0,0,0,0
SAN DIEGO,Jul 2015,DCH,2015,"Navy Region Southwest, Child and Youth Programs",DCH_LUNCH,23,0,0,0,0,4997,0,0,4997,217.2609
SAN DIEGO,Jul 2015,DCH,2015,"Navy Region Southwest, Child and Youth Programs",DCH_LUNCH,,0,0,0,0,0,0,185,185,0
SAN DIEGO,Jul 2015,DCH,2015,"Navy Region Southwest, Child and Youth Programs",DCH_LUNCH,22,0,0,0,0,0,0,0,0,0
SAN DIEGO,Jul 2015,DCH,2015,"Navy Region Southwest, Child and Youth Programs",DCH_SNACK_AM,23,0,0,0,0,2864,0,0,2864,124.5217
SAN DIEGO,Jul 2015,DCH,2015,"Navy Region Southwest, Child and Youth Programs",DCH_SNACK_AM,,0,0,0,0,0,0,64,64,0
SAN DIEGO,Jul 2015,DCH,2015,"Navy Region Southwest, Child and Youth Programs",DCH_SNACK_AM,22,0,0,0,0,0,0,0,0,0
SAN DIEGO,Jul 2015,DCH,2015,"Navy Region Southwest, Child and Youth Programs",DCH_SNACK_NT,23,0,0,0,0,20,0,0,20,0.8696
SAN DIEGO,Jul 2015,DCH,2015,"Navy Region Southwest, Child and Youth Programs",DCH_SNACK_NT,22,0,0,0,0,0,0,0,0,0
SAN DIEGO,Jul 2015,DCH,2015,"Navy Region Southwest, Child and Youth Programs",DCH_SNACK_PM,23,0,0,0,0,2577,0,0,2577,112.0435
SAN DIEGO,Jul 2015,DCH,2015,"Navy Region Southwest, Child and Youth Programs",DCH_SNACK_PM,,0,0,0,0,0,0,136,136,0
SAN DIEGO,Jul 2015,DCH,2015,"Navy Region Southwest, Child and Youth Programs",DCH_SNACK_PM,22,0,0,0,0,0,0,0,0,0
SAN DIEGO,Jul 2015,DCH,2015,"Navy Region Southwest, Child and Youth Programs",DCH_SUPPER,23,0,0,0,0,279,0,0,279,12.1304
SAN DIEGO,Jul 2015,DCH,2015,"Navy Region Southwest, Child and Youth Programs",DCH_SUPPER,22,0,0,0,0,0,0,0,0,0
SAN DIEGO,Jul 2015,CACF,2015,"Navy Region Southwest, Child and Youth Programs",OSCH_CHILD_BREAKFAST,22,5,2,69,76,44,18,605,667,30.3182
SAN DIEGO,Jul 2015,CACF,2015,"Navy Region Southwest, Child and Youth Programs",OSCH_CHILD_LUNCH,22,5,2,69,76,82,33,1130,1245,56.5909
SAN DIEGO,Jul 2015,CACF,2015,"Navy Region Southwest, Child and Youth Programs",OSCH_CHILD_SNACK_PM,22,5,2,69,76,69,28,959,1056,48
SAN DIEGO,Aug 2015,CACF,2015,"Navy Region Southwest, Child and Youth Programs",ATRISK_CHILD_LUNCH,6,91,0,0,91,3,0,0,3,0.5
SAN DIEGO,Aug 2015,CACF,2015,"Navy Region Southwest, Child and Youth Programs",ATRISK_CHILD_SNACK,6,91,0,0,91,489,0,0,489,81.5
SAN DIEGO,Aug 2015,CACF,2015,"Navy Region Southwest, Child and Youth Programs",CHILD_BREAKFAST,21,67,135,2338,2540,924,1858,32210,34992,1666.2857
SAN DIEGO,Aug 2015,CACF,2015,"Navy Region Southwest, Child and Youth Programs",CHILD_LUNCH,21,67,135,2338,2540,1093,2199,38121,41413,1972.0476
SAN DIEGO,Aug 2015,CACF,2015,"Navy Region Southwest, Child and Youth Programs",CHILD_SNACK_PM,21,67,135,2338,2540,974,1959,33959,36892,1756.7619
SAN DIEGO,Aug 2015,DCH,2015,"Navy Region Southwest, Child and Youth Programs",DCH_BREAKFAST,22,0,0,0,0,3796,0,0,3796,172.5455
SAN DIEGO,Aug 2015,DCH,2015,"Navy Region Southwest, Child and Youth Programs",DCH_BREAKFAST,,0,0,0,0,0,0,154,154,0
SAN DIEGO,Aug 2015,DCH,2015,"Navy Region Southwest, Child and Youth Programs",DCH_BREAKFAST,21,0,0,0,0,0,0,0,0,0
SAN DIEGO,Aug 2015,DCH,2015,"Navy Region Southwest, Child and Youth Programs",DCH_LUNCH,22,0,0,0,0,4749,0,0,4749,215.8636
SAN DIEGO,Aug 2015,DCH,2015,"Navy Region Southwest, Child and Youth Programs",DCH_LUNCH,,0,0,0,0,0,0,186,186,0
SAN DIEGO,Aug 2015,DCH,2015,"Navy Region Southwest, Child and Youth Programs",DCH_LUNCH,21,0,0,0,0,0,0,0,0,0
SAN DIEGO,Aug 2015,DCH,2015,"Navy Region Southwest, Child and Youth Programs",DCH_SNACK_AM,22,0,0,0,0,2629,0,0,2629,119.5
SAN DIEGO,Aug 2015,DCH,2015,"Navy Region Southwest, Child and Youth Programs",DCH_SNACK_AM,,0,0,0,0,0,0,69,69,0
SAN DIEGO,Aug 2015,DCH,2015,"Navy Region Southwest, Child and Youth Programs",DCH_SNACK_AM,21,0,0,0,0,0,0,0,0,0
SAN DIEGO,Aug 2015,DCH,2015,"Navy Region Southwest, Child and Youth Programs",DCH_SNACK_NT,22,0,0,0,0,1,0,0,1,0.0455
SAN DIEGO,Aug 2015,DCH,2015,"Navy Region Southwest, Child and Youth Programs",DCH_SNACK_NT,21,0,0,0,0,0,0,0,0,0
SAN DIEGO,Aug 2015,DCH,2015,"Navy Region Southwest, Child and Youth Programs",DCH_SNACK_PM,22,0,0,0,0,2718,0,0,2718,123.5455
SAN DIEGO,Aug 2015,DCH,2015,"Navy Region Southwest, Child and Youth Programs",DCH_SNACK_PM,,0,0,0,0,0,0,144,144,0
SAN DIEGO,Aug 2015,DCH,2015,"Navy Region Southwest, Child and Youth Programs",DCH_SNACK_PM,21,0,0,0,0,0,0,0,0,0
SAN DIEGO,Aug 2015,DCH,2015,"Navy Region Southwest, Child and Youth Programs",DCH_SUPPER,22,0,0,0,0,226,0,0,226,10.2727
SAN DIEGO,Aug 2015,DCH,2015,"Navy Region Southwest, Child and Youth Programs",DCH_SUPPER,21,0,0,0,0,0,0,0,0,0
SAN DIEGO,Aug 2015,CACF,2015,"Navy Region Southwest, Child and Youth Programs",OSCH_CHILD_BREAKFAST,21,5,2,69,76,23,9,320,352,16.7619
SAN DIEGO,Aug 2015,CACF,2015,"Navy Region Southwest, Child and Youth Programs",OSCH_CHILD_LUNCH,21,5,2,69,76,31,12,431,474,22.5714
SAN DIEGO,Aug 2015,CACF,2015,"Navy Region Southwest, Child and Youth Programs",OSCH_CHILD_SNACK_PM,21,5,2,69,76,85,34,1179,1298,61.8095
SAN DIEGO,Sep 2015,CACF,2015,"Navy Region Southwest, Child and Youth Programs",ATRISK_CHILD_SNACK,21,396,0,0,396,8069,0,0,8069,384.2381
SAN DIEGO,Sep 2015,CACF,2015,"Navy Region Southwest, Child and Youth Programs",CHILD_BREAKFAST,21,67,135,2338,2540,942,1894,32836,35672,1698.6667
SAN DIEGO,Sep 2015,CACF,2015,"Navy Region Southwest, Child and Youth Programs",CHILD_LUNCH,21,67,135,2338,2540,1087,2187,37907,41181,1961
SAN DIEGO,Sep 2015,CACF,2015,"Navy Region Southwest, Child and Youth Programs",CHILD_SNACK_PM,21,67,135,2338,2540,974,1958,33946,36878,1756.0952
SAN DIEGO,Sep 2015,DCH,2015,"Navy Region Southwest, Child and Youth Programs",DCH_BREAKFAST,22,0,0,0,0,4131,0,0,4131,187.7727
SAN DIEGO,Sep 2015,DCH,2015,"Navy Region Southwest, Child and Youth Programs",DCH_BREAKFAST,,0,0,0,0,0,0,238,238,0
SAN DIEGO,Sep 2015,DCH,2015,"Navy Region Southwest, Child and Youth Programs",DCH_BREAKFAST,21,0,0,0,0,0,0,0,0,0
SAN DIEGO,Sep 2015,DCH,2015,"Navy Region Southwest, Child and Youth Programs",DCH_LUNCH,22,0,0,0,0,4527,0,0,4527,205.7727
SAN DIEGO,Sep 2015,DCH,2015,"Navy Region Southwest, Child and Youth Programs",DCH_LUNCH,,0,0,0,0,0,0,200,200,0
SAN DIEGO,Sep 2015,DCH,2015,"Navy Region Southwest, Child and Youth Programs",DCH_LUNCH,21,0,0,0,0,0,0,0,0,0
SAN DIEGO,Sep 2015,DCH,2015,"Navy Region Southwest, Child and Youth Programs",DCH_SNACK_AM,22,0,0,0,0,2392,0,0,2392,108.7273
SAN DIEGO,Sep 2015,DCH,2015,"Navy Region Southwest, Child and Youth Programs",DCH_SNACK_AM,,0,0,0,0,0,0,165,165,0
SAN DIEGO,Sep 2015,DCH,2015,"Navy Region Southwest, Child and Youth Programs",DCH_SNACK_AM,21,0,0,0,0,0,0,0,0,0
SAN DIEGO,Sep 2015,DCH,2015,"Navy Region Southwest, Child and Youth Programs",DCH_SNACK_NT,22,0,0,0,0,9,0,0,9,0.4091
SAN DIEGO,Sep 2015,DCH,2015,"Navy Region Southwest, Child and Youth Programs",DCH_SNACK_NT,21,0,0,0,0,0,0,0,0,0
SAN DIEGO,Sep 2015,DCH,2015,"Navy Region Southwest, Child and Youth Programs",DCH_SNACK_PM,22,0,0,0,0,2945,0,0,2945,133.8636
SAN DIEGO,Sep 2015,DCH,2015,"Navy Region Southwest, Child and Youth Programs",DCH_SNACK_PM,,0,0,0,0,0,0,215,215,0
SAN DIEGO,Sep 2015,DCH,2015,"Navy Region Southwest, Child and Youth Programs",DCH_SNACK_PM,21,0,0,0,0,0,0,0,0,0
SAN DIEGO,Sep 2015,DCH,2015,"Navy Region Southwest, Child and Youth Programs",DCH_SUPPER,22,0,0,0,0,280,0,0,280,12.7273
SAN DIEGO,Sep 2015,DCH,2015,"Navy Region Southwest, Child and Youth Programs",DCH_SUPPER,21,0,0,0,0,0,0,0,0,0
SAN DIEGO,Sep 2015,CACF,2015,"Navy Region Southwest, Child and Youth Programs",OSCH_CHILD_BREAKFAST,21,5,2,69,76,20,8,274,302,14.381
SAN DIEGO,Sep 2015,CACF,2015,"Navy Region Southwest, Child and Youth Programs",OSCH_CHILD_SNACK_PM,21,5,2,69,76,84,33,1153,1270,60.4762
SAN DIEGO,Oct 2014,CACF,2015,NEIGHBORHOOD HOUSE ASSOCIATION ,ADULT_LUNCH,23,57,2,13,72,869,31,198,1098,47.7391
SAN DIEGO,Oct 2014,CACF,2015,NEIGHBORHOOD HOUSE ASSOCIATION ,ADULT_SNACK_AM,23,57,2,13,72,695,24,159,878,38.1739
SAN DIEGO,Oct 2014,CACF,2015,NEIGHBORHOOD HOUSE ASSOCIATION ,ADULT_SNACK_PM,23,57,2,13,72,794,28,181,1003,43.6087
SAN DIEGO,Oct 2014,CACF,2015,NEIGHBORHOOD HOUSE ASSOCIATION ,HS_CHILD_BREAKFAST,23,2421,0,0,2421,26336,0,0,26336,1145.0435
SAN DIEGO,Oct 2014,CACF,2015,NEIGHBORHOOD HOUSE ASSOCIATION ,HS_CHILD_LUNCH,23,2421,0,0,2421,35644,0,0,35644,1549.7391
SAN DIEGO,Oct 2014,CACF,2015,NEIGHBORHOOD HOUSE ASSOCIATION ,HS_CHILD_SNACK_AM,23,2421,0,0,2421,299,0,0,299,13
SAN DIEGO,Oct 2014,CACF,2015,NEIGHBORHOOD HOUSE ASSOCIATION ,HS_CHILD_SNACK_PM,23,2421,0,0,2421,20457,0,0,20457,889.4348
SAN DIEGO,Nov 2014,CACF,2015,NEIGHBORHOOD HOUSE ASSOCIATION ,ADULT_LUNCH,18,57,2,13,72,697,24,159,880,48.8889
SAN DIEGO,Nov 2014,CACF,2015,NEIGHBORHOOD HOUSE ASSOCIATION ,ADULT_SNACK_AM,18,57,2,13,72,623,22,142,787,43.7222
SAN DIEGO,Nov 2014,CACF,2015,NEIGHBORHOOD HOUSE ASSOCIATION ,ADULT_SNACK_PM,18,57,2,13,72,648,23,147,818,45.4444
SAN DIEGO,Nov 2014,CACF,2015,NEIGHBORHOOD HOUSE ASSOCIATION ,HS_CHILD_BREAKFAST,17,2421,0,0,2421,15762,0,0,15762,927.1765
SAN DIEGO,Nov 2014,CACF,2015,NEIGHBORHOOD HOUSE ASSOCIATION ,HS_CHILD_LUNCH,17,2421,0,0,2421,21587,0,0,21587,1269.8235
SAN DIEGO,Nov 2014,CACF,2015,NEIGHBORHOOD HOUSE ASSOCIATION ,HS_CHILD_SNACK_AM,17,2421,0,0,2421,214,0,0,214,12.5882
SAN DIEGO,Nov 2014,CACF,2015,NEIGHBORHOOD HOUSE ASSOCIATION ,HS_CHILD_SNACK_PM,17,2421,0,0,2421,12523,0,0,12523,736.6471
SAN DIEGO,Dec 2014,CACF,2015,NEIGHBORHOOD HOUSE ASSOCIATION ,ADULT_LUNCH,21,57,2,13,72,787,28,179,994,47.3333
SAN DIEGO,Dec 2014,CACF,2015,NEIGHBORHOOD HOUSE ASSOCIATION ,ADULT_SNACK_AM,21,57,2,13,72,690,24,158,872,41.5238
SAN DIEGO,Dec 2014,CACF,2015,NEIGHBORHOOD HOUSE ASSOCIATION ,ADULT_SNACK_PM,21,57,2,13,72,717,25,164,906,43.1429
SAN DIEGO,Dec 2014,CACF,2015,NEIGHBORHOOD HOUSE ASSOCIATION ,HS_CHILD_BREAKFAST,20,2421,0,0,2421,16806,0,0,16806,840.3
SAN DIEGO,Dec 2014,CACF,2015,NEIGHBORHOOD HOUSE ASSOCIATION ,HS_CHILD_LUNCH,20,2421,0,0,2421,22999,0,0,22999,1149.95
SAN DIEGO,Dec 2014,CACF,2015,NEIGHBORHOOD HOUSE ASSOCIATION ,HS_CHILD_SNACK_AM,20,2421,0,0,2421,232,0,0,232,11.6
SAN DIEGO,Dec 2014,CACF,2015,NEIGHBORHOOD HOUSE ASSOCIATION ,HS_CHILD_SNACK_PM,20,2421,0,0,2421,13139,0,0,13139,656.95
SAN DIEGO,Jan 2015,CACF,2015,NEIGHBORHOOD HOUSE ASSOCIATION ,ADULT_LUNCH,21,57,2,13,72,789,28,179,996,47.4286
SAN DIEGO,Jan 2015,CACF,2015,NEIGHBORHOOD HOUSE ASSOCIATION ,ADULT_SNACK_AM,21,57,2,13,72,728,26,165,919,43.7619
SAN DIEGO,Jan 2015,CACF,2015,NEIGHBORHOOD HOUSE ASSOCIATION ,ADULT_SNACK_PM,21,57,2,13,72,728,26,166,920,43.8095
SAN DIEGO,Jan 2015,CACF,2015,NEIGHBORHOOD HOUSE ASSOCIATION ,HS_CHILD_BREAKFAST,19,2421,0,0,2421,20734,0,0,20734,1091.2632
SAN DIEGO,Jan 2015,CACF,2015,NEIGHBORHOOD HOUSE ASSOCIATION ,HS_CHILD_LUNCH,19,2421,0,0,2421,28633,0,0,28633,1507
SAN DIEGO,Jan 2015,CACF,2015,NEIGHBORHOOD HOUSE ASSOCIATION ,HS_CHILD_SNACK_AM,19,2421,0,0,2421,246,0,0,246,12.9474
SAN DIEGO,Jan 2015,CACF,2015,NEIGHBORHOOD HOUSE ASSOCIATION ,HS_CHILD_SNACK_PM,19,2421,0,0,2421,16315,0,0,16315,858.6842
SAN DIEGO,Feb 2015,CACF,2015,NEIGHBORHOOD HOUSE ASSOCIATION ,ADULT_LUNCH,20,57,2,13,72,768,27,175,970,48.5
SAN DIEGO,Feb 2015,CACF,2015,NEIGHBORHOOD HOUSE ASSOCIATION ,ADULT_SNACK_AM,20,57,2,13,72,703,25,160,888,44.4
SAN DIEGO,Feb 2015,CACF,2015,NEIGHBORHOOD HOUSE ASSOCIATION ,ADULT_SNACK_PM,20,57,2,13,72,714,25,163,902,45.1
SAN DIEGO,Feb 2015,CACF,2015,NEIGHBORHOOD HOUSE ASSOCIATION ,HS_CHILD_BREAKFAST,18,2421,0,0,2421,21078,0,0,21078,1171
SAN DIEGO,Feb 2015,CACF,2015,NEIGHBORHOOD HOUSE ASSOCIATION ,HS_CHILD_LUNCH,18,2421,0,0,2421,29366,0,0,29366,1631.4444
SAN DIEGO,Feb 2015,CACF,2015,NEIGHBORHOOD HOUSE ASSOCIATION ,HS_CHILD_SNACK_AM,18,2421,0,0,2421,242,0,0,242,13.4444
SAN DIEGO,Feb 2015,CACF,2015,NEIGHBORHOOD HOUSE ASSOCIATION ,HS_CHILD_SNACK_PM,18,2421,0,0,2421,17249,0,0,17249,958.2778
SAN DIEGO,Mar 2015,CACF,2015,NEIGHBORHOOD HOUSE ASSOCIATION ,ADULT_LUNCH,22,57,2,13,72,823,29,187,1039,47.2273
SAN DIEGO,Mar 2015,CACF,2015,NEIGHBORHOOD HOUSE ASSOCIATION ,ADULT_SNACK_AM,22,57,2,13,72,795,28,181,1004,45.6364
SAN DIEGO,Mar 2015,CACF,2015,NEIGHBORHOOD HOUSE ASSOCIATION ,ADULT_SNACK_PM,22,57,2,13,72,762,27,173,962,43.7273
SAN DIEGO,Mar 2015,CACF,2015,NEIGHBORHOOD HOUSE ASSOCIATION ,HS_CHILD_BREAKFAST,21,2421,0,0,2421,22916,0,0,22916,1091.2381
SAN DIEGO,Mar 2015,CACF,2015,NEIGHBORHOOD HOUSE ASSOCIATION ,HS_CHILD_LUNCH,21,2421,0,0,2421,32006,0,0,32006,1524.0952
SAN DIEGO,Mar 2015,CACF,2015,NEIGHBORHOOD HOUSE ASSOCIATION ,HS_CHILD_SNACK_AM,21,2421,0,0,2421,263,0,0,263,12.5238
SAN DIEGO,Mar 2015,CACF,2015,NEIGHBORHOOD HOUSE ASSOCIATION ,HS_CHILD_SNACK_PM,21,2421,0,0,2421,18388,0,0,18388,875.619
SAN DIEGO,Apr 2015,CACF,2015,NEIGHBORHOOD HOUSE ASSOCIATION ,ADULT_LUNCH,22,57,2,13,72,844,30,192,1066,48.4545
SAN DIEGO,Apr 2015,CACF,2015,NEIGHBORHOOD HOUSE ASSOCIATION ,ADULT_SNACK_AM,22,57,2,13,72,812,29,185,1026,46.6364
SAN DIEGO,Apr 2015,CACF,2015,NEIGHBORHOOD HOUSE ASSOCIATION ,ADULT_SNACK_PM,22,57,2,13,72,781,27,178,986,44.8182
SAN DIEGO,Apr 2015,CACF,2015,NEIGHBORHOOD HOUSE ASSOCIATION ,HS_CHILD_BREAKFAST,22,2421,0,0,2421,22271,0,0,22271,1012.3182
SAN DIEGO,Apr 2015,CACF,2015,NEIGHBORHOOD HOUSE ASSOCIATION ,HS_CHILD_LUNCH,22,2421,0,0,2421,31355,0,0,31355,1425.2273
SAN DIEGO,Apr 2015,CACF,2015,NEIGHBORHOOD HOUSE ASSOCIATION ,HS_CHILD_SNACK_AM,22,2421,0,0,2421,272,0,0,272,12.3636
SAN DIEGO,Apr 2015,CACF,2015,NEIGHBORHOOD HOUSE ASSOCIATION ,HS_CHILD_SNACK_PM,22,2421,0,0,2421,18092,0,0,18092,822.3636
SAN DIEGO,May 2015,CACF,2015,NEIGHBORHOOD HOUSE ASSOCIATION ,ADULT_LUNCH,20,57,2,13,72,744,26,170,940,47
SAN DIEGO,May 2015,CACF,2015,NEIGHBORHOOD HOUSE ASSOCIATION ,ADULT_SNACK_AM,20,57,2,13,72,727,26,165,918,45.9
SAN DIEGO,May 2015,CACF,2015,NEIGHBORHOOD HOUSE ASSOCIATION ,ADULT_SNACK_PM,20,57,2,13,72,698,25,159,882,44.1
SAN DIEGO,May 2015,CACF,2015,NEIGHBORHOOD HOUSE ASSOCIATION ,HS_CHILD_BREAKFAST,20,2421,0,0,2421,22949,0,0,22949,1147.45
SAN DIEGO,May 2015,CACF,2015,NEIGHBORHOOD HOUSE ASSOCIATION ,HS_CHILD_LUNCH,20,2421,0,0,2421,31755,0,0,31755,1587.75
SAN DIEGO,May 2015,CACF,2015,NEIGHBORHOOD HOUSE ASSOCIATION ,HS_CHILD_SNACK_AM,20,2421,0,0,2421,279,0,0,279,13.95
SAN DIEGO,May 2015,CACF,2015,NEIGHBORHOOD HOUSE ASSOCIATION ,HS_CHILD_SNACK_PM,20,2421,0,0,2421,18050,0,0,18050,902.5
SAN DIEGO,Jun 2015,CACF,2015,NEIGHBORHOOD HOUSE ASSOCIATION ,ADULT_LUNCH,22,57,2,13,72,839,29,192,1060,48.1818
SAN DIEGO,Jun 2015,CACF,2015,NEIGHBORHOOD HOUSE ASSOCIATION ,ADULT_SNACK_AM,22,57,2,13,72,815,29,185,1029,46.7727
SAN DIEGO,Jun 2015,CACF,2015,NEIGHBORHOOD HOUSE ASSOCIATION ,ADULT_SNACK_PM,22,57,2,13,72,778,27,178,983,44.6818
SAN DIEGO,Jun 2015,CACF,2015,NEIGHBORHOOD HOUSE ASSOCIATION ,HS_CHILD_BREAKFAST,19,2421,0,0,2421,11646,0,0,11646,612.9474
SAN DIEGO,Jun 2015,CACF,2015,NEIGHBORHOOD HOUSE ASSOCIATION ,HS_CHILD_LUNCH,19,2421,0,0,2421,15997,0,0,15997,841.9474
SAN DIEGO,Jun 2015,CACF,2015,NEIGHBORHOOD HOUSE ASSOCIATION ,HS_CHILD_SNACK_AM,19,2421,0,0,2421,194,0,0,194,10.2105
SAN DIEGO,Jun 2015,CACF,2015,NEIGHBORHOOD HOUSE ASSOCIATION ,HS_CHILD_SNACK_PM,19,2421,0,0,2421,8079,0,0,8079,425.2105
SAN DIEGO,Jul 2015,CACF,2015,NEIGHBORHOOD HOUSE ASSOCIATION ,ADULT_LUNCH,22,57,2,13,72,826,29,188,1043,47.4091
SAN DIEGO,Jul 2015,CACF,2015,NEIGHBORHOOD HOUSE ASSOCIATION ,ADULT_SNACK_AM,22,57,2,13,72,810,28,185,1023,46.5
SAN DIEGO,Jul 2015,CACF,2015,NEIGHBORHOOD HOUSE ASSOCIATION ,ADULT_SNACK_PM,22,57,2,13,72,782,27,179,988,44.9091
SAN DIEGO,Jul 2015,CACF,2015,NEIGHBORHOOD HOUSE ASSOCIATION ,HS_CHILD_BREAKFAST,21,2421,0,0,2421,906,0,0,906,43.1429
SAN DIEGO,Jul 2015,CACF,2015,NEIGHBORHOOD HOUSE ASSOCIATION ,HS_CHILD_LUNCH,21,2421,0,0,2421,1155,0,0,1155,55
SAN DIEGO,Jul 2015,CACF,2015,NEIGHBORHOOD HOUSE ASSOCIATION ,HS_CHILD_SNACK_AM,21,2421,0,0,2421,113,0,0,113,5.381
SAN DIEGO,Jul 2015,CACF,2015,NEIGHBORHOOD HOUSE ASSOCIATION ,HS_CHILD_SNACK_PM,21,2421,0,0,2421,723,0,0,723,34.4286
SAN DIEGO,Aug 2015,CACF,2015,NEIGHBORHOOD HOUSE ASSOCIATION ,ADULT_LUNCH,21,57,2,13,72,785,28,179,992,47.2381
SAN DIEGO,Aug 2015,CACF,2015,NEIGHBORHOOD HOUSE ASSOCIATION ,ADULT_SNACK_AM,21,57,2,13,72,777,27,178,982,46.7619
SAN DIEGO,Aug 2015,CACF,2015,NEIGHBORHOOD HOUSE ASSOCIATION ,ADULT_SNACK_PM,21,57,2,13,72,761,27,173,961,45.7619
SAN DIEGO,Aug 2015,CACF,2015,NEIGHBORHOOD HOUSE ASSOCIATION ,HS_CHILD_BREAKFAST,21,2421,0,0,2421,1353,0,0,1353,64.4286
SAN DIEGO,Aug 2015,CACF,2015,NEIGHBORHOOD HOUSE ASSOCIATION ,HS_CHILD_LUNCH,21,2421,0,0,2421,1888,0,0,1888,89.9048
SAN DIEGO,Aug 2015,CACF,2015,NEIGHBORHOOD HOUSE ASSOCIATION ,HS_CHILD_SNACK_AM,21,2421,0,0,2421,260,0,0,260,12.381
SAN DIEGO,Aug 2015,CACF,2015,NEIGHBORHOOD HOUSE ASSOCIATION ,HS_CHILD_SNACK_PM,21,2421,0,0,2421,1232,0,0,1232,58.6667
SAN DIEGO,Sep 2015,CACF,2015,NEIGHBORHOOD HOUSE ASSOCIATION ,ADULT_LUNCH,21,57,2,13,72,837,29,191,1057,50.3333
SAN DIEGO,Sep 2015,CACF,2015,NEIGHBORHOOD HOUSE ASSOCIATION ,ADULT_SNACK_AM,21,57,2,13,72,831,29,190,1050,50
SAN DIEGO,Sep 2015,CACF,2015,NEIGHBORHOOD HOUSE ASSOCIATION ,ADULT_SNACK_PM,21,57,2,13,72,805,28,184,1017,48.4286
SAN DIEGO,Sep 2015,CACF,2015,NEIGHBORHOOD HOUSE ASSOCIATION ,HS_CHILD_BREAKFAST,21,2421,0,0,2421,15760,0,0,15760,750.4762
SAN DIEGO,Sep 2015,CACF,2015,NEIGHBORHOOD HOUSE ASSOCIATION ,HS_CHILD_LUNCH,21,2421,0,0,2421,20696,0,0,20696,985.5238
SAN DIEGO,Sep 2015,CACF,2015,NEIGHBORHOOD HOUSE ASSOCIATION ,HS_CHILD_SNACK_AM,21,2421,0,0,2421,313,0,0,313,14.9048
SAN DIEGO,Sep 2015,CACF,2015,NEIGHBORHOOD HOUSE ASSOCIATION ,HS_CHILD_SNACK_PM,21,2421,0,0,2421,12315,0,0,12315,586.4286
SAN DIEGO,Oct 2014,CACF,2015,NEXT GENERATION EDUC CTR INC,CHILD_BREAKFAST,22,29,0,86,115,205,0,609,814,37
SAN DIEGO,Oct 2014,CACF,2015,NEXT GENERATION EDUC CTR INC,CHILD_LUNCH,22,29,0,86,115,455,0,1348,1803,81.9545
SAN DIEGO,Oct 2014,CACF,2015,NEXT GENERATION EDUC CTR INC,CHILD_SNACK_AM,22,29,0,86,115,366,0,1085,1451,65.9545
SAN DIEGO,Oct 2014,CACF,2015,NEXT GENERATION EDUC CTR INC,CHILD_SNACK_PM,22,29,0,86,115,261,0,774,1035,47.0455
SAN DIEGO,Oct 2014,CACF,2015,NEXT GENERATION EDUC CTR INC,OSCH_CHILD_BREAKFAST,22,15,0,5,20,62,0,21,83,3.7727
SAN DIEGO,Oct 2014,CACF,2015,NEXT GENERATION EDUC CTR INC,OSCH_CHILD_LUNCH,22,15,0,5,20,8,0,2,10,0.4545
SAN DIEGO,Oct 2014,CACF,2015,NEXT GENERATION EDUC CTR INC,OSCH_CHILD_SNACK_AM,22,15,0,5,20,8,0,2,10,0.4545
SAN DIEGO,Oct 2014,CACF,2015,NEXT GENERATION EDUC CTR INC,OSCH_CHILD_SNACK_PM,22,15,0,5,20,208,0,69,277,12.5909
SAN DIEGO,Nov 2014,CACF,2015,NEXT GENERATION EDUC CTR INC,CHILD_BREAKFAST,18,29,0,86,115,160,0,473,633,35.1667
SAN DIEGO,Nov 2014,CACF,2015,NEXT GENERATION EDUC CTR INC,CHILD_LUNCH,18,29,0,86,115,362,0,1075,1437,79.8333
SAN DIEGO,Nov 2014,CACF,2015,NEXT GENERATION EDUC CTR INC,CHILD_SNACK_AM,18,29,0,86,115,292,0,865,1157,64.2778
SAN DIEGO,Nov 2014,CACF,2015,NEXT GENERATION EDUC CTR INC,CHILD_SNACK_PM,18,29,0,86,115,210,0,621,831,46.1667
SAN DIEGO,Nov 2014,CACF,2015,NEXT GENERATION EDUC CTR INC,OSCH_CHILD_BREAKFAST,18,15,0,5,20,32,0,10,42,2.3333
SAN DIEGO,Nov 2014,CACF,2015,NEXT GENERATION EDUC CTR INC,OSCH_CHILD_LUNCH,18,15,0,5,20,32,0,10,42,2.3333
SAN DIEGO,Nov 2014,CACF,2015,NEXT GENERATION EDUC CTR INC,OSCH_CHILD_SNACK_AM,18,15,0,5,20,28,0,9,37,2.0556
SAN DIEGO,Nov 2014,CACF,2015,NEXT GENERATION EDUC CTR INC,OSCH_CHILD_SNACK_PM,18,15,0,5,20,140,0,47,187,10.3889
SAN DIEGO,Dec 2014,CACF,2015,NEXT GENERATION EDUC CTR INC,CHILD_BREAKFAST,22,28,8,75,111,180,51,483,714,32.4545
SAN DIEGO,Dec 2014,CACF,2015,NEXT GENERATION EDUC CTR INC,CHILD_LUNCH,22,28,8,75,111,422,120,1129,1671,75.9545
SAN DIEGO,Dec 2014,CACF,2015,NEXT GENERATION EDUC CTR INC,CHILD_SNACK_AM,22,28,8,75,111,331,95,885,1311,59.5909
SAN DIEGO,Dec 2014,CACF,2015,NEXT GENERATION EDUC CTR INC,CHILD_SNACK_PM,22,28,8,75,111,219,63,587,869,39.5
SAN DIEGO,Dec 2014,CACF,2015,NEXT GENERATION EDUC CTR INC,OSCH_CHILD_BREAKFAST,22,15,0,5,20,104,0,34,138,6.2727
SAN DIEGO,Dec 2014,CACF,2015,NEXT GENERATION EDUC CTR INC,OSCH_CHILD_LUNCH,22,15,0,5,20,71,0,23,94,4.2727
SAN DIEGO,Dec 2014,CACF,2015,NEXT GENERATION EDUC CTR INC,OSCH_CHILD_SNACK_AM,22,15,0,5,20,72,0,24,96,4.3636
SAN DIEGO,Dec 2014,CACF,2015,NEXT GENERATION EDUC CTR INC,OSCH_CHILD_SNACK_PM,22,15,0,5,20,188,0,62,250,11.3636
SAN DIEGO,Jan 2015,CACF,2015,NEXT GENERATION EDUC CTR INC,CHILD_BREAKFAST,21,25,8,71,104,164,52,466,682,32.4762
SAN DIEGO,Jan 2015,CACF,2015,NEXT GENERATION EDUC CTR INC,CHILD_LUNCH,21,25,8,71,104,340,109,964,1413,67.2857
SAN DIEGO,Jan 2015,CACF,2015,NEXT GENERATION EDUC CTR INC,CHILD_SNACK_AM,21,25,8,71,104,289,93,822,1204,57.3333
SAN DIEGO,Jan 2015,CACF,2015,NEXT GENERATION EDUC CTR INC,CHILD_SNACK_PM,21,25,8,71,104,179,57,508,744,35.4286
SAN DIEGO,Jan 2015,CACF,2015,NEXT GENERATION EDUC CTR INC,OSCH_CHILD_BREAKFAST,21,15,0,5,20,98,0,32,130,6.1905
SAN DIEGO,Jan 2015,CACF,2015,NEXT GENERATION EDUC CTR INC,OSCH_CHILD_LUNCH,21,15,0,5,20,46,0,15,61,2.9048
SAN DIEGO,Jan 2015,CACF,2015,NEXT GENERATION EDUC CTR INC,OSCH_CHILD_SNACK_AM,21,15,0,5,20,44,0,14,58,2.7619
SAN DIEGO,Jan 2015,CACF,2015,NEXT GENERATION EDUC CTR INC,OSCH_CHILD_SNACK_PM,21,15,0,5,20,162,0,54,216,10.2857
SAN DIEGO,Feb 2015,CACF,2015,NEXT GENERATION EDUC CTR INC,CHILD_BREAKFAST,19,27,7,70,104,179,46,465,690,36.3158
SAN DIEGO,Feb 2015,CACF,2015,NEXT GENERATION EDUC CTR INC,CHILD_LUNCH,19,27,7,70,104,363,94,940,1397,73.5263
SAN DIEGO,Feb 2015,CACF,2015,NEXT GENERATION EDUC CTR INC,CHILD_SNACK_AM,19,27,7,70,104,314,81,815,1210,63.6842
SAN DIEGO,Feb 2015,CACF,2015,NEXT GENERATION EDUC CTR INC,CHILD_SNACK_PM,19,27,7,70,104,179,46,464,689,36.2632
SAN DIEGO,Feb 2015,CACF,2015,NEXT GENERATION EDUC CTR INC,OSCH_CHILD_BREAKFAST,19,15,0,5,20,89,0,29,118,6.2105
SAN DIEGO,Feb 2015,CACF,2015,NEXT GENERATION EDUC CTR INC,OSCH_CHILD_LUNCH,19,15,0,5,20,9,0,3,12,0.6316
SAN DIEGO,Feb 2015,CACF,2015,NEXT GENERATION EDUC CTR INC,OSCH_CHILD_SNACK_AM,19,15,0,5,20,9,0,3,12,0.6316
SAN DIEGO,Feb 2015,CACF,2015,NEXT GENERATION EDUC CTR INC,OSCH_CHILD_SNACK_PM,19,15,0,5,20,136,0,45,181,9.5263
SAN DIEGO,Mar 2015,CACF,2015,NEXT GENERATION EDUC CTR INC,CHILD_BREAKFAST,22,27,7,70,104,320,83,828,1231,55.9545
SAN DIEGO,Mar 2015,CACF,2015,NEXT GENERATION EDUC CTR INC,CHILD_LUNCH,22,27,7,70,104,521,135,1351,2007,91.2273
SAN DIEGO,Mar 2015,CACF,2015,NEXT GENERATION EDUC CTR INC,CHILD_SNACK_AM,22,27,7,70,104,439,114,1138,1691,76.8636
SAN DIEGO,Mar 2015,CACF,2015,NEXT GENERATION EDUC CTR INC,CHILD_SNACK_PM,22,27,7,70,104,256,66,666,988,44.9091
SAN DIEGO,Mar 2015,CACF,2015,NEXT GENERATION EDUC CTR INC,OSCH_CHILD_BREAKFAST,22,15,0,5,20,84,0,28,112,5.0909
SAN DIEGO,Mar 2015,CACF,2015,NEXT GENERATION EDUC CTR INC,OSCH_CHILD_LUNCH,22,15,0,5,20,15,0,5,20,0.9091
SAN DIEGO,Mar 2015,CACF,2015,NEXT GENERATION EDUC CTR INC,OSCH_CHILD_SNACK_AM,22,15,0,5,20,15,0,5,20,0.9091
SAN DIEGO,Mar 2015,CACF,2015,NEXT GENERATION EDUC CTR INC,OSCH_CHILD_SNACK_PM,22,15,0,5,20,155,0,52,207,9.4091
SAN DIEGO,Apr 2015,CACF,2015,NEXT GENERATION EDUC CTR INC,CHILD_BREAKFAST,22,27,7,70,104,224,58,579,861,39.1364
SAN DIEGO,Apr 2015,CACF,2015,NEXT GENERATION EDUC CTR INC,CHILD_LUNCH,22,27,7,70,104,473,123,1227,1823,82.8636
SAN DIEGO,Apr 2015,CACF,2015,NEXT GENERATION EDUC CTR INC,CHILD_SNACK_AM,22,27,7,70,104,437,113,1135,1685,76.5909
SAN DIEGO,Apr 2015,CACF,2015,NEXT GENERATION EDUC CTR INC,CHILD_SNACK_PM,22,27,7,70,104,218,57,566,841,38.2273
SAN DIEGO,Apr 2015,CACF,2015,NEXT GENERATION EDUC CTR INC,OSCH_CHILD_BREAKFAST,22,15,0,5,20,92,0,30,122,5.5455
SAN DIEGO,Apr 2015,CACF,2015,NEXT GENERATION EDUC CTR INC,OSCH_CHILD_LUNCH,22,15,0,5,20,64,0,21,85,3.8636
SAN DIEGO,Apr 2015,CACF,2015,NEXT GENERATION EDUC CTR INC,OSCH_CHILD_SNACK_AM,22,15,0,5,20,54,0,18,72,3.2727
SAN DIEGO,Apr 2015,CACF,2015,NEXT GENERATION EDUC CTR INC,OSCH_CHILD_SNACK_PM,22,15,0,5,20,137,0,45,182,8.2727
SAN DIEGO,May 2015,CACF,2015,NEXT GENERATION EDUC CTR INC,CHILD_BREAKFAST,20,27,7,70,104,260,67,674,1001,50.05
SAN DIEGO,May 2015,CACF,2015,NEXT GENERATION EDUC CTR INC,CHILD_LUNCH,20,27,7,70,104,485,126,1258,1869,93.45
SAN DIEGO,May 2015,CACF,2015,NEXT GENERATION EDUC CTR INC,CHILD_SNACK_AM,20,27,7,70,104,436,113,1131,1680,84
SAN DIEGO,May 2015,CACF,2015,NEXT GENERATION EDUC CTR INC,CHILD_SNACK_PM,20,27,7,70,104,225,58,583,866,43.3
SAN DIEGO,May 2015,CACF,2015,NEXT GENERATION EDUC CTR INC,OSCH_CHILD_BREAKFAST,20,15,0,5,20,85,0,28,113,5.65
SAN DIEGO,May 2015,CACF,2015,NEXT GENERATION EDUC CTR INC,OSCH_CHILD_SNACK_PM,20,15,0,5,20,173,0,58,231,11.55
SAN DIEGO,Aug 2015,CACF,2015,NEXT GENERATION EDUC CTR INC,CHILD_BREAKFAST,21,27,7,70,104,212,55,550,817,38.9048
SAN DIEGO,Aug 2015,CACF,2015,NEXT GENERATION EDUC CTR INC,CHILD_LUNCH,21,27,7,70,104,347,90,901,1338,63.7143
SAN DIEGO,Aug 2015,CACF,2015,NEXT GENERATION EDUC CTR INC,CHILD_SNACK_AM,21,27,7,70,104,310,80,804,1194,56.8571
SAN DIEGO,Aug 2015,CACF,2015,NEXT GENERATION EDUC CTR INC,CHILD_SNACK_PM,21,27,7,70,104,232,60,600,892,42.4762
SAN DIEGO,Aug 2015,CACF,2015,NEXT GENERATION EDUC CTR INC,OSCH_CHILD_BREAKFAST,21,15,0,5,20,140,0,46,186,8.8571
SAN DIEGO,Aug 2015,CACF,2015,NEXT GENERATION EDUC CTR INC,OSCH_CHILD_LUNCH,21,15,0,5,20,215,0,71,286,13.619
SAN DIEGO,Aug 2015,CACF,2015,NEXT GENERATION EDUC CTR INC,OSCH_CHILD_SNACK_AM,21,15,0,5,20,170,0,57,227,10.8095
SAN DIEGO,Aug 2015,CACF,2015,NEXT GENERATION EDUC CTR INC,OSCH_CHILD_SNACK_PM,21,15,0,5,20,201,0,67,268,12.7619
SAN DIEGO,Sep 2015,CACF,2015,NEXT GENERATION EDUC CTR INC,CHILD_BREAKFAST,21,27,7,70,104,217,56,562,835,39.7619
SAN DIEGO,Sep 2015,CACF,2015,NEXT GENERATION EDUC CTR INC,CHILD_LUNCH,21,27,7,70,104,423,110,1095,1628,77.5238
SAN DIEGO,Sep 2015,CACF,2015,NEXT GENERATION EDUC CTR INC,CHILD_SNACK_AM,21,27,7,70,104,375,97,974,1446,68.8571
SAN DIEGO,Sep 2015,CACF,2015,NEXT GENERATION EDUC CTR INC,CHILD_SNACK_PM,21,27,7,70,104,208,54,538,800,38.0952
SAN DIEGO,Sep 2015,CACF,2015,NEXT GENERATION EDUC CTR INC,OSCH_CHILD_BREAKFAST,21,15,0,5,20,149,0,49,198,9.4286
SAN DIEGO,Sep 2015,CACF,2015,NEXT GENERATION EDUC CTR INC,OSCH_CHILD_SNACK_PM,21,15,0,5,20,281,0,93,374,17.8095
SAN DIEGO,Oct 2014,CACF,2015,NORTH COUNTY COMMUNITY SERVICE ,CHILD_BREAKFAST,23,224,126,41,391,3193,1797,584,5574,242.3478
SAN DIEGO,Oct 2014,CACF,2015,NORTH COUNTY COMMUNITY SERVICE ,CHILD_LUNCH,23,224,126,41,391,3355,1887,614,5856,254.6087
SAN DIEGO,Oct 2014,CACF,2015,NORTH COUNTY COMMUNITY SERVICE ,CHILD_SNACK_PM,23,224,126,41,391,2235,1258,409,3902,169.6522
SAN DIEGO,Nov 2014,CACF,2015,NORTH COUNTY COMMUNITY SERVICE ,CHILD_BREAKFAST,18,235,130,39,404,2401,1328,398,4127,229.2778
SAN DIEGO,Nov 2014,CACF,2015,NORTH COUNTY COMMUNITY SERVICE ,CHILD_LUNCH,18,235,130,39,404,2586,1430,429,4445,246.9444
SAN DIEGO,Nov 2014,CACF,2015,NORTH COUNTY COMMUNITY SERVICE ,CHILD_SNACK_PM,18,235,130,39,404,1697,939,282,2918,162.1111
SAN DIEGO,Dec 2014,CACF,2015,NORTH COUNTY COMMUNITY SERVICE ,CHILD_BREAKFAST,21,235,130,39,404,2497,1381,415,4293,204.4286
SAN DIEGO,Dec 2014,CACF,2015,NORTH COUNTY COMMUNITY SERVICE ,CHILD_LUNCH,21,235,130,39,404,2635,1457,437,4529,215.6667
SAN DIEGO,Dec 2014,CACF,2015,NORTH COUNTY COMMUNITY SERVICE ,CHILD_SNACK_PM,21,235,130,39,404,1908,1056,316,3280,156.1905
SAN DIEGO,Jan 2015,CACF,2015,NORTH COUNTY COMMUNITY SERVICE ,CHILD_BREAKFAST,19,235,130,39,404,2706,1497,449,4652,244.8421
SAN DIEGO,Jan 2015,CACF,2015,NORTH COUNTY COMMUNITY SERVICE ,CHILD_LUNCH,19,235,130,39,404,2914,1612,483,5009,263.6316
SAN DIEGO,Jan 2015,CACF,2015,NORTH COUNTY COMMUNITY SERVICE ,CHILD_SNACK_PM,19,235,130,39,404,2064,1142,342,3548,186.7368
SAN DIEGO,Feb 2015,CACF,2015,NORTH COUNTY COMMUNITY SERVICE ,CHILD_BREAKFAST,19,235,130,39,404,2542,1406,422,4370,230
SAN DIEGO,Feb 2015,CACF,2015,NORTH COUNTY COMMUNITY SERVICE ,CHILD_LUNCH,19,235,130,39,404,2664,1474,442,4580,241.0526
SAN DIEGO,Feb 2015,CACF,2015,NORTH COUNTY COMMUNITY SERVICE ,CHILD_SNACK_PM,19,235,130,39,404,2096,1159,348,3603,189.6316
SAN DIEGO,Mar 2015,CACF,2015,NORTH COUNTY COMMUNITY SERVICE ,CHILD_BREAKFAST,22,235,130,39,404,3226,1785,535,5546,252.0909
SAN DIEGO,Mar 2015,CACF,2015,NORTH COUNTY COMMUNITY SERVICE ,CHILD_LUNCH,22,235,130,39,404,3093,1711,514,5318,241.7273
SAN DIEGO,Mar 2015,CACF,2015,NORTH COUNTY COMMUNITY SERVICE ,CHILD_SNACK_PM,22,235,130,39,404,2761,1527,458,4746,215.7273
SAN DIEGO,Apr 2015,CACF,2015,NORTH COUNTY COMMUNITY SERVICE ,CHILD_BREAKFAST,22,235,130,39,404,3121,1726,518,5365,243.8636
SAN DIEGO,Apr 2015,CACF,2015,NORTH COUNTY COMMUNITY SERVICE ,CHILD_LUNCH,22,235,130,39,404,2967,1642,492,5101,231.8636
SAN DIEGO,Apr 2015,CACF,2015,NORTH COUNTY COMMUNITY SERVICE ,CHILD_SNACK_PM,22,235,130,39,404,2640,1460,438,4538,206.2727
SAN DIEGO,May 2015,CACF,2015,NORTH COUNTY COMMUNITY SERVICE ,CHILD_BREAKFAST,20,235,130,39,404,2873,1589,477,4939,246.95
SAN DIEGO,May 2015,CACF,2015,NORTH COUNTY COMMUNITY SERVICE ,CHILD_LUNCH,20,235,130,39,404,2615,1446,434,4495,224.75
SAN DIEGO,May 2015,CACF,2015,NORTH COUNTY COMMUNITY SERVICE ,CHILD_SNACK_PM,20,235,130,39,404,2419,1338,401,4158,207.9
SAN DIEGO,Jun 2015,CACF,2015,NORTH COUNTY COMMUNITY SERVICE ,CHILD_BREAKFAST,22,235,130,39,404,2671,1477,443,4591,208.6818
SAN DIEGO,Jun 2015,CACF,2015,NORTH COUNTY COMMUNITY SERVICE ,CHILD_LUNCH,22,235,130,39,404,2532,1400,420,4352,197.8182
SAN DIEGO,Jun 2015,CACF,2015,NORTH COUNTY COMMUNITY SERVICE ,CHILD_SNACK_PM,22,235,130,39,404,2311,1279,383,3973,180.5909
SAN DIEGO,Jul 2015,CACF,2015,NORTH COUNTY COMMUNITY SERVICE ,CHILD_BREAKFAST,22,235,130,39,404,2222,1229,369,3820,173.6364
SAN DIEGO,Jul 2015,CACF,2015,NORTH COUNTY COMMUNITY SERVICE ,CHILD_LUNCH,22,235,130,39,404,2581,1428,428,4437,201.6818
SAN DIEGO,Jul 2015,CACF,2015,NORTH COUNTY COMMUNITY SERVICE ,CHILD_SNACK_PM,22,235,130,39,404,2138,1183,354,3675,167.0455
SAN DIEGO,Aug 2015,CACF,2015,NORTH COUNTY COMMUNITY SERVICE ,CHILD_BREAKFAST,20,235,130,39,404,1999,1106,332,3437,171.85
SAN DIEGO,Aug 2015,CACF,2015,NORTH COUNTY COMMUNITY SERVICE ,CHILD_LUNCH,20,235,130,39,404,2133,1180,354,3667,183.35
SAN DIEGO,Aug 2015,CACF,2015,NORTH COUNTY COMMUNITY SERVICE ,CHILD_SNACK_PM,20,235,130,39,404,1792,991,297,3080,154
SAN DIEGO,Sep 2015,CACF,2015,NORTH COUNTY COMMUNITY SERVICE ,CHILD_BREAKFAST,21,235,130,39,404,2726,1508,453,4687,223.1905
SAN DIEGO,Sep 2015,CACF,2015,NORTH COUNTY COMMUNITY SERVICE ,CHILD_LUNCH,21,235,130,39,404,2291,1267,380,3938,187.5238
SAN DIEGO,Sep 2015,CACF,2015,NORTH COUNTY COMMUNITY SERVICE ,CHILD_SNACK_PM,21,235,130,39,404,2310,1278,383,3971,189.0952
SAN DIEGO,Oct 2014,CACF,2015,NORTH COUNTY SERENITY HOUSE INC ,CHILD_BREAKFAST,22,52,17,3,72,394,129,23,546,24.8182
SAN DIEGO,Oct 2014,CACF,2015,NORTH COUNTY SERENITY HOUSE INC ,CHILD_LUNCH,22,52,17,3,72,522,171,30,723,32.8636
SAN DIEGO,Oct 2014,CACF,2015,NORTH COUNTY SERENITY HOUSE INC ,CHILD_SNACK_PM,22,52,17,3,72,620,203,35,858,39
SAN DIEGO,Nov 2014,CACF,2015,NORTH COUNTY SERENITY HOUSE INC ,CHILD_BREAKFAST,17,52,17,3,72,457,149,27,633,37.2353
SAN DIEGO,Nov 2014,CACF,2015,NORTH COUNTY SERENITY HOUSE INC ,CHILD_LUNCH,17,52,17,3,72,641,210,37,888,52.2353
SAN DIEGO,Nov 2014,CACF,2015,NORTH COUNTY SERENITY HOUSE INC ,CHILD_SNACK_PM,17,52,17,3,72,464,152,27,643,37.8235
SAN DIEGO,Dec 2014,CACF,2015,NORTH COUNTY SERENITY HOUSE INC ,CHILD_BREAKFAST,19,52,17,3,72,485,158,28,671,35.3158
SAN DIEGO,Dec 2014,CACF,2015,NORTH COUNTY SERENITY HOUSE INC ,CHILD_LUNCH,19,52,17,3,72,679,222,39,940,49.4737
SAN DIEGO,Dec 2014,CACF,2015,NORTH COUNTY SERENITY HOUSE INC ,CHILD_SNACK_PM,19,52,17,3,72,470,154,27,651,34.2632
SAN DIEGO,Jan 2015,CACF,2015,NORTH COUNTY SERENITY HOUSE INC ,CHILD_BREAKFAST,19,52,17,3,72,515,168,30,713,37.5263
SAN DIEGO,Jan 2015,CACF,2015,NORTH COUNTY SERENITY HOUSE INC ,CHILD_LUNCH,19,52,17,3,72,698,228,41,967,50.8947
SAN DIEGO,Jan 2015,CACF,2015,NORTH COUNTY SERENITY HOUSE INC ,CHILD_SNACK_PM,19,52,17,3,72,502,164,29,695,36.5789
SAN DIEGO,Feb 2015,CACF,2015,NORTH COUNTY SERENITY HOUSE INC ,CHILD_BREAKFAST,19,52,17,3,72,554,181,32,767,40.3684
SAN DIEGO,Feb 2015,CACF,2015,NORTH COUNTY SERENITY HOUSE INC ,CHILD_LUNCH,19,52,17,3,72,703,230,41,974,51.2632
SAN DIEGO,Feb 2015,CACF,2015,NORTH COUNTY SERENITY HOUSE INC ,CHILD_SNACK_PM,19,52,17,3,72,508,166,29,703,37
SAN DIEGO,Mar 2015,CACF,2015,NORTH COUNTY SERENITY HOUSE INC ,CHILD_BREAKFAST,22,52,17,3,72,620,203,35,858,39
SAN DIEGO,Mar 2015,CACF,2015,NORTH COUNTY SERENITY HOUSE INC ,CHILD_LUNCH,22,52,17,3,72,832,272,48,1152,52.3636
SAN DIEGO,Mar 2015,CACF,2015,NORTH COUNTY SERENITY HOUSE INC ,CHILD_SNACK_PM,22,52,17,3,72,615,201,36,852,38.7273
SAN DIEGO,Apr 2015,CACF,2015,NORTH COUNTY SERENITY HOUSE INC ,CHILD_BREAKFAST,22,52,17,3,72,702,229,41,972,44.1818
SAN DIEGO,Apr 2015,CACF,2015,NORTH COUNTY SERENITY HOUSE INC ,CHILD_LUNCH,22,52,17,3,72,924,302,54,1280,58.1818
SAN DIEGO,Apr 2015,CACF,2015,NORTH COUNTY SERENITY HOUSE INC ,CHILD_SNACK_PM,22,52,17,3,72,659,216,38,913,41.5
SAN DIEGO,May 2015,CACF,2015,NORTH COUNTY SERENITY HOUSE INC ,CHILD_BREAKFAST,20,52,17,3,72,666,218,38,922,46.1
SAN DIEGO,May 2015,CACF,2015,NORTH COUNTY SERENITY HOUSE INC ,CHILD_LUNCH,20,52,17,3,72,862,282,50,1194,59.7
SAN DIEGO,May 2015,CACF,2015,NORTH COUNTY SERENITY HOUSE INC ,CHILD_SNACK_PM,20,52,17,3,72,612,200,36,848,42.4
SAN DIEGO,Jun 2015,CACF,2015,NORTH COUNTY SERENITY HOUSE INC ,CHILD_BREAKFAST,22,52,17,3,72,662,216,38,916,41.6364
SAN DIEGO,Jun 2015,CACF,2015,NORTH COUNTY SERENITY HOUSE INC ,CHILD_LUNCH,22,52,17,3,72,864,283,50,1197,54.4091
SAN DIEGO,Jun 2015,CACF,2015,NORTH COUNTY SERENITY HOUSE INC ,CHILD_SNACK_PM,22,52,17,3,72,624,204,36,864,39.2727
SAN DIEGO,Jul 2015,CACF,2015,NORTH COUNTY SERENITY HOUSE INC ,CHILD_BREAKFAST,21,52,17,3,72,508,166,30,704,33.5238
SAN DIEGO,Jul 2015,CACF,2015,NORTH COUNTY SERENITY HOUSE INC ,CHILD_LUNCH,21,52,17,3,72,703,230,41,974,46.381
SAN DIEGO,Jul 2015,CACF,2015,NORTH COUNTY SERENITY HOUSE INC ,CHILD_SNACK_PM,21,52,17,3,72,545,178,31,754,35.9048
SAN DIEGO,Aug 2015,CACF,2015,NORTH COUNTY SERENITY HOUSE INC ,CHILD_BREAKFAST,21,52,17,3,72,519,170,29,718,34.1905
SAN DIEGO,Aug 2015,CACF,2015,NORTH COUNTY SERENITY HOUSE INC ,CHILD_LUNCH,21,52,17,3,72,669,219,38,926,44.0952
SAN DIEGO,Aug 2015,CACF,2015,NORTH COUNTY SERENITY HOUSE INC ,CHILD_SNACK_PM,21,52,17,3,72,480,157,28,665,31.6667
SAN DIEGO,Sep 2015,CACF,2015,NORTH COUNTY SERENITY HOUSE INC ,CHILD_BREAKFAST,21,52,17,3,72,560,183,32,775,36.9048
SAN DIEGO,Sep 2015,CACF,2015,NORTH COUNTY SERENITY HOUSE INC ,CHILD_LUNCH,21,52,17,3,72,707,231,41,979,46.619
SAN DIEGO,Sep 2015,CACF,2015,NORTH COUNTY SERENITY HOUSE INC ,CHILD_SNACK_PM,21,52,17,3,72,530,173,31,734,34.9524
SAN DIEGO,Oct 2014,CACF,2015,OAK TREE ACADEMY LLC,CHILD_BREAKFAST,23,30,4,29,63,396,53,383,832,36.1739
SAN DIEGO,Oct 2014,CACF,2015,OAK TREE ACADEMY LLC,CHILD_LUNCH,23,30,4,29,63,464,62,448,974,42.3478
SAN DIEGO,Oct 2014,CACF,2015,OAK TREE ACADEMY LLC,CHILD_SNACK_PM,23,30,4,29,63,402,54,388,844,36.6957
SAN DIEGO,Nov 2014,CACF,2015,OAK TREE ACADEMY LLC,CHILD_BREAKFAST,17,29,4,27,60,273,38,253,564,33.1765
SAN DIEGO,Nov 2014,CACF,2015,OAK TREE ACADEMY LLC,CHILD_LUNCH,17,29,4,27,60,357,49,332,738,43.4118
SAN DIEGO,Nov 2014,CACF,2015,OAK TREE ACADEMY LLC,CHILD_SNACK_PM,17,29,4,27,60,310,43,288,641,37.7059
SAN DIEGO,Dec 2014,CACF,2015,OAK TREE ACADEMY LLC,CHILD_BREAKFAST,21,35,5,28,68,361,52,288,701,33.381
SAN DIEGO,Dec 2014,CACF,2015,OAK TREE ACADEMY LLC,CHILD_LUNCH,21,35,5,28,68,456,65,364,885,42.1429
SAN DIEGO,Dec 2014,CACF,2015,OAK TREE ACADEMY LLC,CHILD_SNACK_PM,21,35,5,28,68,398,57,319,774,36.8571
SAN DIEGO,Jan 2015,CACF,2015,OAK TREE ACADEMY LLC,CHILD_BREAKFAST,19,34,3,23,60,352,31,239,622,32.7368
SAN DIEGO,Jan 2015,CACF,2015,OAK TREE ACADEMY LLC,CHILD_LUNCH,19,34,3,23,60,439,39,296,774,40.7368
SAN DIEGO,Jan 2015,CACF,2015,OAK TREE ACADEMY LLC,CHILD_SNACK_PM,19,34,3,23,60,392,35,264,691,36.3684
SAN DIEGO,Feb 2015,CACF,2015,OAK TREE ACADEMY LLC,CHILD_BREAKFAST,19,35,3,23,61,383,33,252,668,35.1579
SAN DIEGO,Feb 2015,CACF,2015,OAK TREE ACADEMY LLC,CHILD_LUNCH,19,35,3,23,61,490,42,322,854,44.9474
SAN DIEGO,Feb 2015,CACF,2015,OAK TREE ACADEMY LLC,CHILD_SNACK_PM,19,35,3,23,61,401,34,264,699,36.7895
SAN DIEGO,Mar 2015,CACF,2015,OAK TREE ACADEMY LLC,CHILD_BREAKFAST,22,36,3,21,60,416,35,243,694,31.5455
SAN DIEGO,Mar 2015,CACF,2015,OAK TREE ACADEMY LLC,CHILD_LUNCH,22,36,3,21,60,526,44,307,877,39.8636
SAN DIEGO,Mar 2015,CACF,2015,OAK TREE ACADEMY LLC,CHILD_SNACK_PM,22,36,3,21,60,437,36,255,728,33.0909
SAN DIEGO,Apr 2015,CACF,2015,OAK TREE ACADEMY LLC,CHILD_BREAKFAST,22,37,3,22,62,427,35,254,716,32.5455
SAN DIEGO,Apr 2015,CACF,2015,OAK TREE ACADEMY LLC,CHILD_LUNCH,22,37,3,22,62,540,44,321,905,41.1364
SAN DIEGO,Apr 2015,CACF,2015,OAK TREE ACADEMY LLC,CHILD_SNACK_PM,22,37,3,22,62,423,34,252,709,32.2273
SAN DIEGO,May 2015,CACF,2015,OAK TREE ACADEMY LLC,CHILD_BREAKFAST,20,30,3,25,58,373,37,311,721,36.05
SAN DIEGO,May 2015,CACF,2015,OAK TREE ACADEMY LLC,CHILD_LUNCH,20,30,3,25,58,444,44,370,858,42.9
SAN DIEGO,May 2015,CACF,2015,OAK TREE ACADEMY LLC,CHILD_SNACK_PM,20,30,3,25,58,371,37,310,718,35.9
SAN DIEGO,Jun 2015,CACF,2015,OAK TREE ACADEMY LLC,CHILD_BREAKFAST,22,27,3,23,53,311,35,265,611,27.7727
SAN DIEGO,Jun 2015,CACF,2015,OAK TREE ACADEMY LLC,CHILD_LUNCH,22,27,3,23,53,421,47,358,826,37.5455
SAN DIEGO,Jun 2015,CACF,2015,OAK TREE ACADEMY LLC,CHILD_SNACK_PM,22,27,3,23,53,347,39,295,681,30.9545
SAN DIEGO,Jul 2015,CACF,2015,OAK TREE ACADEMY LLC,CHILD_BREAKFAST,21,27,3,28,58,310,34,323,667,31.7619
SAN DIEGO,Jul 2015,CACF,2015,OAK TREE ACADEMY LLC,CHILD_LUNCH,21,27,3,28,58,405,45,419,869,41.381
SAN DIEGO,Jul 2015,CACF,2015,OAK TREE ACADEMY LLC,CHILD_SNACK_PM,21,27,3,28,58,347,39,359,745,35.4762
SAN DIEGO,Aug 2015,CACF,2015,OAK TREE ACADEMY LLC,CHILD_BREAKFAST,21,33,1,20,54,345,10,210,565,26.9048
SAN DIEGO,Aug 2015,CACF,2015,OAK TREE ACADEMY LLC,CHILD_LUNCH,21,33,1,20,54,453,14,274,741,35.2857
SAN DIEGO,Aug 2015,CACF,2015,OAK TREE ACADEMY LLC,CHILD_SNACK_PM,21,33,1,20,54,410,12,249,671,31.9524
SAN DIEGO,Sep 2015,CACF,2015,OAK TREE ACADEMY LLC,CHILD_BREAKFAST,21,36,2,27,65,395,22,297,714,34
SAN DIEGO,Sep 2015,CACF,2015,OAK TREE ACADEMY LLC,CHILD_LUNCH,21,36,2,27,65,541,30,405,976,46.4762
SAN DIEGO,Sep 2015,CACF,2015,OAK TREE ACADEMY LLC,CHILD_SNACK_PM,21,36,2,27,65,451,25,339,815,38.8095
SAN DIEGO,Oct 2014,CACF,2015,OCEAN BEACH CHILD CARE PROJECT CHILDRENS CIRCLE,CHILD_BREAKFAST,21,33,7,0,40,511,108,0,619,29.4762
SAN DIEGO,Oct 2014,CACF,2015,OCEAN BEACH CHILD CARE PROJECT CHILDRENS CIRCLE,CHILD_LUNCH,21,33,7,0,40,655,139,0,794,37.8095
SAN DIEGO,Oct 2014,CACF,2015,OCEAN BEACH CHILD CARE PROJECT CHILDRENS CIRCLE,CHILD_SNACK_PM,21,33,7,0,40,585,124,0,709,33.7619
SAN DIEGO,Nov 2014,CACF,2015,OCEAN BEACH CHILD CARE PROJECT CHILDRENS CIRCLE,CHILD_BREAKFAST,18,33,7,0,40,367,78,0,445,24.7222
SAN DIEGO,Nov 2014,CACF,2015,OCEAN BEACH CHILD CARE PROJECT CHILDRENS CIRCLE,CHILD_LUNCH,18,33,7,0,40,499,106,0,605,33.6111
SAN DIEGO,Nov 2014,CACF,2015,OCEAN BEACH CHILD CARE PROJECT CHILDRENS CIRCLE,CHILD_SNACK_PM,18,33,7,0,40,441,93,0,534,29.6667
SAN DIEGO,Dec 2014,CACF,2015,OCEAN BEACH CHILD CARE PROJECT CHILDRENS CIRCLE,CHILD_BREAKFAST,15,33,7,0,40,294,62,0,356,23.7333
SAN DIEGO,Dec 2014,CACF,2015,OCEAN BEACH CHILD CARE PROJECT CHILDRENS CIRCLE,CHILD_LUNCH,15,33,7,0,40,406,86,0,492,32.8
SAN DIEGO,Dec 2014,CACF,2015,OCEAN BEACH CHILD CARE PROJECT CHILDRENS CIRCLE,CHILD_SNACK_PM,15,33,7,0,40,342,72,0,414,27.6
SAN DIEGO,Jan 2015,CACF,2015,OCEAN BEACH CHILD CARE PROJECT CHILDRENS CIRCLE,CHILD_BREAKFAST,20,33,7,0,40,376,80,0,456,22.8
SAN DIEGO,Jan 2015,CACF,2015,OCEAN BEACH CHILD CARE PROJECT CHILDRENS CIRCLE,CHILD_LUNCH,20,33,7,0,40,529,112,0,641,32.05
SAN DIEGO,Jan 2015,CACF,2015,OCEAN BEACH CHILD CARE PROJECT CHILDRENS CIRCLE,CHILD_SNACK_PM,20,33,7,0,40,462,98,0,560,28
SAN DIEGO,Feb 2015,CACF,2015,OCEAN BEACH CHILD CARE PROJECT CHILDRENS CIRCLE,CHILD_BREAKFAST,20,33,7,0,40,396,84,0,480,24
SAN DIEGO,Feb 2015,CACF,2015,OCEAN BEACH CHILD CARE PROJECT CHILDRENS CIRCLE,CHILD_LUNCH,20,33,7,0,40,537,114,0,651,32.55
SAN DIEGO,Feb 2015,CACF,2015,OCEAN BEACH CHILD CARE PROJECT CHILDRENS CIRCLE,CHILD_SNACK_PM,20,33,7,0,40,478,102,0,580,29
SAN DIEGO,Mar 2015,CACF,2015,OCEAN BEACH CHILD CARE PROJECT CHILDRENS CIRCLE,CHILD_BREAKFAST,22,33,7,0,40,403,85,0,488,22.1818
SAN DIEGO,Mar 2015,CACF,2015,OCEAN BEACH CHILD CARE PROJECT CHILDRENS CIRCLE,CHILD_LUNCH,22,33,7,0,40,576,122,0,698,31.7273
SAN DIEGO,Mar 2015,CACF,2015,OCEAN BEACH CHILD CARE PROJECT CHILDRENS CIRCLE,CHILD_SNACK_PM,22,33,7,0,40,499,106,0,605,27.5
SAN DIEGO,Apr 2015,CACF,2015,OCEAN BEACH CHILD CARE PROJECT CHILDRENS CIRCLE,CHILD_BREAKFAST,22,33,7,0,40,389,83,0,472,21.4545
SAN DIEGO,Apr 2015,CACF,2015,OCEAN BEACH CHILD CARE PROJECT CHILDRENS CIRCLE,CHILD_LUNCH,22,33,7,0,40,526,111,0,637,28.9545
SAN DIEGO,Apr 2015,CACF,2015,OCEAN BEACH CHILD CARE PROJECT CHILDRENS CIRCLE,CHILD_SNACK_PM,22,33,7,0,40,457,97,0,554,25.1818
SAN DIEGO,May 2015,CACF,2015,OCEAN BEACH CHILD CARE PROJECT CHILDRENS CIRCLE,CHILD_BREAKFAST,20,33,7,0,40,374,79,0,453,22.65
SAN DIEGO,May 2015,CACF,2015,OCEAN BEACH CHILD CARE PROJECT CHILDRENS CIRCLE,CHILD_LUNCH,20,33,7,0,40,514,109,0,623,31.15
SAN DIEGO,May 2015,CACF,2015,OCEAN BEACH CHILD CARE PROJECT CHILDRENS CIRCLE,CHILD_SNACK_PM,20,33,7,0,40,453,96,0,549,27.45
SAN DIEGO,Jun 2015,CACF,2015,OCEAN BEACH CHILD CARE PROJECT CHILDRENS CIRCLE,CHILD_BREAKFAST,22,33,7,0,40,412,88,0,500,22.7273
SAN DIEGO,Jun 2015,CACF,2015,OCEAN BEACH CHILD CARE PROJECT CHILDRENS CIRCLE,CHILD_LUNCH,22,33,7,0,40,530,113,0,643,29.2273
SAN DIEGO,Jun 2015,CACF,2015,OCEAN BEACH CHILD CARE PROJECT CHILDRENS CIRCLE,CHILD_SNACK_PM,22,33,7,0,40,465,99,0,564,25.6364
SAN DIEGO,Jul 2015,CACF,2015,OCEAN BEACH CHILD CARE PROJECT CHILDRENS CIRCLE,CHILD_BREAKFAST,23,33,7,0,40,409,87,0,496,21.5652
SAN DIEGO,Jul 2015,CACF,2015,OCEAN BEACH CHILD CARE PROJECT CHILDRENS CIRCLE,CHILD_LUNCH,23,33,7,0,40,522,111,0,633,27.5217
SAN DIEGO,Jul 2015,CACF,2015,OCEAN BEACH CHILD CARE PROJECT CHILDRENS CIRCLE,CHILD_SNACK_PM,23,33,7,0,40,463,98,0,561,24.3913
SAN DIEGO,Aug 2015,CACF,2015,OCEAN BEACH CHILD CARE PROJECT CHILDRENS CIRCLE,CHILD_BREAKFAST,21,33,7,0,40,395,84,0,479,22.8095
SAN DIEGO,Aug 2015,CACF,2015,OCEAN BEACH CHILD CARE PROJECT CHILDRENS CIRCLE,CHILD_LUNCH,21,33,7,0,40,513,109,0,622,29.619
SAN DIEGO,Aug 2015,CACF,2015,OCEAN BEACH CHILD CARE PROJECT CHILDRENS CIRCLE,CHILD_SNACK_PM,21,33,7,0,40,460,98,0,558,26.5714
SAN DIEGO,Sep 2015,CACF,2015,OCEAN BEACH CHILD CARE PROJECT CHILDRENS CIRCLE,CHILD_BREAKFAST,21,33,7,0,40,409,87,0,496,23.619
SAN DIEGO,Sep 2015,CACF,2015,OCEAN BEACH CHILD CARE PROJECT CHILDRENS CIRCLE,CHILD_LUNCH,21,33,7,0,40,529,112,0,641,30.5238
SAN DIEGO,Sep 2015,CACF,2015,OCEAN BEACH CHILD CARE PROJECT CHILDRENS CIRCLE,CHILD_SNACK_PM,21,33,7,0,40,491,104,0,595,28.3333
SAN DIEGO,Oct 2014,CACF,2015,Oceanside Unified School District,ATRISK_CHILD_SUPPER,23,1037,0,0,1037,20506,0,0,20506,891.5652
SAN DIEGO,Nov 2014,CACF,2015,Oceanside Unified School District,ATRISK_CHILD_SUPPER,14,1025,0,0,1025,12284,0,0,12284,877.4286
SAN DIEGO,Dec 2014,CACF,2015,Oceanside Unified School District,ATRISK_CHILD_SUPPER,15,1236,0,0,1236,13836,0,0,13836,922.4
SAN DIEGO,Jan 2015,CACF,2015,Oceanside Unified School District,ATRISK_CHILD_SUPPER,19,1260,0,0,1260,17592,0,0,17592,925.8947
SAN DIEGO,Feb 2015,CACF,2015,Oceanside Unified School District,ATRISK_CHILD_SUPPER,15,1262,0,0,1262,13590,0,0,13590,906
SAN DIEGO,Mar 2015,CACF,2015,Oceanside Unified School District,ATRISK_CHILD_SUPPER,22,1275,0,0,1275,19685,0,0,19685,894.7727
SAN DIEGO,Apr 2015,CACF,2015,Oceanside Unified School District,ATRISK_CHILD_SUPPER,17,1247,0,0,1247,15031,0,0,15031,884.1765
SAN DIEGO,May 2015,CACF,2015,Oceanside Unified School District,ATRISK_CHILD_SUPPER,20,1298,0,0,1298,16121,0,0,16121,806.05
SAN DIEGO,Jun 2015,CACF,2015,Oceanside Unified School District,ATRISK_CHILD_SUPPER,4,1283,0,0,1283,2243,0,0,2243,560.75
SAN DIEGO,Aug 2015,CACF,2015,Oceanside Unified School District,ATRISK_CHILD_SUPPER,11,1041,0,0,1041,7353,0,0,7353,668.4545
SAN DIEGO,Sep 2015,CACF,2015,Oceanside Unified School District,ATRISK_CHILD_SUPPER,21,1134,0,0,1134,19617,0,0,19617,934.1429
SAN DIEGO,Oct 2014,CACF,2015,OPEN ARMS ADHC INC,ADULT_BREAKFAST,23,145,0,0,145,1060,0,0,1060,46.087
SAN DIEGO,Oct 2014,CACF,2015,OPEN ARMS ADHC INC,ADULT_LUNCH,23,145,0,0,145,1567,0,0,1567,68.1304
SAN DIEGO,Oct 2014,CACF,2015,OPEN ARMS ADHC INC,ADULT_SNACK_AM,23,145,0,0,145,509,0,0,509,22.1304
SAN DIEGO,Oct 2014,CACF,2015,OPEN ARMS ADHC INC,ADULT_SNACK_PM,23,145,0,0,145,560,0,0,560,24.3478
SAN DIEGO,Nov 2014,CACF,2015,OPEN ARMS ADHC INC,ADULT_BREAKFAST,18,145,0,0,145,811,0,0,811,45.0556
SAN DIEGO,Nov 2014,CACF,2015,OPEN ARMS ADHC INC,ADULT_LUNCH,18,145,0,0,145,1196,0,0,1196,66.4444
SAN DIEGO,Nov 2014,CACF,2015,OPEN ARMS ADHC INC,ADULT_SNACK_AM,18,145,0,0,145,386,0,0,386,21.4444
SAN DIEGO,Nov 2014,CACF,2015,OPEN ARMS ADHC INC,ADULT_SNACK_PM,18,145,0,0,145,413,0,0,413,22.9444
SAN DIEGO,Dec 2014,CACF,2015,OPEN ARMS ADHC INC,ADULT_BREAKFAST,21,145,0,0,145,860,0,0,860,40.9524
SAN DIEGO,Dec 2014,CACF,2015,OPEN ARMS ADHC INC,ADULT_LUNCH,21,145,0,0,145,1350,0,0,1350,64.2857
SAN DIEGO,Dec 2014,CACF,2015,OPEN ARMS ADHC INC,ADULT_SNACK_AM,21,145,0,0,145,491,0,0,491,23.381
SAN DIEGO,Dec 2014,CACF,2015,OPEN ARMS ADHC INC,ADULT_SNACK_PM,21,145,0,0,145,516,0,0,516,24.5714
SAN DIEGO,Jan 2015,CACF,2015,OPEN ARMS ADHC INC,ADULT_BREAKFAST,20,168,0,0,168,763,0,0,763,38.15
SAN DIEGO,Jan 2015,CACF,2015,OPEN ARMS ADHC INC,ADULT_LUNCH,20,168,0,0,168,1196,0,0,1196,59.8
SAN DIEGO,Jan 2015,CACF,2015,OPEN ARMS ADHC INC,ADULT_SNACK_AM,20,168,0,0,168,436,0,0,436,21.8
SAN DIEGO,Jan 2015,CACF,2015,OPEN ARMS ADHC INC,ADULT_SNACK_PM,20,168,0,0,168,450,0,0,450,22.5
SAN DIEGO,Feb 2015,CACF,2015,OPEN ARMS ADHC INC,ADULT_BREAKFAST,20,168,0,0,168,1307,0,0,1307,65.35
SAN DIEGO,Feb 2015,CACF,2015,OPEN ARMS ADHC INC,ADULT_LUNCH,20,168,0,0,168,1307,0,0,1307,65.35
SAN DIEGO,Feb 2015,CACF,2015,OPEN ARMS ADHC INC,ADULT_SNACK_PM,20,168,0,0,168,471,0,0,471,23.55
SAN DIEGO,Mar 2015,CACF,2015,OPEN ARMS ADHC INC,ADULT_BREAKFAST,22,167,0,0,167,1376,0,0,1376,62.5455
SAN DIEGO,Mar 2015,CACF,2015,OPEN ARMS ADHC INC,ADULT_LUNCH,22,167,0,0,167,1376,0,0,1376,62.5455
SAN DIEGO,Mar 2015,CACF,2015,OPEN ARMS ADHC INC,ADULT_SNACK_PM,22,167,0,0,167,480,0,0,480,21.8182
SAN DIEGO,Apr 2015,CACF,2015,OPEN ARMS ADHC INC,ADULT_BREAKFAST,22,166,0,0,166,1414,0,0,1414,64.2727
SAN DIEGO,Apr 2015,CACF,2015,OPEN ARMS ADHC INC,ADULT_LUNCH,22,166,0,0,166,1412,0,0,1412,64.1818
SAN DIEGO,Apr 2015,CACF,2015,OPEN ARMS ADHC INC,ADULT_SNACK_PM,22,166,0,0,166,566,0,0,566,25.7273
SAN DIEGO,May 2015,CACF,2015,OPEN ARMS ADHC INC,ADULT_BREAKFAST,21,164,0,0,164,1384,0,0,1384,65.9048
SAN DIEGO,May 2015,CACF,2015,OPEN ARMS ADHC INC,ADULT_LUNCH,21,164,0,0,164,1380,0,0,1380,65.7143
SAN DIEGO,May 2015,CACF,2015,OPEN ARMS ADHC INC,ADULT_SNACK_PM,21,164,0,0,164,561,0,0,561,26.7143
SAN DIEGO,Jun 2015,CACF,2015,OPEN ARMS ADHC INC,ADULT_BREAKFAST,22,164,0,0,164,1437,0,0,1437,65.3182
SAN DIEGO,Jun 2015,CACF,2015,OPEN ARMS ADHC INC,ADULT_LUNCH,22,164,0,0,164,1437,0,0,1437,65.3182
SAN DIEGO,Jun 2015,CACF,2015,OPEN ARMS ADHC INC,ADULT_SNACK_PM,22,164,0,0,164,604,0,0,604,27.4545
SAN DIEGO,Jul 2015,CACF,2015,OPEN ARMS ADHC INC,ADULT_BREAKFAST,23,162,0,0,162,1603,0,0,1603,69.6957
SAN DIEGO,Jul 2015,CACF,2015,OPEN ARMS ADHC INC,ADULT_LUNCH,23,162,0,0,162,1260,0,0,1260,54.7826
SAN DIEGO,Jul 2015,CACF,2015,OPEN ARMS ADHC INC,ADULT_SNACK_PM,23,162,0,0,162,695,0,0,695,30.2174
SAN DIEGO,Aug 2015,CACF,2015,OPEN ARMS ADHC INC,ADULT_BREAKFAST,21,163,0,0,163,1426,0,0,1426,67.9048
SAN DIEGO,Aug 2015,CACF,2015,OPEN ARMS ADHC INC,ADULT_LUNCH,21,163,0,0,163,1407,0,0,1407,67
SAN DIEGO,Aug 2015,CACF,2015,OPEN ARMS ADHC INC,ADULT_SNACK_PM,21,163,0,0,163,612,0,0,612,29.1429
SAN DIEGO,Sep 2015,CACF,2015,OPEN ARMS ADHC INC,ADULT_BREAKFAST,21,158,0,0,158,1415,0,0,1415,67.381
SAN DIEGO,Sep 2015,CACF,2015,OPEN ARMS ADHC INC,ADULT_LUNCH,21,158,0,0,158,1414,0,0,1414,67.3333
SAN DIEGO,Sep 2015,CACF,2015,OPEN ARMS ADHC INC,ADULT_SNACK_PM,21,158,0,0,158,627,0,0,627,29.8571
SAN DIEGO,Oct 2014,CACF,2015,PALOMAR COMMUNITY COLLEGE DISTRICT CDC,CHILD_BREAKFAST,23,76,19,71,166,778,195,726,1699,73.8696
SAN DIEGO,Oct 2014,CACF,2015,PALOMAR COMMUNITY COLLEGE DISTRICT CDC,CHILD_LUNCH,23,76,19,71,166,558,139,521,1218,52.9565
SAN DIEGO,Oct 2014,CACF,2015,PALOMAR COMMUNITY COLLEGE DISTRICT CDC,CHILD_SNACK_PM,23,76,19,71,166,762,191,712,1665,72.3913
SAN DIEGO,Nov 2014,CACF,2015,PALOMAR COMMUNITY COLLEGE DISTRICT CDC,CHILD_BREAKFAST,17,76,19,71,166,576,144,539,1259,74.0588
SAN DIEGO,Nov 2014,CACF,2015,PALOMAR COMMUNITY COLLEGE DISTRICT CDC,CHILD_LUNCH,17,76,19,71,166,405,101,379,885,52.0588
SAN DIEGO,Nov 2014,CACF,2015,PALOMAR COMMUNITY COLLEGE DISTRICT CDC,CHILD_SNACK_PM,17,76,19,71,166,552,138,515,1205,70.8824
SAN DIEGO,Dec 2014,CACF,2015,PALOMAR COMMUNITY COLLEGE DISTRICT CDC,CHILD_BREAKFAST,15,76,19,71,166,518,130,484,1132,75.4667
SAN DIEGO,Dec 2014,CACF,2015,PALOMAR COMMUNITY COLLEGE DISTRICT CDC,CHILD_LUNCH,15,76,19,71,166,380,95,356,831,55.4
SAN DIEGO,Dec 2014,CACF,2015,PALOMAR COMMUNITY COLLEGE DISTRICT CDC,CHILD_SNACK_PM,15,76,19,71,166,523,131,488,1142,76.1333
SAN DIEGO,Jan 2015,CACF,2015,PALOMAR COMMUNITY COLLEGE DISTRICT CDC,CHILD_BREAKFAST,19,76,19,71,166,650,163,607,1420,74.7368
SAN DIEGO,Jan 2015,CACF,2015,PALOMAR COMMUNITY COLLEGE DISTRICT CDC,CHILD_LUNCH,19,76,19,71,166,470,118,439,1027,54.0526
SAN DIEGO,Jan 2015,CACF,2015,PALOMAR COMMUNITY COLLEGE DISTRICT CDC,CHILD_SNACK_PM,19,76,19,71,166,683,171,638,1492,78.5263
SAN DIEGO,Feb 2015,CACF,2015,PALOMAR COMMUNITY COLLEGE DISTRICT CDC,CHILD_BREAKFAST,18,76,19,71,166,662,166,618,1446,80.3333
SAN DIEGO,Feb 2015,CACF,2015,PALOMAR COMMUNITY COLLEGE DISTRICT CDC,CHILD_LUNCH,18,76,19,71,166,494,123,461,1078,59.8889
SAN DIEGO,Feb 2015,CACF,2015,PALOMAR COMMUNITY COLLEGE DISTRICT CDC,CHILD_SNACK_PM,18,76,19,71,166,692,173,647,1512,84
SAN DIEGO,Mar 2015,CACF,2015,PALOMAR COMMUNITY COLLEGE DISTRICT CDC,CHILD_BREAKFAST,17,76,19,71,166,672,168,628,1468,86.3529
SAN DIEGO,Mar 2015,CACF,2015,PALOMAR COMMUNITY COLLEGE DISTRICT CDC,CHILD_LUNCH,17,76,19,71,166,487,122,454,1063,62.5294
SAN DIEGO,Mar 2015,CACF,2015,PALOMAR COMMUNITY COLLEGE DISTRICT CDC,CHILD_SNACK_PM,17,76,19,71,166,678,169,633,1480,87.0588
SAN DIEGO,Apr 2015,CACF,2015,PALOMAR COMMUNITY COLLEGE DISTRICT CDC,CHILD_BREAKFAST,22,76,19,71,166,856,214,799,1869,84.9545
SAN DIEGO,Apr 2015,CACF,2015,PALOMAR COMMUNITY COLLEGE DISTRICT CDC,CHILD_LUNCH,22,76,19,71,166,603,151,563,1317,59.8636
SAN DIEGO,Apr 2015,CACF,2015,PALOMAR COMMUNITY COLLEGE DISTRICT CDC,CHILD_SNACK_PM,22,76,19,71,166,819,205,766,1790,81.3636
SAN DIEGO,May 2015,CACF,2015,PALOMAR COMMUNITY COLLEGE DISTRICT CDC,CHILD_BREAKFAST,20,76,19,71,166,719,180,672,1571,78.55
SAN DIEGO,May 2015,CACF,2015,PALOMAR COMMUNITY COLLEGE DISTRICT CDC,CHILD_LUNCH,20,76,19,71,166,505,126,473,1104,55.2
SAN DIEGO,May 2015,CACF,2015,PALOMAR COMMUNITY COLLEGE DISTRICT CDC,CHILD_SNACK_PM,20,76,19,71,166,727,182,680,1589,79.45
SAN DIEGO,Jun 2015,CACF,2015,PALOMAR COMMUNITY COLLEGE DISTRICT CDC,CHILD_BREAKFAST,21,76,19,71,166,651,163,608,1422,67.7143
SAN DIEGO,Jun 2015,CACF,2015,PALOMAR COMMUNITY COLLEGE DISTRICT CDC,CHILD_LUNCH,21,76,19,71,166,456,114,427,997,47.4762
SAN DIEGO,Jun 2015,CACF,2015,PALOMAR COMMUNITY COLLEGE DISTRICT CDC,CHILD_SNACK_PM,21,76,19,71,166,698,175,652,1525,72.619
SAN DIEGO,Jul 2015,CACF,2015,PALOMAR COMMUNITY COLLEGE DISTRICT CDC,CHILD_BREAKFAST,22,76,19,71,166,660,165,616,1441,65.5
SAN DIEGO,Jul 2015,CACF,2015,PALOMAR COMMUNITY COLLEGE DISTRICT CDC,CHILD_LUNCH,22,76,19,71,166,480,120,449,1049,47.6818
SAN DIEGO,Jul 2015,CACF,2015,PALOMAR COMMUNITY COLLEGE DISTRICT CDC,CHILD_SNACK_PM,22,76,19,71,166,567,142,530,1239,56.3182
SAN DIEGO,Aug 2015,CACF,2015,PALOMAR COMMUNITY COLLEGE DISTRICT CDC,CHILD_BREAKFAST,20,76,19,71,166,650,162,607,1419,70.95
SAN DIEGO,Aug 2015,CACF,2015,PALOMAR COMMUNITY COLLEGE DISTRICT CDC,CHILD_LUNCH,20,76,19,71,166,472,118,440,1030,51.5
SAN DIEGO,Aug 2015,CACF,2015,PALOMAR COMMUNITY COLLEGE DISTRICT CDC,CHILD_SNACK_PM,20,76,19,71,166,591,148,553,1292,64.6
SAN DIEGO,Sep 2015,CACF,2015,PALOMAR COMMUNITY COLLEGE DISTRICT CDC,CHILD_BREAKFAST,21,76,19,71,166,808,202,755,1765,84.0476
SAN DIEGO,Sep 2015,CACF,2015,PALOMAR COMMUNITY COLLEGE DISTRICT CDC,CHILD_LUNCH,21,76,19,71,166,599,150,559,1308,62.2857
SAN DIEGO,Sep 2015,CACF,2015,PALOMAR COMMUNITY COLLEGE DISTRICT CDC,CHILD_SNACK_PM,21,76,19,71,166,708,177,661,1546,73.619
SAN DIEGO,Oct 2014,CACF,2015,POWAY ADHC CENTER ,ADULT_BREAKFAST,23,142,0,26,168,1219,0,223,1442,62.6957
SAN DIEGO,Oct 2014,CACF,2015,POWAY ADHC CENTER ,ADULT_LUNCH,23,142,0,26,168,1444,0,264,1708,74.2609
SAN DIEGO,Oct 2014,CACF,2015,POWAY ADHC CENTER ,ADULT_SNACK_PM,23,142,0,26,168,151,0,28,179,7.7826
SAN DIEGO,Nov 2014,CACF,2015,POWAY ADHC CENTER ,ADULT_BREAKFAST,19,142,0,26,168,937,0,172,1109,58.3684
SAN DIEGO,Nov 2014,CACF,2015,POWAY ADHC CENTER ,ADULT_LUNCH,19,142,0,26,168,1144,0,210,1354,71.2632
SAN DIEGO,Nov 2014,CACF,2015,POWAY ADHC CENTER ,ADULT_SNACK_PM,19,142,0,26,168,132,0,24,156,8.2105
SAN DIEGO,Dec 2014,CACF,2015,POWAY ADHC CENTER ,ADULT_BREAKFAST,19,142,0,26,168,1002,0,183,1185,62.3684
SAN DIEGO,Dec 2014,CACF,2015,POWAY ADHC CENTER ,ADULT_LUNCH,19,142,0,26,168,1195,0,219,1414,74.4211
SAN DIEGO,Dec 2014,CACF,2015,POWAY ADHC CENTER ,ADULT_SNACK_PM,19,142,0,26,168,131,0,24,155,8.1579
SAN DIEGO,Jan 2015,CACF,2015,POWAY ADHC CENTER ,ADULT_BREAKFAST,21,142,0,26,168,1026,0,188,1214,57.8095
SAN DIEGO,Jan 2015,CACF,2015,POWAY ADHC CENTER ,ADULT_LUNCH,21,142,0,26,168,1256,0,230,1486,70.7619
SAN DIEGO,Feb 2015,CACF,2015,POWAY ADHC CENTER ,ADULT_BREAKFAST,20,142,0,26,168,981,0,180,1161,58.05
SAN DIEGO,Feb 2015,CACF,2015,POWAY ADHC CENTER ,ADULT_LUNCH,20,142,0,26,168,1201,0,220,1421,71.05
SAN DIEGO,Feb 2015,CACF,2015,POWAY ADHC CENTER ,ADULT_SNACK_PM,20,142,0,26,168,128,0,23,151,7.55
SAN DIEGO,Mar 2015,CACF,2015,POWAY ADHC CENTER ,ADULT_BREAKFAST,22,142,0,26,168,1191,0,218,1409,64.0455
SAN DIEGO,Mar 2015,CACF,2015,POWAY ADHC CENTER ,ADULT_LUNCH,22,142,0,26,168,1473,0,270,1743,79.2273
SAN DIEGO,Mar 2015,CACF,2015,POWAY ADHC CENTER ,ADULT_SNACK_PM,22,142,0,26,168,162,0,30,192,8.7273
SAN DIEGO,Apr 2015,CACF,2015,POWAY ADHC CENTER ,ADULT_BREAKFAST,22,142,0,26,168,1086,0,199,1285,58.4091
SAN DIEGO,Apr 2015,CACF,2015,POWAY ADHC CENTER ,ADULT_LUNCH,22,142,0,26,168,1400,0,257,1657,75.3182
SAN DIEGO,Apr 2015,CACF,2015,POWAY ADHC CENTER ,ADULT_SNACK_PM,22,142,0,26,168,156,0,29,185,8.4091
SAN DIEGO,May 2015,CACF,2015,POWAY ADHC CENTER ,ADULT_BREAKFAST,20,142,0,26,168,947,0,173,1120,56
SAN DIEGO,May 2015,CACF,2015,POWAY ADHC CENTER ,ADULT_LUNCH,20,142,0,26,168,1214,0,222,1436,71.8
SAN DIEGO,May 2015,CACF,2015,POWAY ADHC CENTER ,ADULT_SNACK_PM,20,142,0,26,168,139,0,25,164,8.2
SAN DIEGO,Jun 2015,CACF,2015,POWAY ADHC CENTER ,ADULT_BREAKFAST,22,142,0,26,168,1035,0,189,1224,55.6364
SAN DIEGO,Jun 2015,CACF,2015,POWAY ADHC CENTER ,ADULT_LUNCH,22,142,0,26,168,1297,0,237,1534,69.7273
SAN DIEGO,Jun 2015,CACF,2015,POWAY ADHC CENTER ,ADULT_SNACK_PM,22,142,0,26,168,155,0,28,183,8.3182
SAN DIEGO,Jul 2015,CACF,2015,POWAY ADHC CENTER ,ADULT_BREAKFAST,22,142,0,26,168,1048,0,192,1240,56.3636
SAN DIEGO,Jul 2015,CACF,2015,POWAY ADHC CENTER ,ADULT_LUNCH,22,142,0,26,168,1318,0,241,1559,70.8636
SAN DIEGO,Jul 2015,CACF,2015,POWAY ADHC CENTER ,ADULT_SNACK_PM,22,142,0,26,168,207,0,38,245,11.1364
SAN DIEGO,Aug 2015,CACF,2015,POWAY ADHC CENTER ,ADULT_BREAKFAST,21,142,0,26,168,1037,0,190,1227,58.4286
SAN DIEGO,Aug 2015,CACF,2015,POWAY ADHC CENTER ,ADULT_LUNCH,21,142,0,26,168,1294,0,237,1531,72.9048
SAN DIEGO,Aug 2015,CACF,2015,POWAY ADHC CENTER ,ADULT_SNACK_PM,21,142,0,26,168,136,0,25,161,7.6667
SAN DIEGO,Sep 2015,CACF,2015,POWAY ADHC CENTER ,ADULT_BREAKFAST,21,142,0,26,168,1057,0,193,1250,59.5238
SAN DIEGO,Sep 2015,CACF,2015,POWAY ADHC CENTER ,ADULT_LUNCH,21,142,0,26,168,1251,0,229,1480,70.4762
SAN DIEGO,Sep 2015,CACF,2015,POWAY ADHC CENTER ,ADULT_SNACK_PM,21,142,0,26,168,134,0,24,158,7.5238
SAN DIEGO,Oct 2014,CACF,2015,QUALITY CHILDREN'S SERVICES ,CHILD_BREAKFAST,23,955,210,84,1249,11141,2449,981,14571,633.5217
SAN DIEGO,Oct 2014,CACF,2015,QUALITY CHILDREN'S SERVICES ,CHILD_LUNCH,23,955,210,84,1249,11392,2505,1002,14899,647.7826
SAN DIEGO,Oct 2014,CACF,2015,QUALITY CHILDREN'S SERVICES ,CHILD_SNACK_AM,23,955,210,84,1249,11901,2616,1048,15565,676.7391
SAN DIEGO,Oct 2014,CACF,2015,QUALITY CHILDREN'S SERVICES ,CHILD_SNACK_PM,23,955,210,84,1249,6361,1398,560,8319,361.6957
SAN DIEGO,Nov 2014,CACF,2015,QUALITY CHILDREN'S SERVICES ,CHILD_BREAKFAST,18,955,210,84,1249,8278,1820,728,10826,601.4444
SAN DIEGO,Nov 2014,CACF,2015,QUALITY CHILDREN'S SERVICES ,CHILD_LUNCH,18,955,210,84,1249,8791,1933,774,11498,638.7778
SAN DIEGO,Nov 2014,CACF,2015,QUALITY CHILDREN'S SERVICES ,CHILD_SNACK_AM,18,955,210,84,1249,9101,2001,801,11903,661.2778
SAN DIEGO,Nov 2014,CACF,2015,QUALITY CHILDREN'S SERVICES ,CHILD_SNACK_PM,18,955,210,84,1249,4748,1044,418,6210,345
SAN DIEGO,Dec 2014,CACF,2015,QUALITY CHILDREN'S SERVICES ,CHILD_BREAKFAST,20,955,210,84,1249,7087,1558,624,9269,463.45
SAN DIEGO,Dec 2014,CACF,2015,QUALITY CHILDREN'S SERVICES ,CHILD_LUNCH,20,955,210,84,1249,7494,1648,659,9801,490.05
SAN DIEGO,Dec 2014,CACF,2015,QUALITY CHILDREN'S SERVICES ,CHILD_SNACK_AM,20,955,210,84,1249,7796,1714,686,10196,509.8
SAN DIEGO,Dec 2014,CACF,2015,QUALITY CHILDREN'S SERVICES ,CHILD_SNACK_PM,20,955,210,84,1249,3653,803,322,4778,238.9
SAN DIEGO,Jan 2015,CACF,2015,QUALITY CHILDREN'S SERVICES ,CHILD_BREAKFAST,20,955,210,84,1249,8978,1974,790,11742,587.1
SAN DIEGO,Jan 2015,CACF,2015,QUALITY CHILDREN'S SERVICES ,CHILD_LUNCH,20,955,210,84,1249,9564,2103,842,12509,625.45
SAN DIEGO,Jan 2015,CACF,2015,QUALITY CHILDREN'S SERVICES ,CHILD_SNACK_AM,20,955,210,84,1249,9741,2142,857,12740,637
SAN DIEGO,Jan 2015,CACF,2015,QUALITY CHILDREN'S SERVICES ,CHILD_SNACK_PM,20,955,210,84,1249,5317,1169,468,6954,347.7
SAN DIEGO,Feb 2015,CACF,2015,QUALITY CHILDREN'S SERVICES ,CHILD_BREAKFAST,19,955,210,84,1249,8745,1923,770,11438,602
SAN DIEGO,Feb 2015,CACF,2015,QUALITY CHILDREN'S SERVICES ,CHILD_LUNCH,19,955,210,84,1249,9155,2013,806,11974,630.2105
SAN DIEGO,Feb 2015,CACF,2015,QUALITY CHILDREN'S SERVICES ,CHILD_SNACK_AM,19,955,210,84,1249,9498,2088,836,12422,653.7895
SAN DIEGO,Feb 2015,CACF,2015,QUALITY CHILDREN'S SERVICES ,CHILD_SNACK_PM,19,955,210,84,1249,5122,1126,451,6699,352.5789
SAN DIEGO,Mar 2015,CACF,2015,QUALITY CHILDREN'S SERVICES ,CHILD_BREAKFAST,22,955,210,84,1249,10157,2233,894,13284,603.8182
SAN DIEGO,Mar 2015,CACF,2015,QUALITY CHILDREN'S SERVICES ,CHILD_LUNCH,22,955,210,84,1249,10866,2389,956,14211,645.9545
SAN DIEGO,Mar 2015,CACF,2015,QUALITY CHILDREN'S SERVICES ,CHILD_SNACK_AM,22,955,210,84,1249,11237,2471,989,14697,668.0455
SAN DIEGO,Mar 2015,CACF,2015,QUALITY CHILDREN'S SERVICES ,CHILD_SNACK_PM,22,955,210,84,1249,5963,1311,525,7799,354.5
SAN DIEGO,Apr 2015,CACF,2015,QUALITY CHILDREN'S SERVICES ,CHILD_BREAKFAST,22,955,210,84,1249,9918,2180,873,12971,589.5909
SAN DIEGO,Apr 2015,CACF,2015,QUALITY CHILDREN'S SERVICES ,CHILD_LUNCH,22,955,210,84,1249,10798,2374,951,14123,641.9545
SAN DIEGO,Apr 2015,CACF,2015,QUALITY CHILDREN'S SERVICES ,CHILD_SNACK_AM,22,955,210,84,1249,10906,2398,960,14264,648.3636
SAN DIEGO,Apr 2015,CACF,2015,QUALITY CHILDREN'S SERVICES ,CHILD_SNACK_PM,22,955,210,84,1249,5781,1271,509,7561,343.6818
SAN DIEGO,May 2015,CACF,2015,QUALITY CHILDREN'S SERVICES ,CHILD_BREAKFAST,20,955,210,84,1249,9293,2043,818,12154,607.7
SAN DIEGO,May 2015,CACF,2015,QUALITY CHILDREN'S SERVICES ,CHILD_LUNCH,20,955,210,84,1249,9777,2149,861,12787,639.35
SAN DIEGO,May 2015,CACF,2015,QUALITY CHILDREN'S SERVICES ,CHILD_SNACK_AM,20,955,210,84,1249,10219,2247,899,13365,668.25
SAN DIEGO,May 2015,CACF,2015,QUALITY CHILDREN'S SERVICES ,CHILD_SNACK_PM,20,955,210,84,1249,5204,1144,458,6806,340.3
SAN DIEGO,Jun 2015,CACF,2015,QUALITY CHILDREN'S SERVICES ,CHILD_BREAKFAST,22,955,210,84,1249,8220,1807,724,10751,488.6818
SAN DIEGO,Jun 2015,CACF,2015,QUALITY CHILDREN'S SERVICES ,CHILD_LUNCH,22,955,210,84,1249,8979,1974,790,11743,533.7727
SAN DIEGO,Jun 2015,CACF,2015,QUALITY CHILDREN'S SERVICES ,CHILD_SNACK_AM,22,955,210,84,1249,9183,2019,808,12010,545.9091
SAN DIEGO,Jun 2015,CACF,2015,QUALITY CHILDREN'S SERVICES ,CHILD_SNACK_PM,22,955,210,84,1249,4100,901,361,5362,243.7273
SAN DIEGO,Jul 2015,CACF,2015,QUALITY CHILDREN'S SERVICES ,CHILD_BREAKFAST,22,955,210,84,1249,4125,907,363,5395,245.2273
SAN DIEGO,Jul 2015,CACF,2015,QUALITY CHILDREN'S SERVICES ,CHILD_LUNCH,22,955,210,84,1249,4812,1058,424,6294,286.0909
SAN DIEGO,Jul 2015,CACF,2015,QUALITY CHILDREN'S SERVICES ,CHILD_SNACK_AM,22,955,210,84,1249,4793,1054,422,6269,284.9545
SAN DIEGO,Aug 2015,CACF,2015,QUALITY CHILDREN'S SERVICES ,CHILD_BREAKFAST,21,955,210,84,1249,3701,814,326,4841,230.5238
SAN DIEGO,Aug 2015,CACF,2015,QUALITY CHILDREN'S SERVICES ,CHILD_LUNCH,21,955,210,84,1249,4305,946,379,5630,268.0952
SAN DIEGO,Aug 2015,CACF,2015,QUALITY CHILDREN'S SERVICES ,CHILD_SNACK_AM,21,955,210,84,1249,4255,935,375,5565,265
SAN DIEGO,Sep 2015,CACF,2015,QUALITY CHILDREN'S SERVICES ,CHILD_BREAKFAST,21,955,210,84,1249,8889,1954,783,11626,553.619
SAN DIEGO,Sep 2015,CACF,2015,QUALITY CHILDREN'S SERVICES ,CHILD_LUNCH,21,955,210,84,1249,9019,1983,794,11796,561.7143
SAN DIEGO,Sep 2015,CACF,2015,QUALITY CHILDREN'S SERVICES ,CHILD_SNACK_AM,21,955,210,84,1249,9603,2111,845,12559,598.0476
SAN DIEGO,Sep 2015,CACF,2015,QUALITY CHILDREN'S SERVICES ,CHILD_SNACK_PM,21,955,210,84,1249,4356,958,383,5697,271.2857
SAN DIEGO,Oct 2014,CACF,2015,READY SET GROW,CHILD_BREAKFAST,23,13,7,50,70,143,77,549,769,33.4348
SAN DIEGO,Oct 2014,CACF,2015,READY SET GROW,CHILD_LUNCH,23,13,7,50,70,152,82,582,816,35.4783
SAN DIEGO,Oct 2014,CACF,2015,READY SET GROW,CHILD_SNACK_PM,23,13,7,50,70,194,104,745,1043,45.3478
SAN DIEGO,Nov 2014,CACF,2015,READY SET GROW,CHILD_BREAKFAST,18,13,7,50,70,114,62,440,616,34.2222
SAN DIEGO,Nov 2014,CACF,2015,READY SET GROW,CHILD_LUNCH,18,13,7,50,70,126,68,487,681,37.8333
SAN DIEGO,Nov 2014,CACF,2015,READY SET GROW,CHILD_SNACK_PM,18,13,7,50,70,140,75,537,752,41.7778
SAN DIEGO,Dec 2014,CACF,2015,READY SET GROW,CHILD_BREAKFAST,21,13,7,50,70,133,71,510,714,34
SAN DIEGO,Dec 2014,CACF,2015,READY SET GROW,CHILD_LUNCH,21,13,7,50,70,144,77,553,774,36.8571
SAN DIEGO,Dec 2014,CACF,2015,READY SET GROW,CHILD_SNACK_PM,21,13,7,50,70,158,85,607,850,40.4762
SAN DIEGO,Jan 2015,CACF,2015,READY SET GROW,CHILD_BREAKFAST,21,13,7,50,70,124,67,476,667,31.7619
SAN DIEGO,Jan 2015,CACF,2015,READY SET GROW,CHILD_LUNCH,21,13,7,50,70,146,78,560,784,37.3333
SAN DIEGO,Jan 2015,CACF,2015,READY SET GROW,CHILD_SNACK_PM,21,13,7,50,70,162,87,623,872,41.5238
SAN DIEGO,Feb 2015,CACF,2015,READY SET GROW,CHILD_BREAKFAST,19,13,7,50,70,128,69,491,688,36.2105
SAN DIEGO,Feb 2015,CACF,2015,READY SET GROW,CHILD_LUNCH,19,13,7,50,70,141,76,540,757,39.8421
SAN DIEGO,Feb 2015,CACF,2015,READY SET GROW,CHILD_SNACK_PM,19,13,7,50,70,152,82,582,816,42.9474
SAN DIEGO,Mar 2015,CACF,2015,READY SET GROW,CHILD_BREAKFAST,22,13,7,50,70,145,78,559,782,35.5455
SAN DIEGO,Mar 2015,CACF,2015,READY SET GROW,CHILD_LUNCH,22,13,7,50,70,165,89,634,888,40.3636
SAN DIEGO,Mar 2015,CACF,2015,READY SET GROW,CHILD_SNACK_PM,22,13,7,50,70,178,96,687,961,43.6818
SAN DIEGO,Apr 2015,CACF,2015,READY SET GROW,CHILD_BREAKFAST,22,15,7,52,74,176,82,610,868,39.4545
SAN DIEGO,Apr 2015,CACF,2015,READY SET GROW,CHILD_LUNCH,22,15,7,52,74,186,87,647,920,41.8182
SAN DIEGO,Apr 2015,CACF,2015,READY SET GROW,CHILD_SNACK_PM,22,15,7,52,74,200,94,695,989,44.9545
SAN DIEGO,May 2015,CACF,2015,READY SET GROW,CHILD_BREAKFAST,20,17,7,49,73,214,88,617,919,45.95
SAN DIEGO,May 2015,CACF,2015,READY SET GROW,CHILD_LUNCH,20,17,7,49,73,201,83,580,864,43.2
SAN DIEGO,May 2015,CACF,2015,READY SET GROW,CHILD_SNACK_PM,20,17,7,49,73,240,99,690,1029,51.45
SAN DIEGO,Jun 2015,CACF,2015,READY SET GROW,CHILD_BREAKFAST,22,17,7,49,73,216,89,623,928,42.1818
SAN DIEGO,Jun 2015,CACF,2015,READY SET GROW,CHILD_LUNCH,22,17,7,49,73,224,92,644,960,43.6364
SAN DIEGO,Jun 2015,CACF,2015,READY SET GROW,CHILD_SNACK_PM,22,17,7,49,73,239,98,688,1025,46.5909
SAN DIEGO,Jul 2015,CACF,2015,READY SET GROW,CHILD_BREAKFAST,23,12,2,38,52,150,25,477,652,28.3478
SAN DIEGO,Jul 2015,CACF,2015,READY SET GROW,CHILD_LUNCH,23,12,2,38,52,163,27,517,707,30.7391
SAN DIEGO,Jul 2015,CACF,2015,READY SET GROW,CHILD_SNACK_PM,23,12,2,38,52,153,26,486,665,28.913
SAN DIEGO,Jul 2015,CACF,2015,READY SET GROW,OSCH_CHILD_BREAKFAST,23,6,0,5,11,77,0,65,142,6.1739
SAN DIEGO,Jul 2015,CACF,2015,READY SET GROW,OSCH_CHILD_LUNCH,23,6,0,5,11,93,0,78,171,7.4348
SAN DIEGO,Jul 2015,CACF,2015,READY SET GROW,OSCH_CHILD_SNACK_PM,23,6,0,5,11,87,0,73,160,6.9565
SAN DIEGO,Aug 2015,CACF,2015,READY SET GROW,CHILD_BREAKFAST,21,13,2,38,53,163,25,478,666,31.7143
SAN DIEGO,Aug 2015,CACF,2015,READY SET GROW,CHILD_LUNCH,21,13,2,38,53,165,25,484,674,32.0952
SAN DIEGO,Aug 2015,CACF,2015,READY SET GROW,CHILD_SNACK_PM,21,13,2,38,53,156,24,456,636,30.2857
SAN DIEGO,Aug 2015,CACF,2015,READY SET GROW,OSCH_CHILD_BREAKFAST,21,7,0,5,12,89,0,64,153,7.2857
SAN DIEGO,Aug 2015,CACF,2015,READY SET GROW,OSCH_CHILD_LUNCH,21,7,0,5,12,94,0,68,162,7.7143
SAN DIEGO,Aug 2015,CACF,2015,READY SET GROW,OSCH_CHILD_SNACK_PM,21,7,0,5,12,96,0,69,165,7.8571
SAN DIEGO,Sep 2015,CACF,2015,READY SET GROW,CHILD_BREAKFAST,21,13,2,38,53,173,27,504,704,33.5238
SAN DIEGO,Sep 2015,CACF,2015,READY SET GROW,CHILD_LUNCH,21,13,2,38,53,170,26,496,692,32.9524
SAN DIEGO,Sep 2015,CACF,2015,READY SET GROW,CHILD_SNACK_PM,21,13,2,38,53,179,27,522,728,34.6667
SAN DIEGO,Sep 2015,CACF,2015,READY SET GROW,OSCH_CHILD_BREAKFAST,21,7,0,5,12,30,0,21,51,2.4286
SAN DIEGO,Sep 2015,CACF,2015,READY SET GROW,OSCH_CHILD_LUNCH,21,7,0,5,12,3,0,3,6,0.2857
SAN DIEGO,Sep 2015,CACF,2015,READY SET GROW,OSCH_CHILD_SNACK_PM,21,7,0,5,12,89,0,64,153,7.2857
SAN DIEGO,Oct 2014,CACF,2015,RISING STAR ACAD CHILDCARE CTR,CHILD_BREAKFAST,23,30,1,0,31,553,18,0,571,24.8261
SAN DIEGO,Oct 2014,CACF,2015,RISING STAR ACAD CHILDCARE CTR,CHILD_LUNCH,23,30,1,0,31,552,18,0,570,24.7826
SAN DIEGO,Oct 2014,CACF,2015,RISING STAR ACAD CHILDCARE CTR,CHILD_SNACK_PM,23,30,1,0,31,645,22,0,667,29
SAN DIEGO,Nov 2014,CACF,2015,RISING STAR ACAD CHILDCARE CTR,CHILD_BREAKFAST,17,30,1,0,31,257,9,0,266,15.6471
SAN DIEGO,Nov 2014,CACF,2015,RISING STAR ACAD CHILDCARE CTR,CHILD_LUNCH,17,30,1,0,31,284,9,0,293,17.2353
SAN DIEGO,Nov 2014,CACF,2015,RISING STAR ACAD CHILDCARE CTR,CHILD_SNACK_PM,17,30,1,0,31,357,12,0,369,21.7059
SAN DIEGO,Dec 2014,CACF,2015,RISING STAR ACAD CHILDCARE CTR,CHILD_BREAKFAST,21,30,1,0,31,359,12,0,371,17.6667
SAN DIEGO,Dec 2014,CACF,2015,RISING STAR ACAD CHILDCARE CTR,CHILD_LUNCH,21,30,1,0,31,335,11,0,346,16.4762
SAN DIEGO,Dec 2014,CACF,2015,RISING STAR ACAD CHILDCARE CTR,CHILD_SNACK_PM,21,30,1,0,31,417,14,0,431,20.5238
SAN DIEGO,Oct 2014,CACF,2015,SAINT VINCENT DE PAUL VILLAGE,ES_CHILD_BREAKFAST,31,569,0,0,569,660,0,0,660,21.2903
SAN DIEGO,Oct 2014,CACF,2015,SAINT VINCENT DE PAUL VILLAGE,ES_CHILD_LUNCH,31,569,0,0,569,390,0,0,390,12.5806
SAN DIEGO,Oct 2014,CACF,2015,SAINT VINCENT DE PAUL VILLAGE,ES_CHILD_SUPPER,31,569,0,0,569,684,0,0,684,22.0645
SAN DIEGO,Nov 2014,CACF,2015,SAINT VINCENT DE PAUL VILLAGE,ES_CHILD_BREAKFAST,30,465,0,0,465,149,0,0,149,4.9667
SAN DIEGO,Nov 2014,CACF,2015,SAINT VINCENT DE PAUL VILLAGE,ES_CHILD_LUNCH,30,465,0,0,465,555,0,0,555,18.5
SAN DIEGO,Nov 2014,CACF,2015,SAINT VINCENT DE PAUL VILLAGE,ES_CHILD_SUPPER,30,465,0,0,465,602,0,0,602,20.0667
SAN DIEGO,Dec 2014,CACF,2015,SAINT VINCENT DE PAUL VILLAGE,ES_CHILD_BREAKFAST,31,322,0,0,322,525,0,0,525,16.9355
SAN DIEGO,Dec 2014,CACF,2015,SAINT VINCENT DE PAUL VILLAGE,ES_CHILD_LUNCH,31,322,0,0,322,950,0,0,950,30.6452
SAN DIEGO,Dec 2014,CACF,2015,SAINT VINCENT DE PAUL VILLAGE,ES_CHILD_SUPPER,31,322,0,0,322,509,0,0,509,16.4194
SAN DIEGO,Jan 2015,CACF,2015,SAINT VINCENT DE PAUL VILLAGE,ES_CHILD_BREAKFAST,31,610,0,0,610,1073,0,0,1073,34.6129
SAN DIEGO,Jan 2015,CACF,2015,SAINT VINCENT DE PAUL VILLAGE,ES_CHILD_LUNCH,31,610,0,0,610,1885,0,0,1885,60.8065
SAN DIEGO,Jan 2015,CACF,2015,SAINT VINCENT DE PAUL VILLAGE,ES_CHILD_SUPPER,31,610,0,0,610,1930,0,0,1930,62.2581
SAN DIEGO,Feb 2015,CACF,2015,SAINT VINCENT DE PAUL VILLAGE,ES_CHILD_BREAKFAST,28,553,0,0,553,1922,0,0,1922,68.6429
SAN DIEGO,Feb 2015,CACF,2015,SAINT VINCENT DE PAUL VILLAGE,ES_CHILD_LUNCH,28,553,0,0,553,1184,0,0,1184,42.2857
SAN DIEGO,Feb 2015,CACF,2015,SAINT VINCENT DE PAUL VILLAGE,ES_CHILD_SUPPER,28,553,0,0,553,3097,0,0,3097,110.6071
SAN DIEGO,Mar 2015,CACF,2015,SAINT VINCENT DE PAUL VILLAGE,ES_CHILD_BREAKFAST,31,358,0,0,358,1525,0,0,1525,49.1935
SAN DIEGO,Mar 2015,CACF,2015,SAINT VINCENT DE PAUL VILLAGE,ES_CHILD_LUNCH,31,358,0,0,358,1395,0,0,1395,45
SAN DIEGO,Mar 2015,CACF,2015,SAINT VINCENT DE PAUL VILLAGE,ES_CHILD_SUPPER,31,358,0,0,358,3325,0,0,3325,107.2581
SAN DIEGO,Apr 2015,CACF,2015,SAINT VINCENT DE PAUL VILLAGE,ES_CHILD_BREAKFAST,30,365,0,0,365,1630,0,0,1630,54.3333
SAN DIEGO,Apr 2015,CACF,2015,SAINT VINCENT DE PAUL VILLAGE,ES_CHILD_LUNCH,30,365,0,0,365,1766,0,0,1766,58.8667
SAN DIEGO,Apr 2015,CACF,2015,SAINT VINCENT DE PAUL VILLAGE,ES_CHILD_SUPPER,30,365,0,0,365,2622,0,0,2622,87.4
SAN DIEGO,May 2015,CACF,2015,SAINT VINCENT DE PAUL VILLAGE,ES_CHILD_BREAKFAST,31,635,0,0,635,1801,0,0,1801,58.0968
SAN DIEGO,May 2015,CACF,2015,SAINT VINCENT DE PAUL VILLAGE,ES_CHILD_LUNCH,31,635,0,0,635,1236,0,0,1236,39.871
SAN DIEGO,May 2015,CACF,2015,SAINT VINCENT DE PAUL VILLAGE,ES_CHILD_SUPPER,31,635,0,0,635,3181,0,0,3181,102.6129
SAN DIEGO,Jun 2015,CACF,2015,SAINT VINCENT DE PAUL VILLAGE,ES_CHILD_BREAKFAST,30,655,0,0,655,1544,0,0,1544,51.4667
SAN DIEGO,Jun 2015,CACF,2015,SAINT VINCENT DE PAUL VILLAGE,ES_CHILD_LUNCH,30,655,0,0,655,1453,0,0,1453,48.4333
SAN DIEGO,Jun 2015,CACF,2015,SAINT VINCENT DE PAUL VILLAGE,ES_CHILD_SUPPER,30,655,0,0,655,3247,0,0,3247,108.2333
SAN DIEGO,Jul 2015,CACF,2015,SAINT VINCENT DE PAUL VILLAGE,ES_CHILD_BREAKFAST,31,663,0,0,663,1619,0,0,1619,52.2258
SAN DIEGO,Jul 2015,CACF,2015,SAINT VINCENT DE PAUL VILLAGE,ES_CHILD_LUNCH,31,663,0,0,663,2229,0,0,2229,71.9032
SAN DIEGO,Jul 2015,CACF,2015,SAINT VINCENT DE PAUL VILLAGE,ES_CHILD_SUPPER,31,663,0,0,663,3554,0,0,3554,114.6452
SAN DIEGO,Aug 2015,CACF,2015,SAINT VINCENT DE PAUL VILLAGE,ES_CHILD_BREAKFAST,31,625,0,0,625,1739,0,0,1739,56.0968
SAN DIEGO,Aug 2015,CACF,2015,SAINT VINCENT DE PAUL VILLAGE,ES_CHILD_LUNCH,31,625,0,0,625,2198,0,0,2198,70.9032
SAN DIEGO,Aug 2015,CACF,2015,SAINT VINCENT DE PAUL VILLAGE,ES_CHILD_SUPPER,31,625,0,0,625,2346,0,0,2346,75.6774
SAN DIEGO,Sep 2015,CACF,2015,SAINT VINCENT DE PAUL VILLAGE,ES_CHILD_BREAKFAST,30,644,0,0,644,1668,0,0,1668,55.6
SAN DIEGO,Sep 2015,CACF,2015,SAINT VINCENT DE PAUL VILLAGE,ES_CHILD_LUNCH,30,644,0,0,644,1790,0,0,1790,59.6667
SAN DIEGO,Sep 2015,CACF,2015,SAINT VINCENT DE PAUL VILLAGE,ES_CHILD_SUPPER,30,644,0,0,644,2705,0,0,2705,90.1667
SAN DIEGO,Oct 2014,CACF,2015,SAN DIEGO COMMUNITY COLL DIST ,CHILD_BREAKFAST,23,47,10,9,66,637,136,122,895,38.913
SAN DIEGO,Oct 2014,CACF,2015,SAN DIEGO COMMUNITY COLL DIST ,CHILD_LUNCH,23,47,10,9,66,668,142,128,938,40.7826
SAN DIEGO,Oct 2014,CACF,2015,SAN DIEGO COMMUNITY COLL DIST ,CHILD_SNACK_PM,23,47,10,9,66,385,82,73,540,23.4783
SAN DIEGO,Oct 2014,CACF,2015,SAN DIEGO COMMUNITY COLL DIST ,HS_CHILD_BREAKFAST,23,67,0,0,67,963,0,0,963,41.8696
SAN DIEGO,Oct 2014,CACF,2015,SAN DIEGO COMMUNITY COLL DIST ,HS_CHILD_LUNCH,23,67,0,0,67,1090,0,0,1090,47.3913
SAN DIEGO,Oct 2014,CACF,2015,SAN DIEGO COMMUNITY COLL DIST ,HS_CHILD_SNACK_PM,23,67,0,0,67,631,0,0,631,27.4348
SAN DIEGO,Nov 2014,CACF,2015,SAN DIEGO COMMUNITY COLL DIST ,CHILD_BREAKFAST,14,47,10,9,66,389,83,74,546,39
SAN DIEGO,Nov 2014,CACF,2015,SAN DIEGO COMMUNITY COLL DIST ,CHILD_LUNCH,14,47,10,9,66,395,84,75,554,39.5714
SAN DIEGO,Nov 2014,CACF,2015,SAN DIEGO COMMUNITY COLL DIST ,CHILD_SNACK_PM,14,47,10,9,66,227,48,44,319,22.7857
SAN DIEGO,Nov 2014,CACF,2015,SAN DIEGO COMMUNITY COLL DIST ,HS_CHILD_BREAKFAST,14,67,0,0,67,646,0,0,646,46.1429
SAN DIEGO,Nov 2014,CACF,2015,SAN DIEGO COMMUNITY COLL DIST ,HS_CHILD_LUNCH,14,67,0,0,67,699,0,0,699,49.9286
SAN DIEGO,Nov 2014,CACF,2015,SAN DIEGO COMMUNITY COLL DIST ,HS_CHILD_SNACK_PM,14,67,0,0,67,402,0,0,402,28.7143
SAN DIEGO,Dec 2014,CACF,2015,SAN DIEGO COMMUNITY COLL DIST ,CHILD_BREAKFAST,12,47,10,9,66,339,72,65,476,39.6667
SAN DIEGO,Dec 2014,CACF,2015,SAN DIEGO COMMUNITY COLL DIST ,CHILD_LUNCH,12,47,10,9,66,348,74,67,489,40.75
SAN DIEGO,Dec 2014,CACF,2015,SAN DIEGO COMMUNITY COLL DIST ,CHILD_SNACK_PM,12,47,10,9,66,211,45,40,296,24.6667
SAN DIEGO,Dec 2014,CACF,2015,SAN DIEGO COMMUNITY COLL DIST ,HS_CHILD_BREAKFAST,12,67,0,0,67,513,0,0,513,42.75
SAN DIEGO,Dec 2014,CACF,2015,SAN DIEGO COMMUNITY COLL DIST ,HS_CHILD_LUNCH,12,67,0,0,67,588,0,0,588,49
SAN DIEGO,Dec 2014,CACF,2015,SAN DIEGO COMMUNITY COLL DIST ,HS_CHILD_SNACK_PM,12,67,0,0,67,367,0,0,367,30.5833
SAN DIEGO,Jan 2015,CACF,2015,SAN DIEGO COMMUNITY COLL DIST ,CHILD_BREAKFAST,14,47,10,9,66,189,40,37,266,19
SAN DIEGO,Jan 2015,CACF,2015,SAN DIEGO COMMUNITY COLL DIST ,CHILD_LUNCH,14,47,10,9,66,182,39,34,255,18.2143
SAN DIEGO,Jan 2015,CACF,2015,SAN DIEGO COMMUNITY COLL DIST ,CHILD_SNACK_PM,14,47,10,9,66,99,21,19,139,9.9286
SAN DIEGO,Jan 2015,CACF,2015,SAN DIEGO COMMUNITY COLL DIST ,HS_CHILD_BREAKFAST,14,67,0,0,67,318,0,0,318,22.7143
SAN DIEGO,Jan 2015,CACF,2015,SAN DIEGO COMMUNITY COLL DIST ,HS_CHILD_LUNCH,14,67,0,0,67,343,0,0,343,24.5
SAN DIEGO,Jan 2015,CACF,2015,SAN DIEGO COMMUNITY COLL DIST ,HS_CHILD_SNACK_PM,14,67,0,0,67,188,0,0,188,13.4286
SAN DIEGO,Feb 2015,CACF,2015,SAN DIEGO COMMUNITY COLL DIST ,CHILD_BREAKFAST,18,47,10,9,66,653,139,125,917,50.9444
SAN DIEGO,Feb 2015,CACF,2015,SAN DIEGO COMMUNITY COLL DIST ,CHILD_LUNCH,18,47,10,9,66,655,139,126,920,51.1111
SAN DIEGO,Feb 2015,CACF,2015,SAN DIEGO COMMUNITY COLL DIST ,CHILD_SNACK_PM,18,47,10,9,66,345,73,67,485,26.9444
SAN DIEGO,Feb 2015,CACF,2015,SAN DIEGO COMMUNITY COLL DIST ,HS_CHILD_BREAKFAST,18,67,0,0,67,877,0,0,877,48.7222
SAN DIEGO,Feb 2015,CACF,2015,SAN DIEGO COMMUNITY COLL DIST ,HS_CHILD_LUNCH,18,67,0,0,67,1009,0,0,1009,56.0556
SAN DIEGO,Feb 2015,CACF,2015,SAN DIEGO COMMUNITY COLL DIST ,HS_CHILD_SNACK_PM,18,67,0,0,67,618,0,0,618,34.3333
SAN DIEGO,Mar 2015,CACF,2015,SAN DIEGO COMMUNITY COLL DIST ,CHILD_BREAKFAST,20,47,10,9,66,758,161,146,1065,53.25
SAN DIEGO,Mar 2015,CACF,2015,SAN DIEGO COMMUNITY COLL DIST ,CHILD_LUNCH,20,47,10,9,66,776,165,149,1090,54.5
SAN DIEGO,Mar 2015,CACF,2015,SAN DIEGO COMMUNITY COLL DIST ,CHILD_SNACK_PM,20,47,10,9,66,432,92,83,607,30.35
SAN DIEGO,Mar 2015,CACF,2015,SAN DIEGO COMMUNITY COLL DIST ,HS_CHILD_BREAKFAST,20,67,0,0,67,919,0,0,919,45.95
SAN DIEGO,Mar 2015,CACF,2015,SAN DIEGO COMMUNITY COLL DIST ,HS_CHILD_LUNCH,20,67,0,0,67,1070,0,0,1070,53.5
SAN DIEGO,Mar 2015,CACF,2015,SAN DIEGO COMMUNITY COLL DIST ,HS_CHILD_SNACK_PM,20,67,0,0,67,703,0,0,703,35.15
SAN DIEGO,Apr 2015,CACF,2015,SAN DIEGO COMMUNITY COLL DIST ,CHILD_BREAKFAST,19,47,10,9,66,756,161,145,1062,55.8947
SAN DIEGO,Apr 2015,CACF,2015,SAN DIEGO COMMUNITY COLL DIST ,CHILD_LUNCH,19,47,10,9,66,778,166,149,1093,57.5263
SAN DIEGO,Apr 2015,CACF,2015,SAN DIEGO COMMUNITY COLL DIST ,CHILD_SNACK_PM,19,47,10,9,66,427,91,81,599,31.5263
SAN DIEGO,Apr 2015,CACF,2015,SAN DIEGO COMMUNITY COLL DIST ,HS_CHILD_BREAKFAST,19,67,0,0,67,829,0,0,829,43.6316
SAN DIEGO,Apr 2015,CACF,2015,SAN DIEGO COMMUNITY COLL DIST ,HS_CHILD_LUNCH,19,67,0,0,67,972,0,0,972,51.1579
SAN DIEGO,Apr 2015,CACF,2015,SAN DIEGO COMMUNITY COLL DIST ,HS_CHILD_SNACK_PM,19,67,0,0,67,664,0,0,664,34.9474
SAN DIEGO,May 2015,CACF,2015,SAN DIEGO COMMUNITY COLL DIST ,CHILD_BREAKFAST,20,47,10,9,66,566,120,109,795,39.75
SAN DIEGO,May 2015,CACF,2015,SAN DIEGO COMMUNITY COLL DIST ,CHILD_LUNCH,20,47,10,9,66,603,128,116,847,42.35
SAN DIEGO,May 2015,CACF,2015,SAN DIEGO COMMUNITY COLL DIST ,CHILD_SNACK_PM,20,47,10,9,66,330,70,64,464,23.2
SAN DIEGO,May 2015,CACF,2015,SAN DIEGO COMMUNITY COLL DIST ,HS_CHILD_BREAKFAST,20,67,0,0,67,774,0,0,774,38.7
SAN DIEGO,May 2015,CACF,2015,SAN DIEGO COMMUNITY COLL DIST ,HS_CHILD_LUNCH,20,67,0,0,67,863,0,0,863,43.15
SAN DIEGO,May 2015,CACF,2015,SAN DIEGO COMMUNITY COLL DIST ,HS_CHILD_SNACK_PM,20,67,0,0,67,571,0,0,571,28.55
SAN DIEGO,Jun 2015,CACF,2015,SAN DIEGO COMMUNITY COLL DIST ,CHILD_BREAKFAST,10,47,10,9,66,19,4,3,26,2.6
SAN DIEGO,Jun 2015,CACF,2015,SAN DIEGO COMMUNITY COLL DIST ,CHILD_LUNCH,10,47,10,9,66,19,4,3,26,2.6
SAN DIEGO,Jun 2015,CACF,2015,SAN DIEGO COMMUNITY COLL DIST ,CHILD_SNACK_PM,10,47,10,9,66,14,3,2,19,1.9
SAN DIEGO,Jun 2015,CACF,2015,SAN DIEGO COMMUNITY COLL DIST ,HS_CHILD_BREAKFAST,10,34,0,0,34,100,0,0,100,10
SAN DIEGO,Jun 2015,CACF,2015,SAN DIEGO COMMUNITY COLL DIST ,HS_CHILD_LUNCH,10,34,0,0,34,140,0,0,140,14
SAN DIEGO,Jun 2015,CACF,2015,SAN DIEGO COMMUNITY COLL DIST ,HS_CHILD_SNACK_PM,10,34,0,0,34,92,0,0,92,9.2
SAN DIEGO,Aug 2015,CACF,2015,SAN DIEGO COMMUNITY COLL DIST ,CHILD_BREAKFAST,11,47,10,9,66,266,57,51,374,34
SAN DIEGO,Aug 2015,CACF,2015,SAN DIEGO COMMUNITY COLL DIST ,CHILD_LUNCH,11,47,10,9,66,249,53,48,350,31.8182
SAN DIEGO,Aug 2015,CACF,2015,SAN DIEGO COMMUNITY COLL DIST ,CHILD_SNACK_PM,11,47,10,9,66,125,27,23,175,15.9091
SAN DIEGO,Aug 2015,CACF,2015,SAN DIEGO COMMUNITY COLL DIST ,HS_CHILD_BREAKFAST,11,67,0,0,67,169,0,0,169,15.3636
SAN DIEGO,Aug 2015,CACF,2015,SAN DIEGO COMMUNITY COLL DIST ,HS_CHILD_LUNCH,11,67,0,0,67,165,0,0,165,15
SAN DIEGO,Aug 2015,CACF,2015,SAN DIEGO COMMUNITY COLL DIST ,HS_CHILD_SNACK_PM,11,67,0,0,67,98,0,0,98,8.9091
SAN DIEGO,Sep 2015,CACF,2015,SAN DIEGO COMMUNITY COLL DIST ,CHILD_BREAKFAST,21,32,2,7,41,386,24,84,494,23.5238
SAN DIEGO,Sep 2015,CACF,2015,SAN DIEGO COMMUNITY COLL DIST ,CHILD_LUNCH,21,32,2,7,41,420,26,92,538,25.619
SAN DIEGO,Sep 2015,CACF,2015,SAN DIEGO COMMUNITY COLL DIST ,CHILD_SNACK_PM,21,32,2,7,41,189,12,41,242,11.5238
SAN DIEGO,Sep 2015,CACF,2015,SAN DIEGO COMMUNITY COLL DIST ,HS_CHILD_BREAKFAST,21,107,0,0,107,1405,0,0,1405,66.9048
SAN DIEGO,Sep 2015,CACF,2015,SAN DIEGO COMMUNITY COLL DIST ,HS_CHILD_LUNCH,21,107,0,0,107,1542,0,0,1542,73.4286
SAN DIEGO,Sep 2015,CACF,2015,SAN DIEGO COMMUNITY COLL DIST ,HS_CHILD_SNACK_PM,21,107,0,0,107,802,0,0,802,38.1905
SAN DIEGO,Oct 2014,CACF,2015,San Diego Unified School District,ATRISK_CHILD_SUPPER,23,11077,0,0,11077,208136,0,0,208136,9049.3913
SAN DIEGO,Nov 2014,CACF,2015,San Diego Unified School District,ATRISK_CHILD_SUPPER,14,11926,0,0,11926,129935,0,0,129935,9281.0714
SAN DIEGO,Dec 2014,CACF,2015,San Diego Unified School District,ATRISK_CHILD_SUPPER,15,12567,0,0,12567,136044,0,0,136044,9069.6
SAN DIEGO,Jan 2015,CACF,2015,San Diego Unified School District,ATRISK_CHILD_SUPPER,19,13999,0,0,13999,133408,0,0,133408,7021.4737
SAN DIEGO,Feb 2015,CACF,2015,San Diego Unified School District,ATRISK_CHILD_SUPPER,18,29074,0,0,29074,173258,0,0,173258,9625.4444
SAN DIEGO,Mar 2015,CACF,2015,San Diego Unified School District,ATRISK_CHILD_SUPPER,20,28582,0,0,28582,200856,0,0,200856,10042.8
SAN DIEGO,Apr 2015,CACF,2015,San Diego Unified School District,ATRISK_CHILD_SUPPER,19,28664,0,0,28664,131894,0,0,131894,6941.7895
SAN DIEGO,May 2015,CACF,2015,San Diego Unified School District,ATRISK_CHILD_SUPPER,20,29935,0,0,29935,198586,0,0,198586,9929.3
SAN DIEGO,Jun 2015,CACF,2015,San Diego Unified School District,ATRISK_CHILD_SUPPER,22,28526,0,0,28526,148597,0,0,148597,6754.4091
SAN DIEGO,Jul 2015,CACF,2015,San Diego Unified School District,ATRISK_CHILD_SUPPER,14,4869,0,0,4869,51448,0,0,51448,3674.8571
SAN DIEGO,Aug 2015,CACF,2015,San Diego Unified School District,ATRISK_CHILD_SUPPER,20,3744,0,0,3744,5399,0,0,5399,269.95
SAN DIEGO,Sep 2015,CACF,2015,San Diego Unified School District,ATRISK_CHILD_SUPPER,21,31892,0,0,31892,160681,0,0,160681,7651.4762
SAN DIEGO,Aug 2015,CACF,2015,San Marcos Unified School District,ATRISK_CHILD_SUPPER,6,780,0,0,780,1259,0,0,1259,209.8333
SAN DIEGO,Sep 2015,CACF,2015,San Marcos Unified School District,ATRISK_CHILD_SUPPER,21,923,0,0,923,16395,0,0,16395,780.7143
SAN DIEGO,Oct 2014,CACF,2015,SANTEE SCHOOL DISTRICT,ATRISK_CHILD_SNACK,23,248,0,0,248,2181,0,0,2181,94.8261
SAN DIEGO,Oct 2014,CACF,2015,SANTEE SCHOOL DISTRICT,ATRISK_CHILD_SNACK_AM,23,248,0,0,248,742,0,0,742,32.2609
SAN DIEGO,Oct 2014,CACF,2015,SANTEE SCHOOL DISTRICT,ATRISK_CHILD_SUPPER,23,248,0,0,248,3693,0,0,3693,160.5652
SAN DIEGO,Nov 2014,CACF,2015,SANTEE SCHOOL DISTRICT,ATRISK_CHILD_SNACK,16,252,0,0,252,1381,0,0,1381,86.3125
SAN DIEGO,Nov 2014,CACF,2015,SANTEE SCHOOL DISTRICT,ATRISK_CHILD_SNACK_AM,16,252,0,0,252,488,0,0,488,30.5
SAN DIEGO,Nov 2014,CACF,2015,SANTEE SCHOOL DISTRICT,ATRISK_CHILD_SUPPER,16,252,0,0,252,2312,0,0,2312,144.5
SAN DIEGO,Dec 2014,CACF,2015,SANTEE SCHOOL DISTRICT,ATRISK_CHILD_SNACK,19,302,0,0,302,1574,0,0,1574,82.8421
SAN DIEGO,Dec 2014,CACF,2015,SANTEE SCHOOL DISTRICT,ATRISK_CHILD_SNACK_AM,19,302,0,0,302,526,0,0,526,27.6842
SAN DIEGO,Dec 2014,CACF,2015,SANTEE SCHOOL DISTRICT,ATRISK_CHILD_SUPPER,19,302,0,0,302,2591,0,0,2591,136.3684
SAN DIEGO,Jan 2015,CACF,2015,SANTEE SCHOOL DISTRICT,ATRISK_CHILD_SNACK,19,252,0,0,252,1708,0,0,1708,89.8947
SAN DIEGO,Jan 2015,CACF,2015,SANTEE SCHOOL DISTRICT,ATRISK_CHILD_SNACK_AM,19,252,0,0,252,509,0,0,509,26.7895
SAN DIEGO,Jan 2015,CACF,2015,SANTEE SCHOOL DISTRICT,ATRISK_CHILD_SUPPER,19,252,0,0,252,3073,0,0,3073,161.7368
SAN DIEGO,Feb 2015,CACF,2015,SANTEE SCHOOL DISTRICT,ATRISK_CHILD_SNACK,18,255,0,0,255,1691,0,0,1691,93.9444
SAN DIEGO,Feb 2015,CACF,2015,SANTEE SCHOOL DISTRICT,ATRISK_CHILD_SNACK_AM,18,255,0,0,255,537,0,0,537,29.8333
SAN DIEGO,Feb 2015,CACF,2015,SANTEE SCHOOL DISTRICT,ATRISK_CHILD_SUPPER,18,255,0,0,255,2842,0,0,2842,157.8889
SAN DIEGO,Mar 2015,CACF,2015,SANTEE SCHOOL DISTRICT,ATRISK_CHILD_SNACK,22,251,0,0,251,1917,0,0,1917,87.1364
SAN DIEGO,Mar 2015,CACF,2015,SANTEE SCHOOL DISTRICT,ATRISK_CHILD_SNACK_AM,22,251,0,0,251,633,0,0,633,28.7727
SAN DIEGO,Mar 2015,CACF,2015,SANTEE SCHOOL DISTRICT,ATRISK_CHILD_SUPPER,22,251,0,0,251,3217,0,0,3217,146.2273
SAN DIEGO,Apr 2015,CACF,2015,SANTEE SCHOOL DISTRICT,ATRISK_CHILD_SNACK,21,250,0,0,250,1656,0,0,1656,78.8571
SAN DIEGO,Apr 2015,CACF,2015,SANTEE SCHOOL DISTRICT,ATRISK_CHILD_SNACK_AM,21,250,0,0,250,464,0,0,464,22.0952
SAN DIEGO,Apr 2015,CACF,2015,SANTEE SCHOOL DISTRICT,ATRISK_CHILD_SUPPER,21,250,0,0,250,2479,0,0,2479,118.0476
SAN DIEGO,May 2015,CACF,2015,SANTEE SCHOOL DISTRICT,ATRISK_CHILD_SNACK,20,253,0,0,253,1796,0,0,1796,89.8
SAN DIEGO,May 2015,CACF,2015,SANTEE SCHOOL DISTRICT,ATRISK_CHILD_SNACK_AM,20,253,0,0,253,642,0,0,642,32.1
SAN DIEGO,May 2015,CACF,2015,SANTEE SCHOOL DISTRICT,ATRISK_CHILD_SUPPER,20,253,0,0,253,2785,0,0,2785,139.25
SAN DIEGO,Jun 2015,CACF,2015,SANTEE SCHOOL DISTRICT,ATRISK_CHILD_SNACK,13,324,0,0,324,1096,0,0,1096,84.3077
SAN DIEGO,Jun 2015,CACF,2015,SANTEE SCHOOL DISTRICT,ATRISK_CHILD_SNACK_AM,13,324,0,0,324,414,0,0,414,31.8462
SAN DIEGO,Jun 2015,CACF,2015,SANTEE SCHOOL DISTRICT,ATRISK_CHILD_SUPPER,13,324,0,0,324,1759,0,0,1759,135.3077
SAN DIEGO,Sep 2015,CACF,2015,SANTEE SCHOOL DISTRICT,ATRISK_CHILD_SNACK,20,385,0,0,385,2128,0,0,2128,106.4
SAN DIEGO,Sep 2015,CACF,2015,SANTEE SCHOOL DISTRICT,ATRISK_CHILD_SNACK_AM,20,385,0,0,385,511,0,0,511,25.55
SAN DIEGO,Sep 2015,CACF,2015,SANTEE SCHOOL DISTRICT,ATRISK_CHILD_SUPPER,20,385,0,0,385,3663,0,0,3663,183.15
SAN DIEGO,Oct 2014,CACF,2015,SELF DISCOVERY INC,CHILD_BREAKFAST,22,25,4,17,46,157,25,106,288,13.0909
SAN DIEGO,Oct 2014,CACF,2015,SELF DISCOVERY INC,CHILD_LUNCH,22,25,4,17,46,343,55,234,632,28.7273
SAN DIEGO,Oct 2014,CACF,2015,SELF DISCOVERY INC,CHILD_SNACK_AM,22,25,4,17,46,241,39,163,443,20.1364
SAN DIEGO,Oct 2014,CACF,2015,SELF DISCOVERY INC,CHILD_SNACK_PM,22,25,4,17,46,165,26,112,303,13.7727
SAN DIEGO,Oct 2014,CACF,2015,SELF DISCOVERY INC,CHILD_SUPPER,22,25,4,17,46,99,16,68,183,8.3182
SAN DIEGO,Nov 2014,CACF,2015,SELF DISCOVERY INC,CHILD_BREAKFAST,17,28,6,18,52,128,27,82,237,13.9412
SAN DIEGO,Nov 2014,CACF,2015,SELF DISCOVERY INC,CHILD_LUNCH,17,28,6,18,52,308,66,198,572,33.6471
SAN DIEGO,Nov 2014,CACF,2015,SELF DISCOVERY INC,CHILD_SNACK_AM,17,28,6,18,52,210,45,135,390,22.9412
SAN DIEGO,Nov 2014,CACF,2015,SELF DISCOVERY INC,CHILD_SNACK_PM,17,28,6,18,52,150,32,96,278,16.3529
SAN DIEGO,Nov 2014,CACF,2015,SELF DISCOVERY INC,CHILD_SUPPER,17,28,6,18,52,94,20,60,174,10.2353
SAN DIEGO,Dec 2014,CACF,2015,SELF DISCOVERY INC,CHILD_BREAKFAST,20,25,4,11,40,156,25,68,249,12.45
SAN DIEGO,Dec 2014,CACF,2015,SELF DISCOVERY INC,CHILD_LUNCH,20,25,4,11,40,372,60,163,595,29.75
SAN DIEGO,Dec 2014,CACF,2015,SELF DISCOVERY INC,CHILD_SNACK_AM,20,25,4,11,40,268,43,117,428,21.4
SAN DIEGO,Dec 2014,CACF,2015,SELF DISCOVERY INC,CHILD_SNACK_PM,20,25,4,11,40,178,28,78,284,14.2
SAN DIEGO,Dec 2014,CACF,2015,SELF DISCOVERY INC,CHILD_SUPPER,20,25,4,11,40,93,15,41,149,7.45
SAN DIEGO,Jan 2015,CACF,2015,SELF DISCOVERY INC,CHILD_BREAKFAST,20,21,5,15,41,150,36,107,293,14.65
SAN DIEGO,Jan 2015,CACF,2015,SELF DISCOVERY INC,CHILD_LUNCH,20,21,5,15,41,335,80,239,654,32.7
SAN DIEGO,Jan 2015,CACF,2015,SELF DISCOVERY INC,CHILD_SNACK_AM,20,21,5,15,41,242,58,172,472,23.6
SAN DIEGO,Jan 2015,CACF,2015,SELF DISCOVERY INC,CHILD_SNACK_PM,20,21,5,15,41,150,36,107,293,14.65
SAN DIEGO,Jan 2015,CACF,2015,SELF DISCOVERY INC,CHILD_SUPPER,20,21,5,15,41,93,22,67,182,9.1
SAN DIEGO,Feb 2015,CACF,2015,SELF DISCOVERY INC,CHILD_BREAKFAST,19,26,4,16,46,159,25,98,282,14.8421
SAN DIEGO,Feb 2015,CACF,2015,SELF DISCOVERY INC,CHILD_LUNCH,19,26,4,16,46,366,56,226,648,34.1053
SAN DIEGO,Feb 2015,CACF,2015,SELF DISCOVERY INC,CHILD_SNACK_AM,19,26,4,16,46,254,39,157,450,23.6842
SAN DIEGO,Feb 2015,CACF,2015,SELF DISCOVERY INC,CHILD_SNACK_PM,19,26,4,16,46,171,26,105,302,15.8947
SAN DIEGO,Feb 2015,CACF,2015,SELF DISCOVERY INC,CHILD_SUPPER,19,26,4,16,46,110,17,67,194,10.2105
SAN DIEGO,Mar 2015,CACF,2015,SELF DISCOVERY INC,CHILD_BREAKFAST,22,28,3,19,50,176,19,120,315,14.3182
SAN DIEGO,Mar 2015,CACF,2015,SELF DISCOVERY INC,CHILD_LUNCH,22,28,3,19,50,421,45,285,751,34.1364
SAN DIEGO,Mar 2015,CACF,2015,SELF DISCOVERY INC,CHILD_SNACK_AM,22,28,3,19,50,265,28,180,473,21.5
SAN DIEGO,Mar 2015,CACF,2015,SELF DISCOVERY INC,CHILD_SNACK_PM,22,28,3,19,50,228,24,156,408,18.5455
SAN DIEGO,Mar 2015,CACF,2015,SELF DISCOVERY INC,CHILD_SUPPER,22,28,3,19,50,152,16,104,272,12.3636
SAN DIEGO,Apr 2015,CACF,2015,SELF DISCOVERY INC,CHILD_BREAKFAST,21,42,3,17,62,212,15,86,313,14.9048
SAN DIEGO,Apr 2015,CACF,2015,SELF DISCOVERY INC,CHILD_LUNCH,21,42,3,17,62,569,41,230,840,40
SAN DIEGO,Apr 2015,CACF,2015,SELF DISCOVERY INC,CHILD_SNACK_AM,21,42,3,17,62,329,24,133,486,23.1429
SAN DIEGO,Apr 2015,CACF,2015,SELF DISCOVERY INC,CHILD_SNACK_PM,21,42,3,17,62,316,23,128,467,22.2381
SAN DIEGO,Apr 2015,CACF,2015,SELF DISCOVERY INC,CHILD_SUPPER,21,42,3,17,62,209,15,85,309,14.7143
SAN DIEGO,May 2015,CACF,2015,SELF DISCOVERY INC,CHILD_BREAKFAST,21,36,3,16,55,217,18,96,331,15.7619
SAN DIEGO,May 2015,CACF,2015,SELF DISCOVERY INC,CHILD_LUNCH,21,36,3,16,55,541,45,241,827,39.381
SAN DIEGO,May 2015,CACF,2015,SELF DISCOVERY INC,CHILD_SNACK_AM,21,36,3,16,55,319,27,141,487,23.1905
SAN DIEGO,May 2015,CACF,2015,SELF DISCOVERY INC,CHILD_SNACK_PM,21,36,3,16,55,286,24,127,437,20.8095
SAN DIEGO,May 2015,CACF,2015,SELF DISCOVERY INC,CHILD_SUPPER,21,36,3,16,55,212,18,94,324,15.4286
SAN DIEGO,Jun 2015,CACF,2015,SELF DISCOVERY INC,CHILD_BREAKFAST,22,39,2,15,56,226,12,86,324,14.7273
SAN DIEGO,Jun 2015,CACF,2015,SELF DISCOVERY INC,CHILD_LUNCH,22,39,2,15,56,619,32,238,889,40.4091
SAN DIEGO,Jun 2015,CACF,2015,SELF DISCOVERY INC,CHILD_SNACK_AM,22,39,2,15,56,357,18,137,512,23.2727
SAN DIEGO,Jun 2015,CACF,2015,SELF DISCOVERY INC,CHILD_SNACK_PM,22,39,2,15,56,329,17,126,472,21.4545
SAN DIEGO,Jun 2015,CACF,2015,SELF DISCOVERY INC,CHILD_SUPPER,22,39,2,15,56,248,13,95,356,16.1818
SAN DIEGO,Jul 2015,CACF,2015,SELF DISCOVERY INC,CHILD_BREAKFAST,22,39,3,13,55,199,15,67,281,12.7727
SAN DIEGO,Jul 2015,CACF,2015,SELF DISCOVERY INC,CHILD_LUNCH,22,39,3,13,55,564,43,189,796,36.1818
SAN DIEGO,Jul 2015,CACF,2015,SELF DISCOVERY INC,CHILD_SNACK_AM,22,39,3,13,55,294,23,97,414,18.8182
SAN DIEGO,Jul 2015,CACF,2015,SELF DISCOVERY INC,CHILD_SNACK_PM,22,39,3,13,55,333,26,110,469,21.3182
SAN DIEGO,Jul 2015,CACF,2015,SELF DISCOVERY INC,CHILD_SUPPER,22,39,3,13,55,264,20,88,372,16.9091
SAN DIEGO,Aug 2015,CACF,2015,SELF DISCOVERY INC,CHILD_BREAKFAST,21,39,3,13,55,200,15,67,282,13.4286
SAN DIEGO,Aug 2015,CACF,2015,SELF DISCOVERY INC,CHILD_LUNCH,21,39,3,13,55,565,43,189,797,37.9524
SAN DIEGO,Aug 2015,CACF,2015,SELF DISCOVERY INC,CHILD_SNACK_AM,21,39,3,13,55,308,24,103,435,20.7143
SAN DIEGO,Aug 2015,CACF,2015,SELF DISCOVERY INC,CHILD_SNACK_PM,21,39,3,13,55,316,24,105,445,21.1905
SAN DIEGO,Aug 2015,CACF,2015,SELF DISCOVERY INC,CHILD_SUPPER,21,39,3,13,55,247,19,83,349,16.619
SAN DIEGO,Sep 2015,CACF,2015,SELF DISCOVERY INC,CHILD_BREAKFAST,21,39,3,13,55,231,18,77,326,15.5238
SAN DIEGO,Sep 2015,CACF,2015,SELF DISCOVERY INC,CHILD_LUNCH,21,39,3,13,55,686,53,229,968,46.0952
SAN DIEGO,Sep 2015,CACF,2015,SELF DISCOVERY INC,CHILD_SNACK_AM,21,39,3,13,55,342,26,115,483,23
SAN DIEGO,Sep 2015,CACF,2015,SELF DISCOVERY INC,CHILD_SNACK_PM,21,39,3,13,55,413,32,138,583,27.7619
SAN DIEGO,Sep 2015,CACF,2015,SELF DISCOVERY INC,CHILD_SUPPER,21,39,3,13,55,348,27,116,491,23.381
SAN DIEGO,Aug 2015,CACF,2015,South Bay Union School District,HS_CHILD_SNACK_AM,7,159,0,0,159,745,0,0,745,106.4286
SAN DIEGO,Aug 2015,CACF,2015,South Bay Union School District,HS_CHILD_SNACK_PM,7,159,0,0,159,419,0,0,419,59.8571
SAN DIEGO,Sep 2015,CACF,2015,South Bay Union School District,HS_CHILD_SNACK_AM,12,159,0,0,159,1205,0,0,1205,100.4167
SAN DIEGO,Sep 2015,CACF,2015,South Bay Union School District,HS_CHILD_SNACK_PM,12,159,0,0,159,686,0,0,686,57.1667
SAN DIEGO,Oct 2014,CACF,2015,SOUTHERN CALIF TRIBAL CHAIR ASSOC-RINCON COMM DAYCARE CTR,CHILD_BREAKFAST,23,8,4,2,14,141,71,35,247,10.7391
SAN DIEGO,Oct 2014,CACF,2015,SOUTHERN CALIF TRIBAL CHAIR ASSOC-RINCON COMM DAYCARE CTR,CHILD_LUNCH,23,8,4,2,14,143,71,36,250,10.8696
SAN DIEGO,Oct 2014,CACF,2015,SOUTHERN CALIF TRIBAL CHAIR ASSOC-RINCON COMM DAYCARE CTR,CHILD_SNACK_PM,23,8,4,2,14,113,56,28,197,8.5652
SAN DIEGO,Nov 2014,CACF,2015,SOUTHERN CALIF TRIBAL CHAIR ASSOC-RINCON COMM DAYCARE CTR,CHILD_BREAKFAST,17,8,4,2,14,91,46,23,160,9.4118
SAN DIEGO,Nov 2014,CACF,2015,SOUTHERN CALIF TRIBAL CHAIR ASSOC-RINCON COMM DAYCARE CTR,CHILD_LUNCH,17,8,4,2,14,91,46,23,160,9.4118
SAN DIEGO,Nov 2014,CACF,2015,SOUTHERN CALIF TRIBAL CHAIR ASSOC-RINCON COMM DAYCARE CTR,CHILD_SNACK_PM,17,8,4,2,14,69,35,17,121,7.1176
SAN DIEGO,Dec 2014,CACF,2015,SOUTHERN CALIF TRIBAL CHAIR ASSOC-RINCON COMM DAYCARE CTR,CHILD_BREAKFAST,18,8,4,2,14,95,48,24,167,9.2778
SAN DIEGO,Dec 2014,CACF,2015,SOUTHERN CALIF TRIBAL CHAIR ASSOC-RINCON COMM DAYCARE CTR,CHILD_LUNCH,18,8,4,2,14,98,49,24,171,9.5
SAN DIEGO,Dec 2014,CACF,2015,SOUTHERN CALIF TRIBAL CHAIR ASSOC-RINCON COMM DAYCARE CTR,CHILD_SNACK_PM,18,8,4,2,14,82,41,21,144,8
SAN DIEGO,Jan 2015,CACF,2015,SOUTHERN CALIF TRIBAL CHAIR ASSOC-RINCON COMM DAYCARE CTR,CHILD_BREAKFAST,20,11,4,3,18,131,48,35,214,10.7
SAN DIEGO,Jan 2015,CACF,2015,SOUTHERN CALIF TRIBAL CHAIR ASSOC-RINCON COMM DAYCARE CTR,CHILD_LUNCH,20,11,4,3,18,133,48,37,218,10.9
SAN DIEGO,Jan 2015,CACF,2015,SOUTHERN CALIF TRIBAL CHAIR ASSOC-RINCON COMM DAYCARE CTR,CHILD_SNACK_PM,20,11,4,3,18,110,40,30,180,9
SAN DIEGO,Feb 2015,CACF,2015,SOUTHERN CALIF TRIBAL CHAIR ASSOC-RINCON COMM DAYCARE CTR,CHILD_BREAKFAST,20,13,4,3,20,156,48,36,240,12
SAN DIEGO,Feb 2015,CACF,2015,SOUTHERN CALIF TRIBAL CHAIR ASSOC-RINCON COMM DAYCARE CTR,CHILD_LUNCH,20,13,4,3,20,171,53,39,263,13.15
SAN DIEGO,Feb 2015,CACF,2015,SOUTHERN CALIF TRIBAL CHAIR ASSOC-RINCON COMM DAYCARE CTR,CHILD_SNACK_PM,20,13,4,3,20,134,41,31,206,10.3
SAN DIEGO,Mar 2015,CACF,2015,SOUTHERN CALIF TRIBAL CHAIR ASSOC-RINCON COMM DAYCARE CTR,CHILD_BREAKFAST,22,14,4,3,21,167,48,36,251,11.4091
SAN DIEGO,Mar 2015,CACF,2015,SOUTHERN CALIF TRIBAL CHAIR ASSOC-RINCON COMM DAYCARE CTR,CHILD_LUNCH,22,14,4,3,21,179,51,39,269,12.2273
SAN DIEGO,Mar 2015,CACF,2015,SOUTHERN CALIF TRIBAL CHAIR ASSOC-RINCON COMM DAYCARE CTR,CHILD_SNACK_PM,22,14,4,3,21,141,40,30,211,9.5909
SAN DIEGO,Apr 2015,CACF,2015,SOUTHERN CALIF TRIBAL CHAIR ASSOC-RINCON COMM DAYCARE CTR,CHILD_BREAKFAST,22,14,6,3,23,159,68,34,261,11.8636
SAN DIEGO,Apr 2015,CACF,2015,SOUTHERN CALIF TRIBAL CHAIR ASSOC-RINCON COMM DAYCARE CTR,CHILD_LUNCH,22,14,6,3,23,172,74,36,282,12.8182
SAN DIEGO,Apr 2015,CACF,2015,SOUTHERN CALIF TRIBAL CHAIR ASSOC-RINCON COMM DAYCARE CTR,CHILD_SNACK_PM,22,14,6,3,23,128,55,27,210,9.5455
SAN DIEGO,May 2015,CACF,2015,SOUTHERN CALIF TRIBAL CHAIR ASSOC-RINCON COMM DAYCARE CTR,CHILD_BREAKFAST,20,14,6,3,23,157,67,34,258,12.9
SAN DIEGO,May 2015,CACF,2015,SOUTHERN CALIF TRIBAL CHAIR ASSOC-RINCON COMM DAYCARE CTR,CHILD_LUNCH,20,14,6,3,23,173,74,38,285,14.25
SAN DIEGO,May 2015,CACF,2015,SOUTHERN CALIF TRIBAL CHAIR ASSOC-RINCON COMM DAYCARE CTR,CHILD_SNACK_PM,20,14,6,3,23,119,51,26,196,9.8
SAN DIEGO,Jun 2015,CACF,2015,SOUTHERN CALIF TRIBAL CHAIR ASSOC-RINCON COMM DAYCARE CTR,CHILD_BREAKFAST,22,14,6,2,22,165,71,23,259,11.7727
SAN DIEGO,Jun 2015,CACF,2015,SOUTHERN CALIF TRIBAL CHAIR ASSOC-RINCON COMM DAYCARE CTR,CHILD_LUNCH,22,14,6,2,22,182,78,26,286,13
SAN DIEGO,Jun 2015,CACF,2015,SOUTHERN CALIF TRIBAL CHAIR ASSOC-RINCON COMM DAYCARE CTR,CHILD_SNACK_PM,22,14,6,2,22,123,53,18,194,8.8182
SAN DIEGO,Jul 2015,CACF,2015,SOUTHERN CALIF TRIBAL CHAIR ASSOC-RINCON COMM DAYCARE CTR,CHILD_BREAKFAST,22,14,6,2,22,91,39,13,143,6.5
SAN DIEGO,Jul 2015,CACF,2015,SOUTHERN CALIF TRIBAL CHAIR ASSOC-RINCON COMM DAYCARE CTR,CHILD_LUNCH,22,14,6,2,22,94,40,14,148,6.7273
SAN DIEGO,Jul 2015,CACF,2015,SOUTHERN CALIF TRIBAL CHAIR ASSOC-RINCON COMM DAYCARE CTR,CHILD_SNACK_PM,22,14,6,2,22,59,25,9,93,4.2273
SAN DIEGO,Aug 2015,CACF,2015,SOUTHERN CALIF TRIBAL CHAIR ASSOC-RINCON COMM DAYCARE CTR,CHILD_BREAKFAST,21,14,6,2,22,99,43,14,156,7.4286
SAN DIEGO,Aug 2015,CACF,2015,SOUTHERN CALIF TRIBAL CHAIR ASSOC-RINCON COMM DAYCARE CTR,CHILD_LUNCH,21,14,6,2,22,106,46,15,167,7.9524
SAN DIEGO,Aug 2015,CACF,2015,SOUTHERN CALIF TRIBAL CHAIR ASSOC-RINCON COMM DAYCARE CTR,CHILD_SNACK_PM,21,14,6,2,22,67,29,9,105,5
SAN DIEGO,Sep 2015,CACF,2015,SOUTHERN CALIF TRIBAL CHAIR ASSOC-RINCON COMM DAYCARE CTR,CHILD_BREAKFAST,21,14,6,2,22,123,53,17,193,9.1905
SAN DIEGO,Sep 2015,CACF,2015,SOUTHERN CALIF TRIBAL CHAIR ASSOC-RINCON COMM DAYCARE CTR,CHILD_LUNCH,21,14,6,2,22,128,55,18,201,9.5714
SAN DIEGO,Sep 2015,CACF,2015,SOUTHERN CALIF TRIBAL CHAIR ASSOC-RINCON COMM DAYCARE CTR,CHILD_SNACK_PM,21,14,6,2,22,89,38,13,140,6.6667
SAN DIEGO,Oct 2014,CACF,2015,SWEET BUSY BEES,CHILD_BREAKFAST,22,6,0,2,8,130,0,43,173,7.8636
SAN DIEGO,Oct 2014,CACF,2015,SWEET BUSY BEES,CHILD_LUNCH,22,6,0,2,8,130,0,43,173,7.8636
SAN DIEGO,Oct 2014,CACF,2015,SWEET BUSY BEES,CHILD_SNACK_AM,22,6,0,2,8,130,0,43,173,7.8636
SAN DIEGO,Nov 2014,CACF,2015,SWEET BUSY BEES,CHILD_BREAKFAST,19,6,0,2,8,113,0,37,150,7.8947
SAN DIEGO,Nov 2014,CACF,2015,SWEET BUSY BEES,CHILD_LUNCH,19,6,0,2,8,113,0,37,150,7.8947
SAN DIEGO,Nov 2014,CACF,2015,SWEET BUSY BEES,CHILD_SNACK_AM,19,6,0,2,8,113,0,37,150,7.8947
SAN DIEGO,Dec 2014,CACF,2015,SWEET BUSY BEES,CHILD_BREAKFAST,21,7,0,1,8,147,0,21,168,8
SAN DIEGO,Dec 2014,CACF,2015,SWEET BUSY BEES,CHILD_LUNCH,21,7,0,1,8,146,0,21,167,7.9524
SAN DIEGO,Dec 2014,CACF,2015,SWEET BUSY BEES,CHILD_SNACK_AM,21,7,0,1,8,146,0,21,167,7.9524
SAN DIEGO,Jan 2015,CACF,2015,SWEET BUSY BEES,CHILD_BREAKFAST,19,7,0,1,8,131,0,19,150,7.8947
SAN DIEGO,Jan 2015,CACF,2015,SWEET BUSY BEES,CHILD_LUNCH,19,7,0,1,8,131,0,19,150,7.8947
SAN DIEGO,Jan 2015,CACF,2015,SWEET BUSY BEES,CHILD_SNACK_AM,19,7,0,1,8,131,0,19,150,7.8947
SAN DIEGO,Feb 2015,CACF,2015,SWEET BUSY BEES,CHILD_BREAKFAST,19,7,0,1,8,131,0,19,150,7.8947
SAN DIEGO,Feb 2015,CACF,2015,SWEET BUSY BEES,CHILD_LUNCH,19,7,0,1,8,131,0,19,150,7.8947
SAN DIEGO,Feb 2015,CACF,2015,SWEET BUSY BEES,CHILD_SNACK_AM,19,7,0,1,8,131,0,19,150,7.8947
SAN DIEGO,Mar 2015,CACF,2015,SWEET BUSY BEES,CHILD_BREAKFAST,22,6,0,2,8,131,0,43,174,7.9091
SAN DIEGO,Mar 2015,CACF,2015,SWEET BUSY BEES,CHILD_LUNCH,22,6,0,2,8,131,0,43,174,7.9091
SAN DIEGO,Mar 2015,CACF,2015,SWEET BUSY BEES,CHILD_SNACK_AM,22,6,0,2,8,131,0,43,174,7.9091
SAN DIEGO,Apr 2015,CACF,2015,SWEET BUSY BEES,CHILD_BREAKFAST,22,6,0,2,8,130,0,43,173,7.8636
SAN DIEGO,Apr 2015,CACF,2015,SWEET BUSY BEES,CHILD_LUNCH,22,6,0,2,8,130,0,43,173,7.8636
SAN DIEGO,Apr 2015,CACF,2015,SWEET BUSY BEES,CHILD_SNACK_AM,22,6,0,2,8,130,0,43,173,7.8636
SAN DIEGO,May 2015,CACF,2015,SWEET BUSY BEES,CHILD_BREAKFAST,20,6,0,2,8,113,0,37,150,7.5
SAN DIEGO,May 2015,CACF,2015,SWEET BUSY BEES,CHILD_LUNCH,20,6,0,2,8,113,0,37,150,7.5
SAN DIEGO,May 2015,CACF,2015,SWEET BUSY BEES,CHILD_SNACK_AM,20,6,0,2,8,113,0,37,150,7.5
SAN DIEGO,Jun 2015,CACF,2015,SWEET BUSY BEES,CHILD_BREAKFAST,22,6,0,2,8,129,0,43,172,7.8182
SAN DIEGO,Jun 2015,CACF,2015,SWEET BUSY BEES,CHILD_LUNCH,22,6,0,2,8,129,0,43,172,7.8182
SAN DIEGO,Jun 2015,CACF,2015,SWEET BUSY BEES,CHILD_SNACK_AM,22,6,0,2,8,129,0,43,172,7.8182
SAN DIEGO,Jul 2015,CACF,2015,SWEET BUSY BEES,CHILD_BREAKFAST,23,6,0,2,8,135,0,45,180,7.8261
SAN DIEGO,Jul 2015,CACF,2015,SWEET BUSY BEES,CHILD_LUNCH,23,6,0,2,8,135,0,45,180,7.8261
SAN DIEGO,Jul 2015,CACF,2015,SWEET BUSY BEES,CHILD_SNACK_AM,23,6,0,2,8,135,0,45,180,7.8261
SAN DIEGO,Aug 2015,CACF,2015,SWEET BUSY BEES,CHILD_BREAKFAST,21,6,0,2,8,120,0,40,160,7.619
SAN DIEGO,Aug 2015,CACF,2015,SWEET BUSY BEES,CHILD_LUNCH,21,6,0,2,8,120,0,40,160,7.619
SAN DIEGO,Aug 2015,CACF,2015,SWEET BUSY BEES,CHILD_SNACK_AM,21,6,0,2,8,120,0,40,160,7.619
SAN DIEGO,Sep 2015,CACF,2015,SWEET BUSY BEES,CHILD_BREAKFAST,21,9,0,2,11,166,0,37,203,9.6667
SAN DIEGO,Sep 2015,CACF,2015,SWEET BUSY BEES,CHILD_LUNCH,21,9,0,2,11,166,0,37,203,9.6667
SAN DIEGO,Sep 2015,CACF,2015,SWEET BUSY BEES,CHILD_SNACK_AM,21,9,0,2,11,166,0,37,203,9.6667
SAN DIEGO,Oct 2014,CACF,2015,Sweetwater Union High School District,ATRISK_CHILD_SUPPER,19,35225,0,0,35225,35225,0,0,35225,1853.9474
SAN DIEGO,Nov 2014,CACF,2015,Sweetwater Union High School District,ATRISK_CHILD_SUPPER,14,26769,0,0,26769,26769,0,0,26769,1912.0714
SAN DIEGO,Dec 2014,CACF,2015,Sweetwater Union High School District,ATRISK_CHILD_SUPPER,15,22205,0,0,22205,22205,0,0,22205,1480.3333
SAN DIEGO,Jan 2015,CACF,2015,Sweetwater Union High School District,ATRISK_CHILD_SUPPER,13,18373,0,0,18373,18373,0,0,18373,1413.3077
SAN DIEGO,Feb 2015,CACF,2015,Sweetwater Union High School District,ATRISK_CHILD_SUPPER,18,29088,0,0,29088,29088,0,0,29088,1616
SAN DIEGO,Mar 2015,CACF,2015,Sweetwater Union High School District,ATRISK_CHILD_SUPPER,15,24004,0,0,24004,24004,0,0,24004,1600.2667
SAN DIEGO,Apr 2015,CACF,2015,Sweetwater Union High School District,ATRISK_CHILD_SUPPER,19,29558,0,0,29558,29558,0,0,29558,1555.6842
SAN DIEGO,May 2015,CACF,2015,Sweetwater Union High School District,ATRISK_CHILD_SUPPER,20,29968,0,0,29968,29968,0,0,29968,1498.4
SAN DIEGO,Jun 2015,CACF,2015,Sweetwater Union High School District,ATRISK_CHILD_SUPPER,5,2161,0,0,2161,2161,0,0,2161,432.2
SAN DIEGO,Jul 2015,CACF,2015,Sweetwater Union High School District,ATRISK_CHILD_SUPPER,8,7623,0,0,7623,7623,0,0,7623,952.875
SAN DIEGO,Aug 2015,CACF,2015,Sweetwater Union High School District,ATRISK_CHILD_SUPPER,21,34793,0,0,34793,34793,0,0,34793,1656.8095
SAN DIEGO,Sep 2015,CACF,2015,Sweetwater Union High School District,ATRISK_CHILD_SUPPER,13,23259,0,0,23259,23259,0,0,23259,1789.1538
SAN DIEGO,Oct 2014,CACF,2015,The Vine Learning Center,CHILD_BREAKFAST,23,26,0,41,67,332,0,524,856,37.2174
SAN DIEGO,Oct 2014,CACF,2015,The Vine Learning Center,CHILD_LUNCH,23,26,0,41,67,422,0,665,1087,47.2609
SAN DIEGO,Oct 2014,CACF,2015,The Vine Learning Center,CHILD_SNACK_PM,23,26,0,41,67,393,0,620,1013,44.0435
SAN DIEGO,Nov 2014,CACF,2015,The Vine Learning Center,CHILD_BREAKFAST,17,26,0,41,67,249,0,392,641,37.7059
SAN DIEGO,Nov 2014,CACF,2015,The Vine Learning Center,CHILD_LUNCH,17,26,0,41,67,322,0,507,829,48.7647
SAN DIEGO,Nov 2014,CACF,2015,The Vine Learning Center,CHILD_SNACK_PM,17,26,0,41,67,301,0,475,776,45.6471
SAN DIEGO,Dec 2014,CACF,2015,The Vine Learning Center,CHILD_BREAKFAST,21,26,0,41,67,265,0,418,683,32.5238
SAN DIEGO,Dec 2014,CACF,2015,The Vine Learning Center,CHILD_LUNCH,21,26,0,41,67,347,0,547,894,42.5714
SAN DIEGO,Dec 2014,CACF,2015,The Vine Learning Center,CHILD_SNACK_PM,21,26,0,41,67,319,0,503,822,39.1429
SAN DIEGO,Jan 2015,CACF,2015,The Vine Learning Center,CHILD_BREAKFAST,22,26,0,41,67,269,0,425,694,31.5455
SAN DIEGO,Jan 2015,CACF,2015,The Vine Learning Center,CHILD_LUNCH,22,26,0,41,67,352,0,556,908,41.2727
SAN DIEGO,Jan 2015,CACF,2015,The Vine Learning Center,CHILD_SNACK_PM,22,26,0,41,67,333,0,524,857,38.9545
SAN DIEGO,Feb 2015,CACF,2015,The Vine Learning Center,CHILD_BREAKFAST,20,26,0,41,67,255,0,403,658,32.9
SAN DIEGO,Feb 2015,CACF,2015,The Vine Learning Center,CHILD_LUNCH,20,26,0,41,67,349,0,551,900,45
SAN DIEGO,Feb 2015,CACF,2015,The Vine Learning Center,CHILD_SNACK_PM,20,26,0,41,67,333,0,525,858,42.9
SAN DIEGO,Mar 2015,CACF,2015,The Vine Learning Center,CHILD_BREAKFAST,22,26,0,41,67,277,0,436,713,32.4091
SAN DIEGO,Mar 2015,CACF,2015,The Vine Learning Center,CHILD_LUNCH,22,26,0,41,67,399,0,630,1029,46.7727
SAN DIEGO,Mar 2015,CACF,2015,The Vine Learning Center,CHILD_SNACK_PM,22,26,0,41,67,373,0,588,961,43.6818
SAN DIEGO,Apr 2015,CACF,2015,The Vine Learning Center,CHILD_BREAKFAST,22,26,0,41,67,288,0,454,742,33.7273
SAN DIEGO,Apr 2015,CACF,2015,The Vine Learning Center,CHILD_LUNCH,22,26,0,41,67,421,0,663,1084,49.2727
SAN DIEGO,Apr 2015,CACF,2015,The Vine Learning Center,CHILD_SNACK_PM,22,26,0,41,67,392,0,617,1009,45.8636
SAN DIEGO,May 2015,CACF,2015,The Vine Learning Center,CHILD_BREAKFAST,21,26,0,41,67,291,0,459,750,35.7143
SAN DIEGO,May 2015,CACF,2015,The Vine Learning Center,CHILD_LUNCH,21,26,0,41,67,401,0,633,1034,49.2381
SAN DIEGO,May 2015,CACF,2015,The Vine Learning Center,CHILD_SNACK_PM,21,26,0,41,67,382,0,601,983,46.8095
SAN DIEGO,Jun 2015,CACF,2015,The Vine Learning Center,CHILD_BREAKFAST,22,26,0,41,67,295,0,465,760,34.5455
SAN DIEGO,Jun 2015,CACF,2015,The Vine Learning Center,CHILD_LUNCH,22,26,0,41,67,413,0,651,1064,48.3636
SAN DIEGO,Jun 2015,CACF,2015,The Vine Learning Center,CHILD_SNACK_PM,22,26,0,41,67,400,0,630,1030,46.8182
SAN DIEGO,Jul 2015,CACF,2015,The Vine Learning Center,CHILD_BREAKFAST,23,26,0,41,67,282,0,445,727,31.6087
SAN DIEGO,Jul 2015,CACF,2015,The Vine Learning Center,CHILD_LUNCH,23,26,0,41,67,392,0,617,1009,43.8696
SAN DIEGO,Jul 2015,CACF,2015,The Vine Learning Center,CHILD_SNACK_PM,23,26,0,41,67,381,0,601,982,42.6957
SAN DIEGO,Aug 2015,CACF,2015,The Vine Learning Center,CHILD_BREAKFAST,21,26,0,41,67,247,0,390,637,30.3333
SAN DIEGO,Aug 2015,CACF,2015,The Vine Learning Center,CHILD_LUNCH,21,26,0,41,67,354,0,557,911,43.381
SAN DIEGO,Aug 2015,CACF,2015,The Vine Learning Center,CHILD_SNACK_PM,21,26,0,41,67,343,0,540,883,42.0476
SAN DIEGO,Sep 2015,CACF,2015,The Vine Learning Center,CHILD_BREAKFAST,22,26,0,41,67,228,0,359,587,26.6818
SAN DIEGO,Sep 2015,CACF,2015,The Vine Learning Center,CHILD_LUNCH,22,26,0,41,67,315,0,496,811,36.8636
SAN DIEGO,Sep 2015,CACF,2015,The Vine Learning Center,CHILD_SNACK_PM,22,26,0,41,67,295,0,465,760,34.5455
SAN DIEGO,Oct 2014,CACF,2015,TODDLER TOWN LLC ,CHILD_BREAKFAST,23,29,3,11,43,348,36,132,516,22.4348
SAN DIEGO,Oct 2014,CACF,2015,TODDLER TOWN LLC ,CHILD_LUNCH,23,29,3,11,43,452,47,171,670,29.1304
SAN DIEGO,Oct 2014,CACF,2015,TODDLER TOWN LLC ,CHILD_SNACK_PM,23,29,3,11,43,606,63,229,898,39.0435
SAN DIEGO,Oct 2014,CACF,2015,TODDLER TOWN LLC ,OSCH_CHILD_BREAKFAST,23,9,0,0,9,4,0,0,4,0.1739
SAN DIEGO,Oct 2014,CACF,2015,TODDLER TOWN LLC ,OSCH_CHILD_LUNCH,23,9,0,0,9,6,0,0,6,0.2609
SAN DIEGO,Oct 2014,CACF,2015,TODDLER TOWN LLC ,OSCH_CHILD_SNACK_PM,23,9,0,0,9,63,0,0,63,2.7391
SAN DIEGO,Nov 2014,CACF,2015,TODDLER TOWN LLC ,CHILD_BREAKFAST,18,29,3,11,43,328,34,125,487,27.0556
SAN DIEGO,Nov 2014,CACF,2015,TODDLER TOWN LLC ,CHILD_LUNCH,18,29,3,11,43,397,41,150,588,32.6667
SAN DIEGO,Nov 2014,CACF,2015,TODDLER TOWN LLC ,CHILD_SNACK_PM,18,29,3,11,43,361,37,137,535,29.7222
SAN DIEGO,Nov 2014,CACF,2015,TODDLER TOWN LLC ,OSCH_CHILD_BREAKFAST,18,9,0,0,9,6,0,0,6,0.3333
SAN DIEGO,Nov 2014,CACF,2015,TODDLER TOWN LLC ,OSCH_CHILD_LUNCH,18,9,0,0,9,6,0,0,6,0.3333
SAN DIEGO,Nov 2014,CACF,2015,TODDLER TOWN LLC ,OSCH_CHILD_SNACK_PM,18,9,0,0,9,46,0,0,46,2.5556
SAN DIEGO,Dec 2014,CACF,2015,TODDLER TOWN LLC ,CHILD_BREAKFAST,18,29,3,11,43,353,37,134,524,29.1111
SAN DIEGO,Dec 2014,CACF,2015,TODDLER TOWN LLC ,CHILD_LUNCH,18,29,3,11,43,430,45,163,638,35.4444
SAN DIEGO,Dec 2014,CACF,2015,TODDLER TOWN LLC ,CHILD_SNACK_PM,18,29,3,11,43,349,36,132,517,28.7222
SAN DIEGO,Dec 2014,CACF,2015,TODDLER TOWN LLC ,OSCH_CHILD_SNACK_PM,18,9,0,0,9,58,0,0,58,3.2222
SAN DIEGO,Jan 2015,CACF,2015,TODDLER TOWN LLC ,CHILD_BREAKFAST,20,29,3,11,43,485,50,184,719,35.95
SAN DIEGO,Jan 2015,CACF,2015,TODDLER TOWN LLC ,CHILD_LUNCH,20,29,3,11,43,550,57,208,815,40.75
SAN DIEGO,Jan 2015,CACF,2015,TODDLER TOWN LLC ,CHILD_SNACK_PM,20,29,3,11,43,519,54,196,769,38.45
SAN DIEGO,Jan 2015,CACF,2015,TODDLER TOWN LLC ,OSCH_CHILD_BREAKFAST,20,9,0,0,9,3,0,0,3,0.15
SAN DIEGO,Jan 2015,CACF,2015,TODDLER TOWN LLC ,OSCH_CHILD_LUNCH,20,9,0,0,9,3,0,0,3,0.15
SAN DIEGO,Jan 2015,CACF,2015,TODDLER TOWN LLC ,OSCH_CHILD_SNACK_PM,20,9,0,0,9,61,0,0,61,3.05
SAN DIEGO,Feb 2015,CACF,2015,TODDLER TOWN LLC ,CHILD_BREAKFAST,20,29,3,11,43,450,47,171,668,33.4
SAN DIEGO,Feb 2015,CACF,2015,TODDLER TOWN LLC ,CHILD_LUNCH,20,29,3,11,43,558,58,211,827,41.35
SAN DIEGO,Feb 2015,CACF,2015,TODDLER TOWN LLC ,CHILD_SNACK_PM,20,29,3,11,43,572,59,217,848,42.4
SAN DIEGO,Feb 2015,CACF,2015,TODDLER TOWN LLC ,OSCH_CHILD_BREAKFAST,20,9,0,0,9,7,0,0,7,0.35
SAN DIEGO,Feb 2015,CACF,2015,TODDLER TOWN LLC ,OSCH_CHILD_LUNCH,20,9,0,0,9,8,0,0,8,0.4
SAN DIEGO,Feb 2015,CACF,2015,TODDLER TOWN LLC ,OSCH_CHILD_SNACK_PM,20,9,0,0,9,56,0,0,56,2.8
SAN DIEGO,Mar 2015,CACF,2015,TODDLER TOWN LLC ,CHILD_BREAKFAST,22,29,3,11,43,463,48,175,686,31.1818
SAN DIEGO,Mar 2015,CACF,2015,TODDLER TOWN LLC ,CHILD_LUNCH,22,29,3,11,43,591,61,224,876,39.8182
SAN DIEGO,Mar 2015,CACF,2015,TODDLER TOWN LLC ,CHILD_SNACK_PM,22,29,3,11,43,541,56,205,802,36.4545
SAN DIEGO,Mar 2015,CACF,2015,TODDLER TOWN LLC ,OSCH_CHILD_SNACK_PM,22,9,0,0,9,46,0,0,46,2.0909
SAN DIEGO,Apr 2015,CACF,2015,TODDLER TOWN LLC ,CHILD_BREAKFAST,22,29,3,11,43,479,50,181,710,32.2727
SAN DIEGO,Apr 2015,CACF,2015,TODDLER TOWN LLC ,CHILD_LUNCH,22,29,3,11,43,557,58,211,826,37.5455
SAN DIEGO,Apr 2015,CACF,2015,TODDLER TOWN LLC ,CHILD_SNACK_PM,22,29,3,11,43,517,53,196,766,34.8182
SAN DIEGO,Apr 2015,CACF,2015,TODDLER TOWN LLC ,OSCH_CHILD_BREAKFAST,22,9,0,0,9,15,0,0,15,0.6818
SAN DIEGO,Apr 2015,CACF,2015,TODDLER TOWN LLC ,OSCH_CHILD_LUNCH,22,9,0,0,9,16,0,0,16,0.7273
SAN DIEGO,Apr 2015,CACF,2015,TODDLER TOWN LLC ,OSCH_CHILD_SNACK_PM,22,9,0,0,9,38,0,0,38,1.7273
SAN DIEGO,May 2015,CACF,2015,TODDLER TOWN LLC ,CHILD_BREAKFAST,20,29,3,11,43,397,41,150,588,29.4
SAN DIEGO,May 2015,CACF,2015,TODDLER TOWN LLC ,CHILD_LUNCH,20,29,3,11,43,451,47,171,669,33.45
SAN DIEGO,May 2015,CACF,2015,TODDLER TOWN LLC ,CHILD_SNACK_PM,20,29,3,11,43,450,47,170,667,33.35
SAN DIEGO,May 2015,CACF,2015,TODDLER TOWN LLC ,OSCH_CHILD_BREAKFAST,20,9,0,0,9,1,0,0,1,0.05
SAN DIEGO,May 2015,CACF,2015,TODDLER TOWN LLC ,OSCH_CHILD_LUNCH,20,9,0,0,9,1,0,0,1,0.05
SAN DIEGO,May 2015,CACF,2015,TODDLER TOWN LLC ,OSCH_CHILD_SNACK_PM,20,9,0,0,9,41,0,0,41,2.05
SAN DIEGO,Jun 2015,CACF,2015,TODDLER TOWN LLC ,CHILD_BREAKFAST,21,29,3,11,43,437,45,166,648,30.8571
SAN DIEGO,Jun 2015,CACF,2015,TODDLER TOWN LLC ,CHILD_LUNCH,21,29,3,11,43,501,52,190,743,35.381
SAN DIEGO,Jun 2015,CACF,2015,TODDLER TOWN LLC ,CHILD_SNACK_PM,21,29,3,11,43,461,48,174,683,32.5238
SAN DIEGO,Jun 2015,CACF,2015,TODDLER TOWN LLC ,OSCH_CHILD_BREAKFAST,21,9,0,0,9,34,0,0,34,1.619
SAN DIEGO,Jun 2015,CACF,2015,TODDLER TOWN LLC ,OSCH_CHILD_LUNCH,21,9,0,0,9,34,0,0,34,1.619
SAN DIEGO,Jun 2015,CACF,2015,TODDLER TOWN LLC ,OSCH_CHILD_SNACK_PM,21,9,0,0,9,43,0,0,43,2.0476
SAN DIEGO,Jul 2015,CACF,2015,TODDLER TOWN LLC ,CHILD_BREAKFAST,22,29,3,11,43,431,45,163,639,29.0455
SAN DIEGO,Jul 2015,CACF,2015,TODDLER TOWN LLC ,CHILD_LUNCH,22,29,3,11,43,496,51,188,735,33.4091
SAN DIEGO,Jul 2015,CACF,2015,TODDLER TOWN LLC ,CHILD_SNACK_PM,22,29,3,11,43,469,49,177,695,31.5909
SAN DIEGO,Jul 2015,CACF,2015,TODDLER TOWN LLC ,OSCH_CHILD_BREAKFAST,22,9,0,0,9,46,0,0,46,2.0909
SAN DIEGO,Jul 2015,CACF,2015,TODDLER TOWN LLC ,OSCH_CHILD_LUNCH,22,9,0,0,9,46,0,0,46,2.0909
SAN DIEGO,Jul 2015,CACF,2015,TODDLER TOWN LLC ,OSCH_CHILD_SNACK_PM,22,9,0,0,9,43,0,0,43,1.9545
SAN DIEGO,Aug 2015,CACF,2015,TODDLER TOWN LLC ,CHILD_BREAKFAST,21,39,3,16,58,553,42,227,822,39.1429
SAN DIEGO,Aug 2015,CACF,2015,TODDLER TOWN LLC ,CHILD_LUNCH,21,39,3,16,58,613,47,252,912,43.4286
SAN DIEGO,Aug 2015,CACF,2015,TODDLER TOWN LLC ,CHILD_SNACK_PM,21,39,3,16,58,539,41,221,801,38.1429
SAN DIEGO,Aug 2015,CACF,2015,TODDLER TOWN LLC ,OSCH_CHILD_BREAKFAST,21,4,0,0,4,22,0,0,22,1.0476
SAN DIEGO,Aug 2015,CACF,2015,TODDLER TOWN LLC ,OSCH_CHILD_LUNCH,21,4,0,0,4,26,0,0,26,1.2381
SAN DIEGO,Aug 2015,CACF,2015,TODDLER TOWN LLC ,OSCH_CHILD_SNACK_PM,21,4,0,0,4,35,0,0,35,1.6667
SAN DIEGO,Sep 2015,CACF,2015,TODDLER TOWN LLC ,CHILD_BREAKFAST,20,39,3,16,58,694,53,285,1032,51.6
SAN DIEGO,Sep 2015,CACF,2015,TODDLER TOWN LLC ,CHILD_LUNCH,20,39,3,16,58,755,58,310,1123,56.15
SAN DIEGO,Sep 2015,CACF,2015,TODDLER TOWN LLC ,CHILD_SNACK_PM,20,39,3,16,58,643,49,264,956,47.8
SAN DIEGO,Sep 2015,CACF,2015,TODDLER TOWN LLC ,OSCH_CHILD_SNACK_PM,20,4,0,0,4,7,0,0,7,0.35
SAN DIEGO,Oct 2014,CACF,2015,TUTOR TIME LEARNING CENTERS LLC,CHILD_BREAKFAST,23,188,24,251,463,2138,273,2856,5267,229
SAN DIEGO,Oct 2014,CACF,2015,TUTOR TIME LEARNING CENTERS LLC,CHILD_LUNCH,23,188,24,251,463,2848,363,3803,7014,304.9565
SAN DIEGO,Oct 2014,CACF,2015,TUTOR TIME LEARNING CENTERS LLC,CHILD_SNACK_PM,23,188,24,251,463,2572,328,3434,6334,275.3913
SAN DIEGO,Oct 2014,CACF,2015,TUTOR TIME LEARNING CENTERS LLC,OSCH_CHILD_BREAKFAST,23,58,13,77,148,261,59,347,667,29
SAN DIEGO,Oct 2014,CACF,2015,TUTOR TIME LEARNING CENTERS LLC,OSCH_CHILD_LUNCH,23,58,13,77,148,155,35,205,395,17.1739
SAN DIEGO,Oct 2014,CACF,2015,TUTOR TIME LEARNING CENTERS LLC,OSCH_CHILD_SNACK_PM,23,58,13,77,148,985,221,1307,2513,109.2609
SAN DIEGO,Nov 2014,CACF,2015,TUTOR TIME LEARNING CENTERS LLC,CHILD_BREAKFAST,18,188,24,251,463,1613,206,2154,3973,220.7222
SAN DIEGO,Nov 2014,CACF,2015,TUTOR TIME LEARNING CENTERS LLC,CHILD_LUNCH,18,188,24,251,463,2107,269,2814,5190,288.3333
SAN DIEGO,Nov 2014,CACF,2015,TUTOR TIME LEARNING CENTERS LLC,CHILD_SNACK_PM,18,188,24,251,463,1896,242,2531,4669,259.3889
SAN DIEGO,Nov 2014,CACF,2015,TUTOR TIME LEARNING CENTERS LLC,OSCH_CHILD_BREAKFAST,18,58,13,77,148,183,41,243,467,25.9444
SAN DIEGO,Nov 2014,CACF,2015,TUTOR TIME LEARNING CENTERS LLC,OSCH_CHILD_LUNCH,18,58,13,77,148,261,59,347,667,37.0556
SAN DIEGO,Nov 2014,CACF,2015,TUTOR TIME LEARNING CENTERS LLC,OSCH_CHILD_SNACK_PM,18,58,13,77,148,748,168,993,1909,106.0556
SAN DIEGO,Dec 2014,CACF,2015,TUTOR TIME LEARNING CENTERS LLC,CHILD_BREAKFAST,22,188,24,251,463,1669,213,2230,4112,186.9091
SAN DIEGO,Dec 2014,CACF,2015,TUTOR TIME LEARNING CENTERS LLC,CHILD_LUNCH,22,188,24,251,463,2259,288,3016,5563,252.8636
SAN DIEGO,Dec 2014,CACF,2015,TUTOR TIME LEARNING CENTERS LLC,CHILD_SNACK_PM,22,188,24,251,463,2081,265,2779,5125,232.9545
SAN DIEGO,Dec 2014,CACF,2015,TUTOR TIME LEARNING CENTERS LLC,OSCH_CHILD_BREAKFAST,22,58,13,77,148,223,50,297,570,25.9091
SAN DIEGO,Dec 2014,CACF,2015,TUTOR TIME LEARNING CENTERS LLC,OSCH_CHILD_LUNCH,22,58,13,77,148,270,60,359,689,31.3182
SAN DIEGO,Dec 2014,CACF,2015,TUTOR TIME LEARNING CENTERS LLC,OSCH_CHILD_SNACK_PM,22,58,13,77,148,792,177,1052,2021,91.8636
SAN DIEGO,Jan 2015,CACF,2015,TUTOR TIME LEARNING CENTERS LLC,CHILD_BREAKFAST,21,188,24,251,463,1585,202,2118,3905,185.9524
SAN DIEGO,Jan 2015,CACF,2015,TUTOR TIME LEARNING CENTERS LLC,CHILD_LUNCH,21,188,24,251,463,2235,285,2985,5505,262.1429
SAN DIEGO,Jan 2015,CACF,2015,TUTOR TIME LEARNING CENTERS LLC,CHILD_SNACK_PM,21,188,24,251,463,2125,271,2837,5233,249.1905
SAN DIEGO,Jan 2015,CACF,2015,TUTOR TIME LEARNING CENTERS LLC,OSCH_CHILD_BREAKFAST,21,58,13,77,148,235,53,312,600,28.5714
SAN DIEGO,Jan 2015,CACF,2015,TUTOR TIME LEARNING CENTERS LLC,OSCH_CHILD_LUNCH,21,58,13,77,148,273,61,362,696,33.1429
SAN DIEGO,Jan 2015,CACF,2015,TUTOR TIME LEARNING CENTERS LLC,OSCH_CHILD_SNACK_PM,21,58,13,77,148,824,185,1094,2103,100.1429
SAN DIEGO,Feb 2015,CACF,2015,TUTOR TIME LEARNING CENTERS LLC,CHILD_BREAKFAST,19,188,24,251,463,1774,226,2370,4370,230
SAN DIEGO,Feb 2015,CACF,2015,TUTOR TIME LEARNING CENTERS LLC,CHILD_LUNCH,19,188,24,251,463,2365,302,3159,5826,306.6316
SAN DIEGO,Feb 2015,CACF,2015,TUTOR TIME LEARNING CENTERS LLC,CHILD_SNACK_PM,19,188,24,251,463,2144,274,2862,5280,277.8947
SAN DIEGO,Feb 2015,CACF,2015,TUTOR TIME LEARNING CENTERS LLC,OSCH_CHILD_BREAKFAST,19,58,13,77,148,174,39,231,444,23.3684
SAN DIEGO,Feb 2015,CACF,2015,TUTOR TIME LEARNING CENTERS LLC,OSCH_CHILD_LUNCH,19,58,13,77,148,158,35,211,404,21.2632
SAN DIEGO,Feb 2015,CACF,2015,TUTOR TIME LEARNING CENTERS LLC,OSCH_CHILD_SNACK_PM,19,58,13,77,148,750,168,997,1915,100.7895
SAN DIEGO,Mar 2015,CACF,2015,TUTOR TIME LEARNING CENTERS LLC,CHILD_BREAKFAST,22,188,24,251,463,1965,251,2625,4841,220.0455
SAN DIEGO,Mar 2015,CACF,2015,TUTOR TIME LEARNING CENTERS LLC,CHILD_LUNCH,22,188,24,251,463,2730,348,3645,6723,305.5909
SAN DIEGO,Mar 2015,CACF,2015,TUTOR TIME LEARNING CENTERS LLC,CHILD_SNACK_PM,22,188,24,251,463,2462,314,3288,6064,275.6364
SAN DIEGO,Mar 2015,CACF,2015,TUTOR TIME LEARNING CENTERS LLC,OSCH_CHILD_BREAKFAST,22,58,13,77,148,238,53,316,607,27.5909
SAN DIEGO,Mar 2015,CACF,2015,TUTOR TIME LEARNING CENTERS LLC,OSCH_CHILD_LUNCH,22,58,13,77,148,274,61,363,698,31.7273
SAN DIEGO,Mar 2015,CACF,2015,TUTOR TIME LEARNING CENTERS LLC,OSCH_CHILD_SNACK_PM,22,58,13,77,148,887,199,1178,2264,102.9091
SAN DIEGO,Apr 2015,CACF,2015,TUTOR TIME LEARNING CENTERS LLC,CHILD_BREAKFAST,22,188,24,251,463,2033,259,2716,5008,227.6364
SAN DIEGO,Apr 2015,CACF,2015,TUTOR TIME LEARNING CENTERS LLC,CHILD_LUNCH,22,188,24,251,463,2769,353,3697,6819,309.9545
SAN DIEGO,Apr 2015,CACF,2015,TUTOR TIME LEARNING CENTERS LLC,CHILD_SNACK_PM,22,188,24,251,463,2516,321,3359,6196,281.6364
SAN DIEGO,Apr 2015,CACF,2015,TUTOR TIME LEARNING CENTERS LLC,OSCH_CHILD_BREAKFAST,22,58,13,77,148,264,59,351,674,30.6364
SAN DIEGO,Apr 2015,CACF,2015,TUTOR TIME LEARNING CENTERS LLC,OSCH_CHILD_LUNCH,22,58,13,77,148,254,57,338,649,29.5
SAN DIEGO,Apr 2015,CACF,2015,TUTOR TIME LEARNING CENTERS LLC,OSCH_CHILD_SNACK_PM,22,58,13,77,148,864,194,1146,2204,100.1818
SAN DIEGO,May 2015,CACF,2015,TUTOR TIME LEARNING CENTERS LLC,CHILD_BREAKFAST,20,188,24,251,463,1853,236,2475,4564,228.2
SAN DIEGO,May 2015,CACF,2015,TUTOR TIME LEARNING CENTERS LLC,CHILD_LUNCH,20,188,24,251,463,2572,328,3435,6335,316.75
SAN DIEGO,May 2015,CACF,2015,TUTOR TIME LEARNING CENTERS LLC,CHILD_SNACK_PM,20,188,24,251,463,2326,297,3105,5728,286.4
SAN DIEGO,May 2015,CACF,2015,TUTOR TIME LEARNING CENTERS LLC,OSCH_CHILD_BREAKFAST,20,58,13,77,148,87,19,116,222,11.1
SAN DIEGO,May 2015,CACF,2015,TUTOR TIME LEARNING CENTERS LLC,OSCH_CHILD_LUNCH,20,58,13,77,148,131,29,175,335,16.75
SAN DIEGO,May 2015,CACF,2015,TUTOR TIME LEARNING CENTERS LLC,OSCH_CHILD_SNACK_PM,20,58,13,77,148,815,183,1082,2080,104
SAN DIEGO,Jun 2015,CACF,2015,TUTOR TIME LEARNING CENTERS LLC,CHILD_BREAKFAST,22,188,24,251,463,1983,253,2648,4884,222
SAN DIEGO,Jun 2015,CACF,2015,TUTOR TIME LEARNING CENTERS LLC,CHILD_LUNCH,22,188,24,251,463,2574,328,3439,6341,288.2273
SAN DIEGO,Jun 2015,CACF,2015,TUTOR TIME LEARNING CENTERS LLC,CHILD_SNACK_PM,22,188,24,251,463,2419,309,3231,5959,270.8636
SAN DIEGO,Jun 2015,CACF,2015,TUTOR TIME LEARNING CENTERS LLC,OSCH_CHILD_BREAKFAST,22,58,13,77,148,439,98,584,1121,50.9545
SAN DIEGO,Jun 2015,CACF,2015,TUTOR TIME LEARNING CENTERS LLC,OSCH_CHILD_LUNCH,22,58,13,77,148,603,135,801,1539,69.9545
SAN DIEGO,Jun 2015,CACF,2015,TUTOR TIME LEARNING CENTERS LLC,OSCH_CHILD_SNACK_PM,22,58,13,77,148,795,178,1055,2028,92.1818
SAN DIEGO,Jul 2015,CACF,2015,TUTOR TIME LEARNING CENTERS LLC,CHILD_BREAKFAST,22,188,24,251,463,2004,256,2677,4937,224.4091
SAN DIEGO,Jul 2015,CACF,2015,TUTOR TIME LEARNING CENTERS LLC,CHILD_LUNCH,22,188,24,251,463,2718,347,3629,6694,304.2727
SAN DIEGO,Jul 2015,CACF,2015,TUTOR TIME LEARNING CENTERS LLC,CHILD_SNACK_PM,22,188,24,251,463,2521,322,3366,6209,282.2273
SAN DIEGO,Jul 2015,CACF,2015,TUTOR TIME LEARNING CENTERS LLC,OSCH_CHILD_BREAKFAST,22,58,13,77,148,499,112,663,1274,57.9091
SAN DIEGO,Jul 2015,CACF,2015,TUTOR TIME LEARNING CENTERS LLC,OSCH_CHILD_LUNCH,22,58,13,77,148,776,174,1031,1981,90.0455
SAN DIEGO,Jul 2015,CACF,2015,TUTOR TIME LEARNING CENTERS LLC,OSCH_CHILD_SNACK_PM,22,58,13,77,148,738,165,979,1882,85.5455
SAN DIEGO,Aug 2015,CACF,2015,TUTOR TIME LEARNING CENTERS LLC,CHILD_BREAKFAST,21,188,24,251,463,1945,248,2598,4791,228.1429
SAN DIEGO,Aug 2015,CACF,2015,TUTOR TIME LEARNING CENTERS LLC,CHILD_LUNCH,21,188,24,251,463,2624,335,3504,6463,307.7619
SAN DIEGO,Aug 2015,CACF,2015,TUTOR TIME LEARNING CENTERS LLC,CHILD_SNACK_PM,21,188,24,251,463,2382,304,3180,5866,279.3333
SAN DIEGO,Aug 2015,CACF,2015,TUTOR TIME LEARNING CENTERS LLC,OSCH_CHILD_BREAKFAST,21,58,13,77,148,354,79,471,904,43.0476
SAN DIEGO,Aug 2015,CACF,2015,TUTOR TIME LEARNING CENTERS LLC,OSCH_CHILD_LUNCH,21,58,13,77,148,457,102,606,1165,55.4762
SAN DIEGO,Aug 2015,CACF,2015,TUTOR TIME LEARNING CENTERS LLC,OSCH_CHILD_SNACK_PM,21,58,13,77,148,812,182,1078,2072,98.6667
SAN DIEGO,Sep 2015,CACF,2015,TUTOR TIME LEARNING CENTERS LLC,CHILD_BREAKFAST,21,188,24,251,463,2011,257,2684,4952,235.8095
SAN DIEGO,Sep 2015,CACF,2015,TUTOR TIME LEARNING CENTERS LLC,CHILD_LUNCH,21,188,24,251,463,2620,334,3498,6452,307.2381
SAN DIEGO,Sep 2015,CACF,2015,TUTOR TIME LEARNING CENTERS LLC,CHILD_SNACK_PM,21,188,24,251,463,2380,304,3178,5862,279.1429
SAN DIEGO,Sep 2015,CACF,2015,TUTOR TIME LEARNING CENTERS LLC,OSCH_CHILD_BREAKFAST,21,58,13,77,148,143,32,189,364,17.3333
SAN DIEGO,Sep 2015,CACF,2015,TUTOR TIME LEARNING CENTERS LLC,OSCH_CHILD_LUNCH,21,58,13,77,148,276,62,366,704,33.5238
SAN DIEGO,Sep 2015,CACF,2015,TUTOR TIME LEARNING CENTERS LLC,OSCH_CHILD_SNACK_PM,21,58,13,77,148,922,207,1224,2353,112.0476
SAN DIEGO,Oct 2014,CACF,2015,UNITED CHURCH/CHRIST LA MESA CHARLEY BROWNS CHILDREN CENTER,CHILD_BREAKFAST,23,6,4,76,86,77,51,975,1103,47.9565
SAN DIEGO,Oct 2014,CACF,2015,UNITED CHURCH/CHRIST LA MESA CHARLEY BROWNS CHILDREN CENTER,CHILD_LUNCH,23,6,4,76,86,90,60,1142,1292,56.1739
SAN DIEGO,Oct 2014,CACF,2015,UNITED CHURCH/CHRIST LA MESA CHARLEY BROWNS CHILDREN CENTER,CHILD_SNACK_PM,23,6,4,76,86,78,52,987,1117,48.5652
SAN DIEGO,Nov 2014,CACF,2015,UNITED CHURCH/CHRIST LA MESA CHARLEY BROWNS CHILDREN CENTER,CHILD_BREAKFAST,18,6,4,76,86,59,40,751,850,47.2222
SAN DIEGO,Nov 2014,CACF,2015,UNITED CHURCH/CHRIST LA MESA CHARLEY BROWNS CHILDREN CENTER,CHILD_LUNCH,18,6,4,76,86,71,48,904,1023,56.8333
SAN DIEGO,Nov 2014,CACF,2015,UNITED CHURCH/CHRIST LA MESA CHARLEY BROWNS CHILDREN CENTER,CHILD_SNACK_PM,18,6,4,76,86,62,42,791,895,49.7222
SAN DIEGO,Dec 2014,CACF,2015,UNITED CHURCH/CHRIST LA MESA CHARLEY BROWNS CHILDREN CENTER,CHILD_BREAKFAST,21,6,4,76,86,66,44,831,941,44.8095
SAN DIEGO,Dec 2014,CACF,2015,UNITED CHURCH/CHRIST LA MESA CHARLEY BROWNS CHILDREN CENTER,CHILD_LUNCH,21,6,4,76,86,85,57,1081,1223,58.2381
SAN DIEGO,Dec 2014,CACF,2015,UNITED CHURCH/CHRIST LA MESA CHARLEY BROWNS CHILDREN CENTER,CHILD_SNACK_PM,21,6,4,76,86,75,50,944,1069,50.9048
SAN DIEGO,Jan 2015,CACF,2015,UNITED CHURCH/CHRIST LA MESA CHARLEY BROWNS CHILDREN CENTER,CHILD_BREAKFAST,19,6,4,76,86,61,40,767,868,45.6842
SAN DIEGO,Jan 2015,CACF,2015,UNITED CHURCH/CHRIST LA MESA CHARLEY BROWNS CHILDREN CENTER,CHILD_LUNCH,19,6,4,76,86,76,51,962,1089,57.3158
SAN DIEGO,Jan 2015,CACF,2015,UNITED CHURCH/CHRIST LA MESA CHARLEY BROWNS CHILDREN CENTER,CHILD_SNACK_PM,19,6,4,76,86,67,44,844,955,50.2632
SAN DIEGO,Feb 2015,CACF,2015,UNITED CHURCH/CHRIST LA MESA CHARLEY BROWNS CHILDREN CENTER,CHILD_BREAKFAST,19,6,4,76,86,65,44,828,937,49.3158
SAN DIEGO,Feb 2015,CACF,2015,UNITED CHURCH/CHRIST LA MESA CHARLEY BROWNS CHILDREN CENTER,CHILD_LUNCH,19,6,4,76,86,81,54,1024,1159,61
SAN DIEGO,Feb 2015,CACF,2015,UNITED CHURCH/CHRIST LA MESA CHARLEY BROWNS CHILDREN CENTER,CHILD_SNACK_PM,19,6,4,76,86,68,46,865,979,51.5263
SAN DIEGO,Mar 2015,CACF,2015,UNITED CHURCH/CHRIST LA MESA CHARLEY BROWNS CHILDREN CENTER,CHILD_BREAKFAST,22,6,4,76,86,70,47,891,1008,45.8182
SAN DIEGO,Mar 2015,CACF,2015,UNITED CHURCH/CHRIST LA MESA CHARLEY BROWNS CHILDREN CENTER,CHILD_LUNCH,22,6,4,76,86,88,58,1110,1256,57.0909
SAN DIEGO,Mar 2015,CACF,2015,UNITED CHURCH/CHRIST LA MESA CHARLEY BROWNS CHILDREN CENTER,CHILD_SNACK_PM,22,6,4,76,86,78,52,984,1114,50.6364
SAN DIEGO,Apr 2015,CACF,2015,UNITED CHURCH/CHRIST LA MESA CHARLEY BROWNS CHILDREN CENTER,CHILD_BREAKFAST,22,6,4,76,86,72,48,918,1038,47.1818
SAN DIEGO,Apr 2015,CACF,2015,UNITED CHURCH/CHRIST LA MESA CHARLEY BROWNS CHILDREN CENTER,CHILD_LUNCH,22,6,4,76,86,91,60,1147,1298,59
SAN DIEGO,Apr 2015,CACF,2015,UNITED CHURCH/CHRIST LA MESA CHARLEY BROWNS CHILDREN CENTER,CHILD_SNACK_PM,22,6,4,76,86,80,53,1011,1144,52
SAN DIEGO,May 2015,CACF,2015,UNITED CHURCH/CHRIST LA MESA CHARLEY BROWNS CHILDREN CENTER,CHILD_BREAKFAST,20,6,4,76,86,72,48,910,1030,51.5
SAN DIEGO,May 2015,CACF,2015,UNITED CHURCH/CHRIST LA MESA CHARLEY BROWNS CHILDREN CENTER,CHILD_LUNCH,20,6,4,76,86,87,58,1101,1246,62.3
SAN DIEGO,May 2015,CACF,2015,UNITED CHURCH/CHRIST LA MESA CHARLEY BROWNS CHILDREN CENTER,CHILD_SNACK_PM,20,6,4,76,86,77,51,969,1097,54.85
SAN DIEGO,Jun 2015,CACF,2015,UNITED CHURCH/CHRIST LA MESA CHARLEY BROWNS CHILDREN CENTER,CHILD_BREAKFAST,22,6,4,76,86,69,46,870,985,44.7727
SAN DIEGO,Jun 2015,CACF,2015,UNITED CHURCH/CHRIST LA MESA CHARLEY BROWNS CHILDREN CENTER,CHILD_LUNCH,22,6,4,76,86,86,57,1088,1231,55.9545
SAN DIEGO,Jun 2015,CACF,2015,UNITED CHURCH/CHRIST LA MESA CHARLEY BROWNS CHILDREN CENTER,CHILD_SNACK_PM,22,6,4,76,86,80,53,1010,1143,51.9545
SAN DIEGO,Jul 2015,CACF,2015,UNITED CHURCH/CHRIST LA MESA CHARLEY BROWNS CHILDREN CENTER,CHILD_BREAKFAST,22,6,4,76,86,65,43,825,933,42.4091
SAN DIEGO,Jul 2015,CACF,2015,UNITED CHURCH/CHRIST LA MESA CHARLEY BROWNS CHILDREN CENTER,CHILD_LUNCH,22,6,4,76,86,81,54,1023,1158,52.6364
SAN DIEGO,Jul 2015,CACF,2015,UNITED CHURCH/CHRIST LA MESA CHARLEY BROWNS CHILDREN CENTER,CHILD_SNACK_PM,22,6,4,76,86,75,50,955,1080,49.0909
SAN DIEGO,Aug 2015,CACF,2015,UNITED CHURCH/CHRIST LA MESA CHARLEY BROWNS CHILDREN CENTER,CHILD_BREAKFAST,21,6,4,76,86,67,45,847,959,45.6667
SAN DIEGO,Aug 2015,CACF,2015,UNITED CHURCH/CHRIST LA MESA CHARLEY BROWNS CHILDREN CENTER,CHILD_LUNCH,21,6,4,76,86,80,53,1016,1149,54.7143
SAN DIEGO,Aug 2015,CACF,2015,UNITED CHURCH/CHRIST LA MESA CHARLEY BROWNS CHILDREN CENTER,CHILD_SNACK_PM,21,6,4,76,86,74,49,936,1059,50.4286
SAN DIEGO,Sep 2015,CACF,2015,UNITED CHURCH/CHRIST LA MESA CHARLEY BROWNS CHILDREN CENTER,CHILD_BREAKFAST,21,6,4,76,86,72,48,908,1028,48.9524
SAN DIEGO,Sep 2015,CACF,2015,UNITED CHURCH/CHRIST LA MESA CHARLEY BROWNS CHILDREN CENTER,CHILD_LUNCH,21,6,4,76,86,82,55,1042,1179,56.1429
SAN DIEGO,Sep 2015,CACF,2015,UNITED CHURCH/CHRIST LA MESA CHARLEY BROWNS CHILDREN CENTER,CHILD_SNACK_PM,21,6,4,76,86,74,49,937,1060,50.4762
SAN DIEGO,Oct 2014,CACF,2015,"University of California, San Diego",CHILD_BREAKFAST,23,22,6,131,159,264,72,1570,1906,82.8696
SAN DIEGO,Oct 2014,CACF,2015,"University of California, San Diego",CHILD_LUNCH,23,22,6,131,159,462,126,2753,3341,145.2609
SAN DIEGO,Oct 2014,CACF,2015,"University of California, San Diego",CHILD_SNACK_PM,23,22,6,131,159,451,123,2687,3261,141.7826
SAN DIEGO,Nov 2014,CACF,2015,"University of California, San Diego",CHILD_BREAKFAST,16,22,6,131,159,163,45,973,1181,73.8125
SAN DIEGO,Nov 2014,CACF,2015,"University of California, San Diego",CHILD_LUNCH,16,22,6,131,159,284,77,1691,2052,128.25
SAN DIEGO,Nov 2014,CACF,2015,"University of California, San Diego",CHILD_SNACK_PM,16,22,6,131,159,275,75,1635,1985,124.0625
SAN DIEGO,Dec 2014,CACF,2015,"University of California, San Diego",CHILD_BREAKFAST,17,22,6,131,159,188,51,1118,1357,79.8235
SAN DIEGO,Dec 2014,CACF,2015,"University of California, San Diego",CHILD_LUNCH,17,22,6,131,159,355,97,2111,2563,150.7647
SAN DIEGO,Dec 2014,CACF,2015,"University of California, San Diego",CHILD_SNACK_PM,17,22,6,131,159,337,92,2009,2438,143.4118
SAN DIEGO,Jan 2015,CACF,2015,"University of California, San Diego",CHILD_BREAKFAST,19,22,6,131,159,224,61,1336,1621,85.3158
SAN DIEGO,Jan 2015,CACF,2015,"University of California, San Diego",CHILD_LUNCH,19,22,6,131,159,408,111,2432,2951,155.3158
SAN DIEGO,Jan 2015,CACF,2015,"University of California, San Diego",CHILD_SNACK_PM,19,22,6,131,159,394,107,2349,2850,150
SAN DIEGO,Feb 2015,CACF,2015,"University of California, San Diego",CHILD_BREAKFAST,19,23,6,139,168,253,66,1528,1847,97.2105
SAN DIEGO,Feb 2015,CACF,2015,"University of California, San Diego",CHILD_LUNCH,19,23,6,139,168,435,114,2631,3180,167.3684
SAN DIEGO,Feb 2015,CACF,2015,"University of California, San Diego",CHILD_SNACK_PM,19,23,6,139,168,412,108,2493,3013,158.5789
SAN DIEGO,Mar 2015,CACF,2015,"University of California, San Diego",CHILD_BREAKFAST,20,29,7,162,198,266,64,1486,1816,90.8
SAN DIEGO,Mar 2015,CACF,2015,"University of California, San Diego",CHILD_LUNCH,20,29,7,162,198,502,121,2803,3426,171.3
SAN DIEGO,Mar 2015,CACF,2015,"University of California, San Diego",CHILD_SNACK_PM,20,29,7,162,198,488,118,2722,3328,166.4
SAN DIEGO,Apr 2015,CACF,2015,"University of California, San Diego",CHILD_BREAKFAST,22,29,7,162,198,309,75,1727,2111,95.9545
SAN DIEGO,Apr 2015,CACF,2015,"University of California, San Diego",CHILD_LUNCH,22,29,7,162,198,557,135,3113,3805,172.9545
SAN DIEGO,Apr 2015,CACF,2015,"University of California, San Diego",CHILD_SNACK_PM,22,29,7,162,198,545,132,3041,3718,169
SAN DIEGO,May 2015,CACF,2015,"University of California, San Diego",CHILD_BREAKFAST,20,29,7,162,198,278,67,1550,1895,94.75
SAN DIEGO,May 2015,CACF,2015,"University of California, San Diego",CHILD_LUNCH,20,29,7,162,198,515,124,2877,3516,175.8
SAN DIEGO,May 2015,CACF,2015,"University of California, San Diego",CHILD_SNACK_PM,20,29,7,162,198,498,120,2781,3399,169.95
SAN DIEGO,Jun 2015,CACF,2015,"University of California, San Diego",CHILD_BREAKFAST,22,29,7,162,198,290,70,1617,1977,89.8636
SAN DIEGO,Jun 2015,CACF,2015,"University of California, San Diego",CHILD_LUNCH,22,29,7,162,198,528,128,2949,3605,163.8636
SAN DIEGO,Jun 2015,CACF,2015,"University of California, San Diego",CHILD_SNACK_PM,22,29,7,162,198,515,124,2875,3514,159.7273
SAN DIEGO,Jul 2015,CACF,2015,"University of California, San Diego",CHILD_BREAKFAST,22,29,7,162,198,266,64,1486,1816,82.5455
SAN DIEGO,Jul 2015,CACF,2015,"University of California, San Diego",CHILD_LUNCH,22,29,7,162,198,485,117,2711,3313,150.5909
SAN DIEGO,Jul 2015,CACF,2015,"University of California, San Diego",CHILD_SNACK_PM,22,29,7,162,198,467,113,2610,3190,145
SAN DIEGO,Aug 2015,CACF,2015,"University of California, San Diego",CHILD_BREAKFAST,21,29,7,162,198,258,62,1438,1758,83.7143
SAN DIEGO,Aug 2015,CACF,2015,"University of California, San Diego",CHILD_LUNCH,21,29,7,162,198,473,114,2639,3226,153.619
SAN DIEGO,Aug 2015,CACF,2015,"University of California, San Diego",CHILD_SNACK_PM,21,29,7,162,198,428,103,2391,2922,139.1429
SAN DIEGO,Sep 2015,CACF,2015,"University of California, San Diego",CHILD_BREAKFAST,20,29,7,162,198,248,60,1386,1694,84.7
SAN DIEGO,Sep 2015,CACF,2015,"University of California, San Diego",CHILD_LUNCH,20,29,7,162,198,439,106,2452,2997,149.85
SAN DIEGO,Sep 2015,CACF,2015,"University of California, San Diego",CHILD_SNACK_PM,20,29,7,162,198,420,101,2345,2866,143.3
SAN DIEGO,Oct 2014,CACF,2015,VISIONS OF GOD CHRISTIAN FELLOWSHIP,CHILD_BREAKFAST,23,19,8,16,43,221,93,186,500,21.7391
SAN DIEGO,Oct 2014,CACF,2015,VISIONS OF GOD CHRISTIAN FELLOWSHIP,CHILD_LUNCH,23,19,8,16,43,302,127,255,684,29.7391
SAN DIEGO,Oct 2014,CACF,2015,VISIONS OF GOD CHRISTIAN FELLOWSHIP,CHILD_SNACK_PM,23,19,8,16,43,278,117,234,629,27.3478
SAN DIEGO,Nov 2014,CACF,2015,VISIONS OF GOD CHRISTIAN FELLOWSHIP,CHILD_BREAKFAST,17,19,8,16,43,177,74,149,400,23.5294
SAN DIEGO,Nov 2014,CACF,2015,VISIONS OF GOD CHRISTIAN FELLOWSHIP,CHILD_LUNCH,17,19,8,16,43,241,102,203,546,32.1176
SAN DIEGO,Nov 2014,CACF,2015,VISIONS OF GOD CHRISTIAN FELLOWSHIP,CHILD_SNACK_PM,17,19,8,16,43,213,90,180,483,28.4118
SAN DIEGO,Dec 2014,CACF,2015,VISIONS OF GOD CHRISTIAN FELLOWSHIP,CHILD_BREAKFAST,18,19,8,16,43,186,78,158,422,23.4444
SAN DIEGO,Dec 2014,CACF,2015,VISIONS OF GOD CHRISTIAN FELLOWSHIP,CHILD_LUNCH,18,19,8,16,43,242,102,204,548,30.4444
SAN DIEGO,Dec 2014,CACF,2015,VISIONS OF GOD CHRISTIAN FELLOWSHIP,CHILD_SNACK_PM,18,19,8,16,43,226,95,191,512,28.4444
SAN DIEGO,Jan 2015,CACF,2015,VISIONS OF GOD CHRISTIAN FELLOWSHIP,CHILD_BREAKFAST,19,19,8,16,43,215,90,181,486,25.5789
SAN DIEGO,Jan 2015,CACF,2015,VISIONS OF GOD CHRISTIAN FELLOWSHIP,CHILD_LUNCH,19,19,8,16,43,297,125,249,671,35.3158
SAN DIEGO,Jan 2015,CACF,2015,VISIONS OF GOD CHRISTIAN FELLOWSHIP,CHILD_SNACK_PM,19,19,8,16,43,264,111,222,597,31.4211
SAN DIEGO,Feb 2015,CACF,2015,VISIONS OF GOD CHRISTIAN FELLOWSHIP,CHILD_BREAKFAST,19,19,8,16,43,239,100,201,540,28.4211
SAN DIEGO,Feb 2015,CACF,2015,VISIONS OF GOD CHRISTIAN FELLOWSHIP,CHILD_LUNCH,19,19,8,16,43,315,132,265,712,37.4737
SAN DIEGO,Feb 2015,CACF,2015,VISIONS OF GOD CHRISTIAN FELLOWSHIP,CHILD_SNACK_PM,19,19,8,16,43,277,116,233,626,32.9474
SAN DIEGO,Mar 2015,CACF,2015,VISIONS OF GOD CHRISTIAN FELLOWSHIP,CHILD_BREAKFAST,22,19,8,16,43,275,116,232,623,28.3182
SAN DIEGO,Mar 2015,CACF,2015,VISIONS OF GOD CHRISTIAN FELLOWSHIP,CHILD_LUNCH,22,19,8,16,43,351,148,296,795,36.1364
SAN DIEGO,Mar 2015,CACF,2015,VISIONS OF GOD CHRISTIAN FELLOWSHIP,CHILD_SNACK_PM,22,19,8,16,43,300,126,252,678,30.8182
SAN DIEGO,Apr 2015,CACF,2015,VISIONS OF GOD CHRISTIAN FELLOWSHIP,CHILD_BREAKFAST,21,19,8,16,43,267,113,225,605,28.8095
SAN DIEGO,Apr 2015,CACF,2015,VISIONS OF GOD CHRISTIAN FELLOWSHIP,CHILD_LUNCH,21,19,8,16,43,373,157,313,843,40.1429
SAN DIEGO,Apr 2015,CACF,2015,VISIONS OF GOD CHRISTIAN FELLOWSHIP,CHILD_SNACK_PM,21,19,8,16,43,331,139,278,748,35.619
SAN DIEGO,May 2015,CACF,2015,VISIONS OF GOD CHRISTIAN FELLOWSHIP,CHILD_BREAKFAST,20,19,8,16,43,262,110,221,593,29.65
SAN DIEGO,May 2015,CACF,2015,VISIONS OF GOD CHRISTIAN FELLOWSHIP,CHILD_LUNCH,20,19,8,16,43,355,149,299,803,40.15
SAN DIEGO,May 2015,CACF,2015,VISIONS OF GOD CHRISTIAN FELLOWSHIP,CHILD_SNACK_PM,20,19,8,16,43,331,139,278,748,37.4
SAN DIEGO,Jun 2015,CACF,2015,VISIONS OF GOD CHRISTIAN FELLOWSHIP,CHILD_BREAKFAST,22,23,12,19,54,280,146,231,657,29.8636
SAN DIEGO,Jun 2015,CACF,2015,VISIONS OF GOD CHRISTIAN FELLOWSHIP,CHILD_LUNCH,22,23,12,19,54,387,202,320,909,41.3182
SAN DIEGO,Jun 2015,CACF,2015,VISIONS OF GOD CHRISTIAN FELLOWSHIP,CHILD_SNACK_PM,22,23,12,19,54,338,176,279,793,36.0455
SAN DIEGO,Jul 2015,CACF,2015,VISIONS OF GOD CHRISTIAN FELLOWSHIP,CHILD_BREAKFAST,22,23,12,19,54,256,134,211,601,27.3182
SAN DIEGO,Jul 2015,CACF,2015,VISIONS OF GOD CHRISTIAN FELLOWSHIP,CHILD_LUNCH,22,23,12,19,54,356,186,293,835,37.9545
SAN DIEGO,Jul 2015,CACF,2015,VISIONS OF GOD CHRISTIAN FELLOWSHIP,CHILD_SNACK_PM,22,23,12,19,54,325,170,268,763,34.6818
SAN DIEGO,Aug 2015,CACF,2015,VISIONS OF GOD CHRISTIAN FELLOWSHIP,CHILD_BREAKFAST,21,23,12,19,54,251,131,208,590,28.0952
SAN DIEGO,Aug 2015,CACF,2015,VISIONS OF GOD CHRISTIAN FELLOWSHIP,CHILD_LUNCH,21,23,12,19,54,372,194,307,873,41.5714
SAN DIEGO,Aug 2015,CACF,2015,VISIONS OF GOD CHRISTIAN FELLOWSHIP,CHILD_SNACK_PM,21,23,12,19,54,333,174,275,782,37.2381
SAN DIEGO,Sep 2015,CACF,2015,VISIONS OF GOD CHRISTIAN FELLOWSHIP,CHILD_BREAKFAST,20,16,8,19,43,217,109,258,584,29.2
SAN DIEGO,Sep 2015,CACF,2015,VISIONS OF GOD CHRISTIAN FELLOWSHIP,CHILD_LUNCH,20,16,8,19,43,274,137,325,736,36.8
SAN DIEGO,Sep 2015,CACF,2015,VISIONS OF GOD CHRISTIAN FELLOWSHIP,CHILD_SNACK_PM,20,16,8,19,43,214,107,254,575,28.75
SAN DIEGO,Oct 2014,CACF,2015,VISTA UNIFIED SCHOOL DISTRICT,ATRISK_CHILD_SUPPER,23,9691,0,0,9691,45013,0,0,45013,1957.087
SAN DIEGO,Nov 2014,CACF,2015,VISTA UNIFIED SCHOOL DISTRICT,ATRISK_CHILD_SUPPER,18,9717,0,0,9717,25830,0,0,25830,1435
SAN DIEGO,Dec 2014,CACF,2015,VISTA UNIFIED SCHOOL DISTRICT,ATRISK_CHILD_SUPPER,21,87,0,0,87,1822,0,0,1822,86.7619
SAN DIEGO,Jan 2015,CACF,2015,VISTA UNIFIED SCHOOL DISTRICT,ATRISK_CHILD_SUPPER,19,9688,0,0,9688,36808,0,0,36808,1937.2632
SAN DIEGO,Feb 2015,CACF,2015,VISTA UNIFIED SCHOOL DISTRICT,ATRISK_CHILD_SUPPER,19,9695,0,0,9695,36742,0,0,36742,1933.7895
SAN DIEGO,Mar 2015,CACF,2015,VISTA UNIFIED SCHOOL DISTRICT,ATRISK_CHILD_SUPPER,22,2011,0,0,2011,32517,0,0,32517,1478.0455
SAN DIEGO,Apr 2015,CACF,2015,VISTA UNIFIED SCHOOL DISTRICT,ATRISK_CHILD_SUPPER,22,1996,0,0,1996,43751,0,0,43751,1988.6818
SAN DIEGO,May 2015,CACF,2015,VISTA UNIFIED SCHOOL DISTRICT,ATRISK_CHILD_SUPPER,20,1891,0,0,1891,37666,0,0,37666,1883.3
SAN DIEGO,Jun 2015,CACF,2015,VISTA UNIFIED SCHOOL DISTRICT,ATRISK_CHILD_SUPPER,4,1499,0,0,1499,5968,0,0,5968,1492
SAN DIEGO,Aug 2015,CACF,2015,VISTA UNIFIED SCHOOL DISTRICT,ATRISK_CHILD_SUPPER,11,9094,0,0,9094,19700,0,0,19700,1790.9091
SAN DIEGO,Sep 2015,CACF,2015,VISTA UNIFIED SCHOOL DISTRICT,ATRISK_CHILD_SUPPER,21,9301,0,0,9301,39133,0,0,39133,1863.4762
SAN DIEGO,Oct 2014,CACF,2015,VOLUNTEERS OF AMERICA SOUTHWEST CA CORP,CHILD_BREAKFAST,23,144,28,12,184,1730,337,144,2211,96.1304
SAN DIEGO,Oct 2014,CACF,2015,VOLUNTEERS OF AMERICA SOUTHWEST CA CORP,CHILD_LUNCH,23,144,28,12,184,1628,317,135,2080,90.4348
SAN DIEGO,Oct 2014,CACF,2015,VOLUNTEERS OF AMERICA SOUTHWEST CA CORP,CHILD_SNACK_PM,23,144,28,12,184,1567,305,130,2002,87.0435
SAN DIEGO,Oct 2014,CACF,2015,VOLUNTEERS OF AMERICA SOUTHWEST CA CORP,HS_CHILD_BREAKFAST,23,235,0,0,235,866,0,0,866,37.6522
SAN DIEGO,Oct 2014,CACF,2015,VOLUNTEERS OF AMERICA SOUTHWEST CA CORP,HS_CHILD_LUNCH,23,235,0,0,235,1035,0,0,1035,45
SAN DIEGO,Oct 2014,CACF,2015,VOLUNTEERS OF AMERICA SOUTHWEST CA CORP,HS_CHILD_SNACK_PM,23,235,0,0,235,638,0,0,638,27.7391
SAN DIEGO,Nov 2014,CACF,2015,VOLUNTEERS OF AMERICA SOUTHWEST CA CORP,CHILD_BREAKFAST,18,144,28,12,184,1331,259,111,1701,94.5
SAN DIEGO,Nov 2014,CACF,2015,VOLUNTEERS OF AMERICA SOUTHWEST CA CORP,CHILD_LUNCH,18,144,28,12,184,1287,250,107,1644,91.3333
SAN DIEGO,Nov 2014,CACF,2015,VOLUNTEERS OF AMERICA SOUTHWEST CA CORP,CHILD_SNACK_PM,18,144,28,12,184,1200,233,100,1533,85.1667
SAN DIEGO,Nov 2014,CACF,2015,VOLUNTEERS OF AMERICA SOUTHWEST CA CORP,HS_CHILD_BREAKFAST,18,235,0,0,235,634,0,0,634,35.2222
SAN DIEGO,Nov 2014,CACF,2015,VOLUNTEERS OF AMERICA SOUTHWEST CA CORP,HS_CHILD_LUNCH,18,235,0,0,235,758,0,0,758,42.1111
SAN DIEGO,Nov 2014,CACF,2015,VOLUNTEERS OF AMERICA SOUTHWEST CA CORP,HS_CHILD_SNACK_PM,18,235,0,0,235,479,0,0,479,26.6111
SAN DIEGO,Dec 2014,CACF,2015,VOLUNTEERS OF AMERICA SOUTHWEST CA CORP,CHILD_BREAKFAST,18,144,28,12,184,1242,242,103,1587,88.1667
SAN DIEGO,Dec 2014,CACF,2015,VOLUNTEERS OF AMERICA SOUTHWEST CA CORP,CHILD_LUNCH,18,144,28,12,184,1216,237,101,1554,86.3333
SAN DIEGO,Dec 2014,CACF,2015,VOLUNTEERS OF AMERICA SOUTHWEST CA CORP,CHILD_SNACK_PM,18,144,28,12,184,1154,224,96,1474,81.8889
SAN DIEGO,Dec 2014,CACF,2015,VOLUNTEERS OF AMERICA SOUTHWEST CA CORP,HS_CHILD_BREAKFAST,17,235,0,0,235,506,0,0,506,29.7647
SAN DIEGO,Dec 2014,CACF,2015,VOLUNTEERS OF AMERICA SOUTHWEST CA CORP,HS_CHILD_LUNCH,17,235,0,0,235,599,0,0,599,35.2353
SAN DIEGO,Dec 2014,CACF,2015,VOLUNTEERS OF AMERICA SOUTHWEST CA CORP,HS_CHILD_SNACK_PM,17,235,0,0,235,382,0,0,382,22.4706
SAN DIEGO,Jan 2015,CACF,2015,VOLUNTEERS OF AMERICA SOUTHWEST CA CORP,CHILD_BREAKFAST,19,144,28,12,184,1360,265,113,1738,91.4737
SAN DIEGO,Jan 2015,CACF,2015,VOLUNTEERS OF AMERICA SOUTHWEST CA CORP,CHILD_LUNCH,19,144,28,12,184,1246,242,104,1592,83.7895
SAN DIEGO,Jan 2015,CACF,2015,VOLUNTEERS OF AMERICA SOUTHWEST CA CORP,CHILD_SNACK_PM,19,144,28,12,184,1287,250,107,1644,86.5263
SAN DIEGO,Jan 2015,CACF,2015,VOLUNTEERS OF AMERICA SOUTHWEST CA CORP,HS_CHILD_BREAKFAST,19,235,0,0,235,624,0,0,624,32.8421
SAN DIEGO,Jan 2015,CACF,2015,VOLUNTEERS OF AMERICA SOUTHWEST CA CORP,HS_CHILD_LUNCH,19,235,0,0,235,734,0,0,734,38.6316
SAN DIEGO,Jan 2015,CACF,2015,VOLUNTEERS OF AMERICA SOUTHWEST CA CORP,HS_CHILD_SNACK_PM,19,235,0,0,235,424,0,0,424,22.3158
SAN DIEGO,Feb 2015,CACF,2015,VOLUNTEERS OF AMERICA SOUTHWEST CA CORP,CHILD_BREAKFAST,19,144,28,12,184,1382,269,115,1766,92.9474
SAN DIEGO,Feb 2015,CACF,2015,VOLUNTEERS OF AMERICA SOUTHWEST CA CORP,CHILD_LUNCH,19,144,28,12,184,1356,264,113,1733,91.2105
SAN DIEGO,Feb 2015,CACF,2015,VOLUNTEERS OF AMERICA SOUTHWEST CA CORP,CHILD_SNACK_PM,19,144,28,12,184,1338,260,112,1710,90
SAN DIEGO,Feb 2015,CACF,2015,VOLUNTEERS OF AMERICA SOUTHWEST CA CORP,HS_CHILD_BREAKFAST,19,235,0,0,235,698,0,0,698,36.7368
SAN DIEGO,Feb 2015,CACF,2015,VOLUNTEERS OF AMERICA SOUTHWEST CA CORP,HS_CHILD_LUNCH,19,235,0,0,235,797,0,0,797,41.9474
SAN DIEGO,Feb 2015,CACF,2015,VOLUNTEERS OF AMERICA SOUTHWEST CA CORP,HS_CHILD_SNACK_PM,19,235,0,0,235,491,0,0,491,25.8421
SAN DIEGO,Mar 2015,CACF,2015,VOLUNTEERS OF AMERICA SOUTHWEST CA CORP,CHILD_BREAKFAST,22,144,28,12,184,1526,297,127,1950,88.6364
SAN DIEGO,Mar 2015,CACF,2015,VOLUNTEERS OF AMERICA SOUTHWEST CA CORP,CHILD_LUNCH,22,144,28,12,184,1486,289,124,1899,86.3182
SAN DIEGO,Mar 2015,CACF,2015,VOLUNTEERS OF AMERICA SOUTHWEST CA CORP,CHILD_SNACK_PM,22,144,28,12,184,1517,295,126,1938,88.0909
SAN DIEGO,Mar 2015,CACF,2015,VOLUNTEERS OF AMERICA SOUTHWEST CA CORP,HS_CHILD_BREAKFAST,22,235,0,0,235,859,0,0,859,39.0455
SAN DIEGO,Mar 2015,CACF,2015,VOLUNTEERS OF AMERICA SOUTHWEST CA CORP,HS_CHILD_LUNCH,22,235,0,0,235,1003,0,0,1003,45.5909
SAN DIEGO,Mar 2015,CACF,2015,VOLUNTEERS OF AMERICA SOUTHWEST CA CORP,HS_CHILD_SNACK_PM,22,235,0,0,235,599,0,0,599,27.2273
SAN DIEGO,Apr 2015,CACF,2015,VOLUNTEERS OF AMERICA SOUTHWEST CA CORP,CHILD_BREAKFAST,20,144,28,12,184,1591,309,133,2033,101.65
SAN DIEGO,Apr 2015,CACF,2015,VOLUNTEERS OF AMERICA SOUTHWEST CA CORP,CHILD_LUNCH,20,144,28,12,184,1550,302,129,1981,99.05
SAN DIEGO,Apr 2015,CACF,2015,VOLUNTEERS OF AMERICA SOUTHWEST CA CORP,CHILD_SNACK_PM,20,144,28,12,184,1547,301,129,1977,98.85
SAN DIEGO,Apr 2015,CACF,2015,VOLUNTEERS OF AMERICA SOUTHWEST CA CORP,HS_CHILD_BREAKFAST,19,235,0,0,235,853,0,0,853,44.8947
SAN DIEGO,Apr 2015,CACF,2015,VOLUNTEERS OF AMERICA SOUTHWEST CA CORP,HS_CHILD_LUNCH,19,235,0,0,235,962,0,0,962,50.6316
SAN DIEGO,Apr 2015,CACF,2015,VOLUNTEERS OF AMERICA SOUTHWEST CA CORP,HS_CHILD_SNACK_PM,19,235,0,0,235,606,0,0,606,31.8947
SAN DIEGO,May 2015,CACF,2015,VOLUNTEERS OF AMERICA SOUTHWEST CA CORP,CHILD_BREAKFAST,20,144,28,12,184,1517,295,126,1938,96.9
SAN DIEGO,May 2015,CACF,2015,VOLUNTEERS OF AMERICA SOUTHWEST CA CORP,CHILD_LUNCH,20,144,28,12,184,1413,275,117,1805,90.25
SAN DIEGO,May 2015,CACF,2015,VOLUNTEERS OF AMERICA SOUTHWEST CA CORP,CHILD_SNACK_PM,20,144,28,12,184,1321,257,110,1688,84.4
SAN DIEGO,May 2015,CACF,2015,VOLUNTEERS OF AMERICA SOUTHWEST CA CORP,HS_CHILD_BREAKFAST,20,235,0,0,235,818,0,0,818,40.9
SAN DIEGO,May 2015,CACF,2015,VOLUNTEERS OF AMERICA SOUTHWEST CA CORP,HS_CHILD_LUNCH,20,235,0,0,235,920,0,0,920,46
SAN DIEGO,May 2015,CACF,2015,VOLUNTEERS OF AMERICA SOUTHWEST CA CORP,HS_CHILD_SNACK_PM,20,235,0,0,235,517,0,0,517,25.85
SAN DIEGO,Jun 2015,CACF,2015,VOLUNTEERS OF AMERICA SOUTHWEST CA CORP,CHILD_BREAKFAST,22,144,28,12,184,1342,261,112,1715,77.9545
SAN DIEGO,Jun 2015,CACF,2015,VOLUNTEERS OF AMERICA SOUTHWEST CA CORP,CHILD_LUNCH,22,144,28,12,184,1343,261,112,1716,78
SAN DIEGO,Jun 2015,CACF,2015,VOLUNTEERS OF AMERICA SOUTHWEST CA CORP,CHILD_SNACK_PM,22,144,28,12,184,1226,238,102,1566,71.1818
SAN DIEGO,Jun 2015,CACF,2015,VOLUNTEERS OF AMERICA SOUTHWEST CA CORP,HS_CHILD_BREAKFAST,22,235,0,0,235,790,0,0,790,35.9091
SAN DIEGO,Jun 2015,CACF,2015,VOLUNTEERS OF AMERICA SOUTHWEST CA CORP,HS_CHILD_LUNCH,22,235,0,0,235,947,0,0,947,43.0455
SAN DIEGO,Jun 2015,CACF,2015,VOLUNTEERS OF AMERICA SOUTHWEST CA CORP,HS_CHILD_SNACK_PM,22,235,0,0,235,572,0,0,572,26
SAN DIEGO,Jul 2015,CACF,2015,VOLUNTEERS OF AMERICA SOUTHWEST CA CORP,CHILD_BREAKFAST,20,144,28,12,184,1272,247,106,1625,81.25
SAN DIEGO,Jul 2015,CACF,2015,VOLUNTEERS OF AMERICA SOUTHWEST CA CORP,CHILD_LUNCH,20,144,28,12,184,1215,236,101,1552,77.6
SAN DIEGO,Jul 2015,CACF,2015,VOLUNTEERS OF AMERICA SOUTHWEST CA CORP,CHILD_SNACK_PM,20,144,28,12,184,908,177,75,1160,58
SAN DIEGO,Jul 2015,CACF,2015,VOLUNTEERS OF AMERICA SOUTHWEST CA CORP,HS_CHILD_BREAKFAST,20,235,0,0,235,642,0,0,642,32.1
SAN DIEGO,Jul 2015,CACF,2015,VOLUNTEERS OF AMERICA SOUTHWEST CA CORP,HS_CHILD_LUNCH,20,235,0,0,235,775,0,0,775,38.75
SAN DIEGO,Jul 2015,CACF,2015,VOLUNTEERS OF AMERICA SOUTHWEST CA CORP,HS_CHILD_SNACK_PM,20,235,0,0,235,488,0,0,488,24.4
SAN DIEGO,Aug 2015,CACF,2015,VOLUNTEERS OF AMERICA SOUTHWEST CA CORP,CHILD_BREAKFAST,21,144,28,12,184,1542,300,128,1970,93.8095
SAN DIEGO,Aug 2015,CACF,2015,VOLUNTEERS OF AMERICA SOUTHWEST CA CORP,CHILD_LUNCH,21,144,28,12,184,1509,293,126,1928,91.8095
SAN DIEGO,Aug 2015,CACF,2015,VOLUNTEERS OF AMERICA SOUTHWEST CA CORP,CHILD_SNACK_PM,21,144,28,12,184,684,133,57,874,41.619
SAN DIEGO,Aug 2015,CACF,2015,VOLUNTEERS OF AMERICA SOUTHWEST CA CORP,HS_CHILD_BREAKFAST,21,235,0,0,235,783,0,0,783,37.2857
SAN DIEGO,Aug 2015,CACF,2015,VOLUNTEERS OF AMERICA SOUTHWEST CA CORP,HS_CHILD_LUNCH,21,235,0,0,235,933,0,0,933,44.4286
SAN DIEGO,Aug 2015,CACF,2015,VOLUNTEERS OF AMERICA SOUTHWEST CA CORP,HS_CHILD_SNACK_PM,21,235,0,0,235,521,0,0,521,24.8095
SAN DIEGO,Sep 2015,CACF,2015,VOLUNTEERS OF AMERICA SOUTHWEST CA CORP,CHILD_BREAKFAST,21,144,28,12,184,1661,323,138,2122,101.0476
SAN DIEGO,Sep 2015,CACF,2015,VOLUNTEERS OF AMERICA SOUTHWEST CA CORP,CHILD_LUNCH,21,144,28,12,184,1646,320,137,2103,100.1429
SAN DIEGO,Sep 2015,CACF,2015,VOLUNTEERS OF AMERICA SOUTHWEST CA CORP,CHILD_SNACK_PM,21,144,28,12,184,814,158,68,1040,49.5238
SAN DIEGO,Sep 2015,CACF,2015,VOLUNTEERS OF AMERICA SOUTHWEST CA CORP,HS_CHILD_BREAKFAST,21,235,0,0,235,878,0,0,878,41.8095
SAN DIEGO,Sep 2015,CACF,2015,VOLUNTEERS OF AMERICA SOUTHWEST CA CORP,HS_CHILD_LUNCH,21,235,0,0,235,993,0,0,993,47.2857
SAN DIEGO,Sep 2015,CACF,2015,VOLUNTEERS OF AMERICA SOUTHWEST CA CORP,HS_CHILD_SNACK_PM,21,235,0,0,235,585,0,0,585,27.8571
SAN DIEGO,Oct 2014,CACF,2015,WESTERN CONSULTING & ANCILLARY SERVICES INC,ADULT_BREAKFAST,23,142,0,10,152,1914,0,135,2049,89.087
SAN DIEGO,Oct 2014,CACF,2015,WESTERN CONSULTING & ANCILLARY SERVICES INC,ADULT_LUNCH,23,142,0,10,152,1914,0,135,2049,89.087
SAN DIEGO,Oct 2014,CACF,2015,WESTERN CONSULTING & ANCILLARY SERVICES INC,ADULT_SNACK_PM,23,142,0,10,152,211,0,15,226,9.8261
SAN DIEGO,Nov 2014,CACF,2015,WESTERN CONSULTING & ANCILLARY SERVICES INC,ADULT_BREAKFAST,19,142,0,10,152,1585,0,112,1697,89.3158
SAN DIEGO,Nov 2014,CACF,2015,WESTERN CONSULTING & ANCILLARY SERVICES INC,ADULT_LUNCH,19,142,0,10,152,1585,0,112,1697,89.3158
SAN DIEGO,Nov 2014,CACF,2015,WESTERN CONSULTING & ANCILLARY SERVICES INC,ADULT_SNACK_PM,19,142,0,10,152,149,0,10,159,8.3684
SAN DIEGO,Dec 2014,CACF,2015,WESTERN CONSULTING & ANCILLARY SERVICES INC,ADULT_BREAKFAST,22,142,0,10,152,1915,0,135,2050,93.1818
SAN DIEGO,Dec 2014,CACF,2015,WESTERN CONSULTING & ANCILLARY SERVICES INC,ADULT_LUNCH,22,142,0,10,152,1921,0,135,2056,93.4545
SAN DIEGO,Dec 2014,CACF,2015,WESTERN CONSULTING & ANCILLARY SERVICES INC,ADULT_SNACK_PM,22,142,0,10,152,141,0,10,151,6.8636
SAN DIEGO,Jan 2015,CACF,2015,WESTERN CONSULTING & ANCILLARY SERVICES INC,ADULT_BREAKFAST,21,142,0,10,152,1732,0,122,1854,88.2857
SAN DIEGO,Jan 2015,CACF,2015,WESTERN CONSULTING & ANCILLARY SERVICES INC,ADULT_LUNCH,21,142,0,10,152,1732,0,122,1854,88.2857
SAN DIEGO,Jan 2015,CACF,2015,WESTERN CONSULTING & ANCILLARY SERVICES INC,ADULT_SNACK_PM,21,142,0,10,152,54,0,4,58,2.7619
SAN DIEGO,Feb 2015,CACF,2015,WESTERN CONSULTING & ANCILLARY SERVICES INC,ADULT_BREAKFAST,20,142,0,10,152,1612,0,114,1726,86.3
SAN DIEGO,Feb 2015,CACF,2015,WESTERN CONSULTING & ANCILLARY SERVICES INC,ADULT_LUNCH,20,142,0,10,152,1698,0,120,1818,90.9
SAN DIEGO,Feb 2015,CACF,2015,WESTERN CONSULTING & ANCILLARY SERVICES INC,ADULT_SNACK_PM,20,142,0,10,152,113,0,8,121,6.05
SAN DIEGO,Mar 2015,CACF,2015,WESTERN CONSULTING & ANCILLARY SERVICES INC,ADULT_BREAKFAST,22,142,0,10,152,1849,0,130,1979,89.9545
SAN DIEGO,Mar 2015,CACF,2015,WESTERN CONSULTING & ANCILLARY SERVICES INC,ADULT_LUNCH,22,142,0,10,152,1892,0,133,2025,92.0455
SAN DIEGO,Mar 2015,CACF,2015,WESTERN CONSULTING & ANCILLARY SERVICES INC,ADULT_SNACK_PM,22,142,0,10,152,106,0,7,113,5.1364
SAN DIEGO,Apr 2015,CACF,2015,WESTERN CONSULTING & ANCILLARY SERVICES INC,ADULT_BREAKFAST,22,142,0,10,152,1791,0,126,1917,87.1364
SAN DIEGO,Apr 2015,CACF,2015,WESTERN CONSULTING & ANCILLARY SERVICES INC,ADULT_LUNCH,22,142,0,10,152,1895,0,134,2029,92.2273
SAN DIEGO,May 2015,CACF,2015,WESTERN CONSULTING & ANCILLARY SERVICES INC,ADULT_BREAKFAST,20,142,0,10,152,1526,0,108,1634,81.7
SAN DIEGO,May 2015,CACF,2015,WESTERN CONSULTING & ANCILLARY SERVICES INC,ADULT_LUNCH,20,142,0,10,152,1688,0,119,1807,90.35
SAN DIEGO,May 2015,CACF,2015,WESTERN CONSULTING & ANCILLARY SERVICES INC,ADULT_SNACK_PM,20,142,0,10,152,102,0,7,109,5.45
SAN DIEGO,Jun 2015,CACF,2015,WESTERN CONSULTING & ANCILLARY SERVICES INC,ADULT_BREAKFAST,22,142,0,10,152,1655,0,117,1772,80.5455
SAN DIEGO,Jun 2015,CACF,2015,WESTERN CONSULTING & ANCILLARY SERVICES INC,ADULT_LUNCH,22,142,0,10,152,1772,0,125,1897,86.2273
SAN DIEGO,Jun 2015,CACF,2015,WESTERN CONSULTING & ANCILLARY SERVICES INC,ADULT_SNACK_PM,22,142,0,10,152,85,0,6,91,4.1364
SAN DIEGO,Jul 2015,CACF,2015,WESTERN CONSULTING & ANCILLARY SERVICES INC,ADULT_BREAKFAST,22,142,0,10,152,1580,0,111,1691,76.8636
SAN DIEGO,Jul 2015,CACF,2015,WESTERN CONSULTING & ANCILLARY SERVICES INC,ADULT_LUNCH,22,142,0,10,152,1795,0,126,1921,87.3182
SAN DIEGO,Jul 2015,CACF,2015,WESTERN CONSULTING & ANCILLARY SERVICES INC,ADULT_SNACK_PM,22,142,0,10,152,76,0,5,81,3.6818
SAN DIEGO,Aug 2015,CACF,2015,WESTERN CONSULTING & ANCILLARY SERVICES INC,ADULT_BREAKFAST,21,142,0,10,152,1459,0,103,1562,74.381
SAN DIEGO,Aug 2015,CACF,2015,WESTERN CONSULTING & ANCILLARY SERVICES INC,ADULT_LUNCH,21,142,0,10,152,1698,0,120,1818,86.5714
SAN DIEGO,Aug 2015,CACF,2015,WESTERN CONSULTING & ANCILLARY SERVICES INC,ADULT_SNACK_PM,21,142,0,10,152,90,0,6,96,4.5714
SAN DIEGO,Sep 2015,CACF,2015,WESTERN CONSULTING & ANCILLARY SERVICES INC,ADULT_BREAKFAST,21,142,0,10,152,1498,0,106,1604,76.381
SAN DIEGO,Sep 2015,CACF,2015,WESTERN CONSULTING & ANCILLARY SERVICES INC,ADULT_LUNCH,21,142,0,10,152,1709,0,120,1829,87.0952
SAN DIEGO,Sep 2015,CACF,2015,WESTERN CONSULTING & ANCILLARY SERVICES INC,ADULT_SNACK_PM,21,142,0,10,152,81,0,6,87,4.1429
SAN DIEGO,Oct 2014,CACF,2015,YWCA OF SAN DIEGO COUNTY,ES_CHILD_BREAKFAST,31,110,0,0,110,758,0,0,758,24.4516
SAN DIEGO,Oct 2014,CACF,2015,YWCA OF SAN DIEGO COUNTY,ES_CHILD_SNACK_PM,31,110,0,0,110,273,0,0,273,8.8065
SAN DIEGO,Oct 2014,CACF,2015,YWCA OF SAN DIEGO COUNTY,ES_CHILD_SUPPER,31,110,0,0,110,1206,0,0,1206,38.9032
SAN DIEGO,Nov 2014,CACF,2015,YWCA OF SAN DIEGO COUNTY,ES_CHILD_BREAKFAST,30,117,0,0,117,656,0,0,656,21.8667
SAN DIEGO,Nov 2014,CACF,2015,YWCA OF SAN DIEGO COUNTY,ES_CHILD_SNACK_PM,30,117,0,0,117,194,0,0,194,6.4667
SAN DIEGO,Nov 2014,CACF,2015,YWCA OF SAN DIEGO COUNTY,ES_CHILD_SUPPER,30,117,0,0,117,1061,0,0,1061,35.3667
SAN DIEGO,Dec 2014,CACF,2015,YWCA OF SAN DIEGO COUNTY,ES_CHILD_BREAKFAST,31,110,0,0,110,518,0,0,518,16.7097
SAN DIEGO,Dec 2014,CACF,2015,YWCA OF SAN DIEGO COUNTY,ES_CHILD_SNACK_PM,31,110,0,0,110,218,0,0,218,7.0323
SAN DIEGO,Dec 2014,CACF,2015,YWCA OF SAN DIEGO COUNTY,ES_CHILD_SUPPER,31,110,0,0,110,962,0,0,962,31.0323
SAN DIEGO,Jan 2015,CACF,2015,YWCA OF SAN DIEGO COUNTY,ES_CHILD_BREAKFAST,31,129,0,0,129,862,0,0,862,27.8065
SAN DIEGO,Jan 2015,CACF,2015,YWCA OF SAN DIEGO COUNTY,ES_CHILD_SNACK_PM,31,129,0,0,129,298,0,0,298,9.6129
SAN DIEGO,Jan 2015,CACF,2015,YWCA OF SAN DIEGO COUNTY,ES_CHILD_SUPPER,31,129,0,0,129,1085,0,0,1085,35
SAN DIEGO,Feb 2015,CACF,2015,YWCA OF SAN DIEGO COUNTY,ES_CHILD_BREAKFAST,28,126,0,0,126,728,0,0,728,26
SAN DIEGO,Feb 2015,CACF,2015,YWCA OF SAN DIEGO COUNTY,ES_CHILD_SNACK_PM,28,126,0,0,126,373,0,0,373,13.3214
SAN DIEGO,Feb 2015,CACF,2015,YWCA OF SAN DIEGO COUNTY,ES_CHILD_SUPPER,28,126,0,0,126,954,0,0,954,34.0714
SAN DIEGO,Mar 2015,CACF,2015,YWCA OF SAN DIEGO COUNTY,ES_CHILD_BREAKFAST,31,129,0,0,129,727,0,0,727,23.4516
SAN DIEGO,Mar 2015,CACF,2015,YWCA OF SAN DIEGO COUNTY,ES_CHILD_SNACK_PM,31,129,0,0,129,437,0,0,437,14.0968
SAN DIEGO,Mar 2015,CACF,2015,YWCA OF SAN DIEGO COUNTY,ES_CHILD_SUPPER,31,129,0,0,129,955,0,0,955,30.8065
SAN DIEGO,Apr 2015,CACF,2015,YWCA OF SAN DIEGO COUNTY,ES_CHILD_BREAKFAST,30,112,0,0,112,742,0,0,742,24.7333
SAN DIEGO,Apr 2015,CACF,2015,YWCA OF SAN DIEGO COUNTY,ES_CHILD_SNACK_PM,30,112,0,0,112,361,0,0,361,12.0333
SAN DIEGO,Apr 2015,CACF,2015,YWCA OF SAN DIEGO COUNTY,ES_CHILD_SUPPER,30,112,0,0,112,808,0,0,808,26.9333
SAN DIEGO,May 2015,CACF,2015,YWCA OF SAN DIEGO COUNTY,ES_CHILD_BREAKFAST,31,87,0,0,87,648,0,0,648,20.9032
SAN DIEGO,May 2015,CACF,2015,YWCA OF SAN DIEGO COUNTY,ES_CHILD_SNACK_PM,31,87,0,0,87,357,0,0,357,11.5161
SAN DIEGO,May 2015,CACF,2015,YWCA OF SAN DIEGO COUNTY,ES_CHILD_SUPPER,31,87,0,0,87,669,0,0,669,21.5806
SAN DIEGO,Jun 2015,CACF,2015,YWCA OF SAN DIEGO COUNTY,ES_CHILD_BREAKFAST,30,100,0,0,100,369,0,0,369,12.3
SAN DIEGO,Jun 2015,CACF,2015,YWCA OF SAN DIEGO COUNTY,ES_CHILD_SNACK_PM,30,100,0,0,100,337,0,0,337,11.2333
SAN DIEGO,Jun 2015,CACF,2015,YWCA OF SAN DIEGO COUNTY,ES_CHILD_SUPPER,30,100,0,0,100,647,0,0,647,21.5667
SAN DIEGO,Jul 2015,CACF,2015,YWCA OF SAN DIEGO COUNTY,ES_CHILD_BREAKFAST,31,101,0,0,101,430,0,0,430,13.871
SAN DIEGO,Jul 2015,CACF,2015,YWCA OF SAN DIEGO COUNTY,ES_CHILD_SNACK_PM,31,101,0,0,101,169,0,0,169,5.4516
SAN DIEGO,Jul 2015,CACF,2015,YWCA OF SAN DIEGO COUNTY,ES_CHILD_SUPPER,31,101,0,0,101,688,0,0,688,22.1935
SAN DIEGO,Aug 2015,CACF,2015,YWCA OF SAN DIEGO COUNTY,ES_CHILD_BREAKFAST,31,103,0,0,103,551,0,0,551,17.7742
SAN DIEGO,Aug 2015,CACF,2015,YWCA OF SAN DIEGO COUNTY,ES_CHILD_SNACK_PM,31,103,0,0,103,280,0,0,280,9.0323
SAN DIEGO,Aug 2015,CACF,2015,YWCA OF SAN DIEGO COUNTY,ES_CHILD_SUPPER,31,103,0,0,103,789,0,0,789,25.4516
SAN DIEGO,Sep 2015,CACF,2015,YWCA OF SAN DIEGO COUNTY,ES_CHILD_BREAKFAST,30,101,0,0,101,589,0,0,589,19.6333
SAN DIEGO,Sep 2015,CACF,2015,YWCA OF SAN DIEGO COUNTY,ES_CHILD_SNACK_PM,30,101,0,0,101,308,0,0,308,10.2667
SAN DIEGO,Sep 2015,CACF,2015,YWCA OF SAN DIEGO COUNTY,ES_CHILD_SUPPER,30,101,0,0,101,800,0,0,800,26.6667
