County,Claim Month/ Year,ProgramCode,Year,Name,Meal Group,Days Served,Free Eligible,Reduced Eligible,Paid Eligible,Enroll,Free Meals,Reduced Meals,Paid Meals,Total Meals,Average Daily Meals
SAN DIEGO,Jan 2014,CACF,2014,A B Vines Ministries,ATRISK_CHILD_SNACK,5,165,0,0,165,650,0,0,650,130
SAN DIEGO,Jan 2014,CACF,2014,A B Vines Ministries,ATRISK_CHILD_SUPPER,5,165,0,0,165,650,0,0,650,130
SAN DIEGO,Feb 2014,CACF,2014,A B Vines Ministries,ATRISK_CHILD_SNACK,19,190,0,0,190,2190,0,0,2190,115.2632
SAN DIEGO,Feb 2014,CACF,2014,A B Vines Ministries,ATRISK_CHILD_SUPPER,19,190,0,0,190,2710,0,0,2710,142.6316
SAN DIEGO,Mar 2014,CACF,2014,A B Vines Ministries,ATRISK_CHILD_SNACK,20,130,0,0,130,2150,0,0,2150,107.5
SAN DIEGO,Mar 2014,CACF,2014,A B Vines Ministries,ATRISK_CHILD_SUPPER,20,130,0,0,130,2150,0,0,2150,107.5
SAN DIEGO,Apr 2014,CACF,2014,A B Vines Ministries,ATRISK_CHILD_SNACK,22,130,0,0,130,2200,0,0,2200,100
SAN DIEGO,Apr 2014,CACF,2014,A B Vines Ministries,ATRISK_CHILD_SUPPER,22,130,0,0,130,2640,0,0,2640,120
SAN DIEGO,May 2014,CACF,2014,A B Vines Ministries,ATRISK_CHILD_SNACK,21,130,0,0,130,2140,0,0,2140,101.9048
SAN DIEGO,May 2014,CACF,2014,A B Vines Ministries,ATRISK_CHILD_SUPPER,21,130,0,0,130,2560,0,0,2560,121.9048
SAN DIEGO,Jun 2014,CACF,2014,A B Vines Ministries,ATRISK_CHILD_SNACK,10,80,0,0,80,600,0,0,600,60
SAN DIEGO,Jun 2014,CACF,2014,A B Vines Ministries,ATRISK_CHILD_SUPPER,10,80,0,0,80,800,0,0,800,80
SAN DIEGO,Oct 2013,CACF,2014,A PLACE OF OUR OWN CHILD,CHILD_BREAKFAST,23,86,4,5,95,918,43,53,1014,44.087
SAN DIEGO,Oct 2013,CACF,2014,A PLACE OF OUR OWN CHILD,CHILD_LUNCH,23,86,4,5,95,1165,54,68,1287,55.9565
SAN DIEGO,Oct 2013,CACF,2014,A PLACE OF OUR OWN CHILD,CHILD_SNACK_PM,23,86,4,5,95,755,35,44,834,36.2609
SAN DIEGO,Nov 2013,CACF,2014,A PLACE OF OUR OWN CHILD,CHILD_BREAKFAST,19,62,3,2,67,718,35,23,776,40.8421
SAN DIEGO,Nov 2013,CACF,2014,A PLACE OF OUR OWN CHILD,CHILD_LUNCH,19,62,3,2,67,903,44,29,976,51.3684
SAN DIEGO,Nov 2013,CACF,2014,A PLACE OF OUR OWN CHILD,CHILD_SNACK_PM,19,62,3,2,67,527,26,17,570,30
SAN DIEGO,Nov 2013,CACF,2014,A PLACE OF OUR OWN CHILD,OSCH_CHILD_BREAKFAST,19,24,1,3,28,35,1,5,41,2.1579
SAN DIEGO,Nov 2013,CACF,2014,A PLACE OF OUR OWN CHILD,OSCH_CHILD_LUNCH,19,24,1,3,28,42,2,5,49,2.5789
SAN DIEGO,Nov 2013,CACF,2014,A PLACE OF OUR OWN CHILD,OSCH_CHILD_SNACK_PM,19,24,1,3,28,175,7,22,204,10.7368
SAN DIEGO,Dec 2013,CACF,2014,A PLACE OF OUR OWN CHILD,CHILD_BREAKFAST,21,62,3,2,67,676,33,22,731,34.8095
SAN DIEGO,Dec 2013,CACF,2014,A PLACE OF OUR OWN CHILD,CHILD_LUNCH,21,62,3,2,67,776,38,25,839,39.9524
SAN DIEGO,Dec 2013,CACF,2014,A PLACE OF OUR OWN CHILD,CHILD_SNACK_PM,21,62,3,2,67,492,24,16,532,25.3333
SAN DIEGO,Dec 2013,CACF,2014,A PLACE OF OUR OWN CHILD,OSCH_CHILD_BREAKFAST,21,24,1,3,28,60,2,8,70,3.3333
SAN DIEGO,Dec 2013,CACF,2014,A PLACE OF OUR OWN CHILD,OSCH_CHILD_LUNCH,21,24,1,3,28,66,3,8,77,3.6667
SAN DIEGO,Dec 2013,CACF,2014,A PLACE OF OUR OWN CHILD,OSCH_CHILD_SNACK_PM,21,24,1,3,28,217,9,27,253,12.0476
SAN DIEGO,Jan 2014,CACF,2014,A PLACE OF OUR OWN CHILD,CHILD_BREAKFAST,21,62,3,2,67,808,39,26,873,41.5714
SAN DIEGO,Jan 2014,CACF,2014,A PLACE OF OUR OWN CHILD,CHILD_LUNCH,21,62,3,2,67,942,46,30,1018,48.4762
SAN DIEGO,Jan 2014,CACF,2014,A PLACE OF OUR OWN CHILD,CHILD_SNACK_PM,21,62,3,2,67,552,27,17,596,28.381
SAN DIEGO,Jan 2014,CACF,2014,A PLACE OF OUR OWN CHILD,OSCH_CHILD_BREAKFAST,21,24,1,3,28,26,1,3,30,1.4286
SAN DIEGO,Jan 2014,CACF,2014,A PLACE OF OUR OWN CHILD,OSCH_CHILD_LUNCH,21,24,1,3,28,43,2,5,50,2.381
SAN DIEGO,Jan 2014,CACF,2014,A PLACE OF OUR OWN CHILD,OSCH_CHILD_SNACK_PM,21,24,1,3,28,235,10,29,274,13.0476
SAN DIEGO,Feb 2014,CACF,2014,A PLACE OF OUR OWN CHILD,CHILD_BREAKFAST,19,62,3,2,67,751,36,25,812,42.7368
SAN DIEGO,Feb 2014,CACF,2014,A PLACE OF OUR OWN CHILD,CHILD_LUNCH,19,62,3,2,67,859,42,27,928,48.8421
SAN DIEGO,Feb 2014,CACF,2014,A PLACE OF OUR OWN CHILD,CHILD_SNACK_PM,19,62,3,2,67,515,25,17,557,29.3158
SAN DIEGO,Feb 2014,CACF,2014,A PLACE OF OUR OWN CHILD,OSCH_CHILD_BREAKFAST,19,24,1,3,28,4,0,1,5,0.2632
SAN DIEGO,Feb 2014,CACF,2014,A PLACE OF OUR OWN CHILD,OSCH_CHILD_LUNCH,19,24,1,3,28,34,1,5,40,2.1053
SAN DIEGO,Feb 2014,CACF,2014,A PLACE OF OUR OWN CHILD,OSCH_CHILD_SNACK_PM,19,24,1,3,28,19,1,2,22,1.1579
SAN DIEGO,Mar 2014,CACF,2014,A PLACE OF OUR OWN CHILD,CHILD_BREAKFAST,21,62,3,2,67,800,39,25,864,41.1429
SAN DIEGO,Mar 2014,CACF,2014,A PLACE OF OUR OWN CHILD,CHILD_LUNCH,21,62,3,2,67,918,44,30,992,47.2381
SAN DIEGO,Mar 2014,CACF,2014,A PLACE OF OUR OWN CHILD,CHILD_SNACK_PM,21,62,3,2,67,528,26,17,571,27.1905
SAN DIEGO,Mar 2014,CACF,2014,A PLACE OF OUR OWN CHILD,OSCH_CHILD_LUNCH,21,24,1,3,28,35,1,5,41,1.9524
SAN DIEGO,Mar 2014,CACF,2014,A PLACE OF OUR OWN CHILD,OSCH_CHILD_SNACK_PM,21,24,1,3,28,180,7,23,210,10
SAN DIEGO,Apr 2014,CACF,2014,A PLACE OF OUR OWN CHILD,CHILD_BREAKFAST,22,62,3,2,67,656,32,21,709,32.2273
SAN DIEGO,Apr 2014,CACF,2014,A PLACE OF OUR OWN CHILD,CHILD_LUNCH,22,62,3,2,67,822,40,26,888,40.3636
SAN DIEGO,Apr 2014,CACF,2014,A PLACE OF OUR OWN CHILD,CHILD_SNACK_PM,22,62,3,2,67,465,23,15,503,22.8636
SAN DIEGO,Apr 2014,CACF,2014,A PLACE OF OUR OWN CHILD,OSCH_CHILD_BREAKFAST,22,24,1,3,28,80,3,10,93,4.2273
SAN DIEGO,Apr 2014,CACF,2014,A PLACE OF OUR OWN CHILD,OSCH_CHILD_LUNCH,22,24,1,3,28,122,5,15,142,6.4545
SAN DIEGO,Apr 2014,CACF,2014,A PLACE OF OUR OWN CHILD,OSCH_CHILD_SNACK_PM,22,24,1,3,28,183,8,22,213,9.6818
SAN DIEGO,May 2014,CACF,2014,A PLACE OF OUR OWN CHILD,CHILD_BREAKFAST,21,62,3,2,67,798,39,25,862,41.0476
SAN DIEGO,May 2014,CACF,2014,A PLACE OF OUR OWN CHILD,CHILD_LUNCH,21,62,3,2,67,937,45,30,1012,48.1905
SAN DIEGO,May 2014,CACF,2014,A PLACE OF OUR OWN CHILD,CHILD_SNACK_PM,21,62,3,2,67,469,23,15,507,24.1429
SAN DIEGO,May 2014,CACF,2014,A PLACE OF OUR OWN CHILD,OSCH_CHILD_LUNCH,21,24,1,3,28,31,1,4,36,1.7143
SAN DIEGO,May 2014,CACF,2014,A PLACE OF OUR OWN CHILD,OSCH_CHILD_SNACK_PM,21,24,1,3,28,195,8,25,228,10.8571
SAN DIEGO,Jun 2014,CACF,2014,A PLACE OF OUR OWN CHILD,CHILD_BREAKFAST,21,62,3,2,67,525,25,17,567,27
SAN DIEGO,Jun 2014,CACF,2014,A PLACE OF OUR OWN CHILD,CHILD_LUNCH,21,62,3,2,67,718,35,23,776,36.9524
SAN DIEGO,Jun 2014,CACF,2014,A PLACE OF OUR OWN CHILD,CHILD_SNACK_PM,21,62,3,2,67,499,24,16,539,25.6667
SAN DIEGO,Jun 2014,CACF,2014,A PLACE OF OUR OWN CHILD,OSCH_CHILD_BREAKFAST,21,26,1,2,29,159,6,12,177,8.4286
SAN DIEGO,Jun 2014,CACF,2014,A PLACE OF OUR OWN CHILD,OSCH_CHILD_LUNCH,21,26,1,2,29,236,9,18,263,12.5238
SAN DIEGO,Jun 2014,CACF,2014,A PLACE OF OUR OWN CHILD,OSCH_CHILD_SNACK_PM,21,26,1,2,29,282,11,21,314,14.9524
SAN DIEGO,Jul 2014,CACF,2014,A PLACE OF OUR OWN CHILD,CHILD_BREAKFAST,23,62,3,2,67,358,17,12,387,16.8261
SAN DIEGO,Jul 2014,CACF,2014,A PLACE OF OUR OWN CHILD,CHILD_LUNCH,23,62,3,2,67,538,26,17,581,25.2609
SAN DIEGO,Jul 2014,CACF,2014,A PLACE OF OUR OWN CHILD,CHILD_SNACK_PM,23,62,3,2,67,424,21,13,458,19.913
SAN DIEGO,Jul 2014,CACF,2014,A PLACE OF OUR OWN CHILD,OSCH_CHILD_BREAKFAST,23,26,1,2,29,249,10,19,278,12.087
SAN DIEGO,Jul 2014,CACF,2014,A PLACE OF OUR OWN CHILD,OSCH_CHILD_LUNCH,23,26,1,2,29,366,14,28,408,17.7391
SAN DIEGO,Jul 2014,CACF,2014,A PLACE OF OUR OWN CHILD,OSCH_CHILD_SNACK_PM,23,26,1,2,29,313,12,24,349,15.1739
SAN DIEGO,Aug 2014,CACF,2014,A PLACE OF OUR OWN CHILD,CHILD_BREAKFAST,21,62,3,2,67,523,25,17,565,26.9048
SAN DIEGO,Aug 2014,CACF,2014,A PLACE OF OUR OWN CHILD,CHILD_LUNCH,21,62,3,2,67,683,33,22,738,35.1429
SAN DIEGO,Aug 2014,CACF,2014,A PLACE OF OUR OWN CHILD,CHILD_SNACK_PM,21,62,3,2,67,433,21,14,468,22.2857
SAN DIEGO,Aug 2014,CACF,2014,A PLACE OF OUR OWN CHILD,OSCH_CHILD_BREAKFAST,21,26,1,2,29,107,4,8,119,5.6667
SAN DIEGO,Aug 2014,CACF,2014,A PLACE OF OUR OWN CHILD,OSCH_CHILD_LUNCH,21,26,1,2,29,181,7,14,202,9.619
SAN DIEGO,Aug 2014,CACF,2014,A PLACE OF OUR OWN CHILD,OSCH_CHILD_SNACK_PM,21,26,1,2,29,309,12,24,345,16.4286
SAN DIEGO,Sep 2014,CACF,2014,A PLACE OF OUR OWN CHILD,CHILD_BREAKFAST,21,62,3,2,67,796,39,25,860,40.9524
SAN DIEGO,Sep 2014,CACF,2014,A PLACE OF OUR OWN CHILD,CHILD_LUNCH,21,62,3,2,67,932,45,30,1007,47.9524
SAN DIEGO,Sep 2014,CACF,2014,A PLACE OF OUR OWN CHILD,CHILD_SNACK_PM,21,62,3,2,67,442,21,15,478,22.7619
SAN DIEGO,Sep 2014,CACF,2014,A PLACE OF OUR OWN CHILD,OSCH_CHILD_LUNCH,21,26,1,2,29,38,1,3,42,2
SAN DIEGO,Sep 2014,CACF,2014,A PLACE OF OUR OWN CHILD,OSCH_CHILD_SNACK_PM,21,26,1,2,29,425,16,33,474,22.5714
SAN DIEGO,Oct 2013,CACF,2014,ALL ABOUT KIDS PRESCHOOL,CHILD_BREAKFAST,23,19,2,39,60,171,18,351,540,23.4783
SAN DIEGO,Oct 2013,CACF,2014,ALL ABOUT KIDS PRESCHOOL,CHILD_LUNCH,23,19,2,39,60,282,30,577,889,38.6522
SAN DIEGO,Oct 2013,CACF,2014,ALL ABOUT KIDS PRESCHOOL,CHILD_SNACK_PM,23,19,2,39,60,258,27,529,814,35.3913
SAN DIEGO,Oct 2013,CACF,2014,ALL ABOUT KIDS PRESCHOOL,CHILD_SUPPER,23,19,2,39,60,2,0,4,6,0.2609
SAN DIEGO,Oct 2013,CACF,2014,ALL ABOUT KIDS PRESCHOOL,OSCH_CHILD_BREAKFAST,23,5,0,11,16,77,0,169,246,10.6957
SAN DIEGO,Oct 2013,CACF,2014,ALL ABOUT KIDS PRESCHOOL,OSCH_CHILD_SNACK_PM,23,5,0,11,16,65,0,143,208,9.0435
SAN DIEGO,Oct 2013,CACF,2014,ALL ABOUT KIDS PRESCHOOL,OSCH_CHILD_SUPPER,23,5,0,11,16,1,0,2,3,0.1304
SAN DIEGO,Nov 2013,CACF,2014,ALL ABOUT KIDS PRESCHOOL,CHILD_BREAKFAST,19,19,2,39,60,140,15,287,442,23.2632
SAN DIEGO,Nov 2013,CACF,2014,ALL ABOUT KIDS PRESCHOOL,CHILD_LUNCH,19,19,2,39,60,231,24,474,729,38.3684
SAN DIEGO,Nov 2013,CACF,2014,ALL ABOUT KIDS PRESCHOOL,CHILD_SNACK_PM,19,19,2,39,60,216,23,444,683,35.9474
SAN DIEGO,Nov 2013,CACF,2014,ALL ABOUT KIDS PRESCHOOL,CHILD_SUPPER,19,19,2,39,60,4,0,9,13,0.6842
SAN DIEGO,Nov 2013,CACF,2014,ALL ABOUT KIDS PRESCHOOL,OSCH_CHILD_BREAKFAST,19,5,0,11,16,55,0,121,176,9.2632
SAN DIEGO,Nov 2013,CACF,2014,ALL ABOUT KIDS PRESCHOOL,OSCH_CHILD_LUNCH,19,5,0,11,16,10,0,23,33,1.7368
SAN DIEGO,Nov 2013,CACF,2014,ALL ABOUT KIDS PRESCHOOL,OSCH_CHILD_SNACK_PM,19,5,0,11,16,49,0,109,158,8.3158
SAN DIEGO,Nov 2013,CACF,2014,ALL ABOUT KIDS PRESCHOOL,OSCH_CHILD_SUPPER,19,5,0,11,16,1,0,1,2,0.1053
SAN DIEGO,Dec 2013,CACF,2014,ALL ABOUT KIDS PRESCHOOL,CHILD_BREAKFAST,24,19,2,39,60,158,17,323,498,20.75
SAN DIEGO,Dec 2013,CACF,2014,ALL ABOUT KIDS PRESCHOOL,CHILD_LUNCH,24,19,2,39,60,241,25,494,760,31.6667
SAN DIEGO,Dec 2013,CACF,2014,ALL ABOUT KIDS PRESCHOOL,CHILD_SNACK_AM,24,19,2,39,60,217,23,446,686,28.5833
SAN DIEGO,Dec 2013,CACF,2014,ALL ABOUT KIDS PRESCHOOL,CHILD_SUPPER,24,19,2,39,60,5,1,10,16,0.6667
SAN DIEGO,Dec 2013,CACF,2014,ALL ABOUT KIDS PRESCHOOL,OSCH_CHILD_BREAKFAST,24,5,0,11,16,61,0,133,194,8.0833
SAN DIEGO,Dec 2013,CACF,2014,ALL ABOUT KIDS PRESCHOOL,OSCH_CHILD_LUNCH,24,5,0,11,16,10,0,21,31,1.2917
SAN DIEGO,Dec 2013,CACF,2014,ALL ABOUT KIDS PRESCHOOL,OSCH_CHILD_SNACK_PM,24,5,0,11,16,49,0,109,158,6.5833
SAN DIEGO,Jan 2014,CACF,2014,ALL ABOUT KIDS PRESCHOOL,CHILD_BREAKFAST,26,19,2,39,60,172,18,354,544,20.9231
SAN DIEGO,Jan 2014,CACF,2014,ALL ABOUT KIDS PRESCHOOL,CHILD_LUNCH,26,19,2,39,60,267,28,548,843,32.4231
SAN DIEGO,Jan 2014,CACF,2014,ALL ABOUT KIDS PRESCHOOL,CHILD_SNACK_PM,26,19,2,39,60,243,26,497,766,29.4615
SAN DIEGO,Jan 2014,CACF,2014,ALL ABOUT KIDS PRESCHOOL,CHILD_SUPPER,26,19,2,39,60,15,2,29,46,1.7692
SAN DIEGO,Jan 2014,CACF,2014,ALL ABOUT KIDS PRESCHOOL,OSCH_CHILD_BREAKFAST,26,5,0,11,16,68,0,148,216,8.3077
SAN DIEGO,Jan 2014,CACF,2014,ALL ABOUT KIDS PRESCHOOL,OSCH_CHILD_LUNCH,26,5,0,11,16,7,0,16,23,0.8846
SAN DIEGO,Jan 2014,CACF,2014,ALL ABOUT KIDS PRESCHOOL,OSCH_CHILD_SNACK_PM,26,5,0,11,16,53,0,117,170,6.5385
SAN DIEGO,Jan 2014,CACF,2014,ALL ABOUT KIDS PRESCHOOL,OSCH_CHILD_SUPPER,26,5,0,11,16,0,0,1,1,0.0385
SAN DIEGO,Feb 2014,CACF,2014,ALL ABOUT KIDS PRESCHOOL,CHILD_BREAKFAST,23,19,2,39,60,173,18,355,546,23.7391
SAN DIEGO,Feb 2014,CACF,2014,ALL ABOUT KIDS PRESCHOOL,CHILD_LUNCH,23,19,2,39,60,257,27,526,810,35.2174
SAN DIEGO,Feb 2014,CACF,2014,ALL ABOUT KIDS PRESCHOOL,CHILD_SNACK_AM,23,19,2,39,60,243,26,497,766,33.3043
SAN DIEGO,Feb 2014,CACF,2014,ALL ABOUT KIDS PRESCHOOL,CHILD_SUPPER,23,19,2,39,60,1,0,3,4,0.1739
SAN DIEGO,Feb 2014,CACF,2014,ALL ABOUT KIDS PRESCHOOL,OSCH_CHILD_BREAKFAST,23,5,0,11,16,53,0,117,170,7.3913
SAN DIEGO,Feb 2014,CACF,2014,ALL ABOUT KIDS PRESCHOOL,OSCH_CHILD_LUNCH,23,5,0,11,16,4,0,8,12,0.5217
SAN DIEGO,Feb 2014,CACF,2014,ALL ABOUT KIDS PRESCHOOL,OSCH_CHILD_SNACK_PM,23,5,0,11,16,48,0,105,153,6.6522
SAN DIEGO,Mar 2014,CACF,2014,ALL ABOUT KIDS PRESCHOOL,CHILD_BREAKFAST,26,19,2,39,60,196,21,402,619,23.8077
SAN DIEGO,Mar 2014,CACF,2014,ALL ABOUT KIDS PRESCHOOL,CHILD_LUNCH,26,19,2,39,60,279,29,572,880,33.8462
SAN DIEGO,Mar 2014,CACF,2014,ALL ABOUT KIDS PRESCHOOL,CHILD_SNACK_PM,26,19,2,39,60,262,28,536,826,31.7692
SAN DIEGO,Mar 2014,CACF,2014,ALL ABOUT KIDS PRESCHOOL,CHILD_SUPPER,26,19,2,39,60,1,0,3,4,0.1538
SAN DIEGO,Mar 2014,CACF,2014,ALL ABOUT KIDS PRESCHOOL,OSCH_CHILD_BREAKFAST,26,5,0,11,16,61,0,135,196,7.5385
SAN DIEGO,Mar 2014,CACF,2014,ALL ABOUT KIDS PRESCHOOL,OSCH_CHILD_SNACK_PM,26,5,0,11,16,45,0,100,145,5.5769
SAN DIEGO,Apr 2014,CACF,2014,ALL ABOUT KIDS PRESCHOOL,CHILD_BREAKFAST,26,19,2,39,60,200,21,410,631,24.2692
SAN DIEGO,Apr 2014,CACF,2014,ALL ABOUT KIDS PRESCHOOL,CHILD_LUNCH,26,19,2,39,60,333,35,685,1053,40.5
SAN DIEGO,Apr 2014,CACF,2014,ALL ABOUT KIDS PRESCHOOL,CHILD_SNACK_AM,26,19,2,39,60,277,29,569,875,33.6538
SAN DIEGO,Apr 2014,CACF,2014,ALL ABOUT KIDS PRESCHOOL,CHILD_SNACK_PM,26,19,2,39,60,287,30,589,906,34.8462
SAN DIEGO,Apr 2014,CACF,2014,ALL ABOUT KIDS PRESCHOOL,CHILD_SUPPER,26,19,2,39,60,9,1,17,27,1.0385
SAN DIEGO,Apr 2014,CACF,2014,ALL ABOUT KIDS PRESCHOOL,OSCH_CHILD_BREAKFAST,26,5,0,11,16,58,0,127,185,7.1154
SAN DIEGO,Apr 2014,CACF,2014,ALL ABOUT KIDS PRESCHOOL,OSCH_CHILD_LUNCH,26,5,0,11,16,29,0,63,92,3.5385
SAN DIEGO,Apr 2014,CACF,2014,ALL ABOUT KIDS PRESCHOOL,OSCH_CHILD_SNACK_AM,26,5,0,11,16,28,0,62,90,3.4615
SAN DIEGO,Apr 2014,CACF,2014,ALL ABOUT KIDS PRESCHOOL,OSCH_CHILD_SNACK_PM,26,5,0,11,16,61,0,135,196,7.5385
SAN DIEGO,Apr 2014,CACF,2014,ALL ABOUT KIDS PRESCHOOL,OSCH_CHILD_SUPPER,26,5,0,11,16,2,0,3,5,0.1923
SAN DIEGO,May 2014,CACF,2014,ALL ABOUT KIDS PRESCHOOL,CHILD_BREAKFAST,27,26,10,41,77,217,83,342,642,23.7778
SAN DIEGO,May 2014,CACF,2014,ALL ABOUT KIDS PRESCHOOL,CHILD_LUNCH,27,26,10,41,77,336,129,529,994,36.8148
SAN DIEGO,May 2014,CACF,2014,ALL ABOUT KIDS PRESCHOOL,CHILD_SNACK_AM,27,26,10,41,77,309,119,487,915,33.8889
SAN DIEGO,May 2014,CACF,2014,ALL ABOUT KIDS PRESCHOOL,CHILD_SNACK_PM,27,26,10,41,77,304,117,480,901,33.3704
SAN DIEGO,May 2014,CACF,2014,ALL ABOUT KIDS PRESCHOOL,CHILD_SUPPER,27,26,10,41,77,30,12,47,89,3.2963
SAN DIEGO,May 2014,CACF,2014,ALL ABOUT KIDS PRESCHOOL,OSCH_CHILD_BREAKFAST,27,4,0,12,16,44,0,131,175,6.4815
SAN DIEGO,May 2014,CACF,2014,ALL ABOUT KIDS PRESCHOOL,OSCH_CHILD_LUNCH,27,4,0,12,16,4,0,12,16,0.5926
SAN DIEGO,May 2014,CACF,2014,ALL ABOUT KIDS PRESCHOOL,OSCH_CHILD_SNACK_PM,27,4,0,12,16,48,0,142,190,7.037
SAN DIEGO,May 2014,CACF,2014,ALL ABOUT KIDS PRESCHOOL,OSCH_CHILD_SUPPER,27,4,0,12,16,1,0,4,5,0.1852
SAN DIEGO,Jun 2014,CACF,2014,ALL ABOUT KIDS PRESCHOOL,CHILD_BREAKFAST,25,33,12,40,85,267,97,325,689,27.56
SAN DIEGO,Jun 2014,CACF,2014,ALL ABOUT KIDS PRESCHOOL,CHILD_LUNCH,25,33,12,40,85,403,147,488,1038,41.52
SAN DIEGO,Jun 2014,CACF,2014,ALL ABOUT KIDS PRESCHOOL,CHILD_SNACK_AM,25,33,12,40,85,381,139,461,981,39.24
SAN DIEGO,Jun 2014,CACF,2014,ALL ABOUT KIDS PRESCHOOL,CHILD_SNACK_PM,25,33,12,40,85,362,132,438,932,37.28
SAN DIEGO,Jun 2014,CACF,2014,ALL ABOUT KIDS PRESCHOOL,CHILD_SUPPER,25,33,12,40,85,33,12,41,86,3.44
SAN DIEGO,Jun 2014,CACF,2014,ALL ABOUT KIDS PRESCHOOL,OSCH_CHILD_BREAKFAST,25,5,2,10,17,51,20,103,174,6.96
SAN DIEGO,Jun 2014,CACF,2014,ALL ABOUT KIDS PRESCHOOL,OSCH_CHILD_LUNCH,25,5,2,10,17,21,8,42,71,2.84
SAN DIEGO,Jun 2014,CACF,2014,ALL ABOUT KIDS PRESCHOOL,OSCH_CHILD_SNACK_AM,25,5,2,10,17,20,8,41,69,2.76
SAN DIEGO,Jun 2014,CACF,2014,ALL ABOUT KIDS PRESCHOOL,OSCH_CHILD_SNACK_PM,25,5,2,10,17,51,20,103,174,6.96
SAN DIEGO,Jun 2014,CACF,2014,ALL ABOUT KIDS PRESCHOOL,OSCH_CHILD_SUPPER,25,5,2,10,17,14,6,27,47,1.88
SAN DIEGO,Jul 2014,CACF,2014,ALL ABOUT KIDS PRESCHOOL,CHILD_BREAKFAST,27,33,12,40,85,247,90,300,637,23.5926
SAN DIEGO,Jul 2014,CACF,2014,ALL ABOUT KIDS PRESCHOOL,CHILD_LUNCH,27,33,12,40,85,384,140,466,990,36.6667
SAN DIEGO,Jul 2014,CACF,2014,ALL ABOUT KIDS PRESCHOOL,CHILD_SNACK_AM,27,33,12,40,85,375,137,455,967,35.8148
SAN DIEGO,Jul 2014,CACF,2014,ALL ABOUT KIDS PRESCHOOL,CHILD_SNACK_NT,27,33,12,40,85,4,1,5,10,0.3704
SAN DIEGO,Jul 2014,CACF,2014,ALL ABOUT KIDS PRESCHOOL,CHILD_SNACK_PM,27,33,12,40,85,352,128,426,906,33.5556
SAN DIEGO,Jul 2014,CACF,2014,ALL ABOUT KIDS PRESCHOOL,CHILD_SUPPER,27,33,12,40,85,52,19,63,134,4.963
SAN DIEGO,Jul 2014,CACF,2014,ALL ABOUT KIDS PRESCHOOL,OSCH_CHILD_BREAKFAST,27,5,2,10,17,44,18,89,151,5.5926
SAN DIEGO,Jul 2014,CACF,2014,ALL ABOUT KIDS PRESCHOOL,OSCH_CHILD_LUNCH,27,5,2,10,17,64,25,127,216,8
SAN DIEGO,Jul 2014,CACF,2014,ALL ABOUT KIDS PRESCHOOL,OSCH_CHILD_SNACK_AM,27,5,2,10,17,64,26,128,218,8.0741
SAN DIEGO,Jul 2014,CACF,2014,ALL ABOUT KIDS PRESCHOOL,OSCH_CHILD_SNACK_PM,27,5,2,10,17,49,20,97,166,6.1481
SAN DIEGO,Jul 2014,CACF,2014,ALL ABOUT KIDS PRESCHOOL,OSCH_CHILD_SUPPER,27,5,2,10,17,18,7,37,62,2.2963
SAN DIEGO,Aug 2014,CACF,2014,ALL ABOUT KIDS PRESCHOOL,CHILD_BREAKFAST,26,27,9,33,69,198,66,242,506,19.4615
SAN DIEGO,Aug 2014,CACF,2014,ALL ABOUT KIDS PRESCHOOL,CHILD_LUNCH,26,27,9,33,69,313,104,384,801,30.8077
SAN DIEGO,Aug 2014,CACF,2014,ALL ABOUT KIDS PRESCHOOL,CHILD_SNACK_AM,26,27,9,33,69,314,105,384,803,30.8846
SAN DIEGO,Aug 2014,CACF,2014,ALL ABOUT KIDS PRESCHOOL,CHILD_SNACK_NT,26,27,9,33,69,8,3,10,21,0.8077
SAN DIEGO,Aug 2014,CACF,2014,ALL ABOUT KIDS PRESCHOOL,CHILD_SNACK_PM,26,27,9,33,69,237,79,290,606,23.3077
SAN DIEGO,Aug 2014,CACF,2014,ALL ABOUT KIDS PRESCHOOL,CHILD_SUPPER,26,27,9,33,69,86,29,106,221,8.5
SAN DIEGO,Aug 2014,CACF,2014,ALL ABOUT KIDS PRESCHOOL,OSCH_CHILD_BREAKFAST,26,7,3,7,17,47,20,48,115,4.4231
SAN DIEGO,Aug 2014,CACF,2014,ALL ABOUT KIDS PRESCHOOL,OSCH_CHILD_LUNCH,26,7,3,7,17,70,30,70,170,6.5385
SAN DIEGO,Aug 2014,CACF,2014,ALL ABOUT KIDS PRESCHOOL,OSCH_CHILD_SNACK_AM,26,7,3,7,17,70,30,71,171,6.5769
SAN DIEGO,Aug 2014,CACF,2014,ALL ABOUT KIDS PRESCHOOL,OSCH_CHILD_SNACK_PM,26,7,3,7,17,71,31,71,173,6.6538
SAN DIEGO,Aug 2014,CACF,2014,ALL ABOUT KIDS PRESCHOOL,OSCH_CHILD_SUPPER,26,7,3,7,17,24,10,25,59,2.2692
SAN DIEGO,Sep 2014,CACF,2014,ALL ABOUT KIDS PRESCHOOL,CHILD_BREAKFAST,26,17,4,28,49,142,33,234,409,15.7308
SAN DIEGO,Sep 2014,CACF,2014,ALL ABOUT KIDS PRESCHOOL,CHILD_LUNCH,26,17,4,28,49,235,55,387,677,26.0385
SAN DIEGO,Sep 2014,CACF,2014,ALL ABOUT KIDS PRESCHOOL,CHILD_SNACK_AM,26,17,4,28,49,213,50,351,614,23.6154
SAN DIEGO,Sep 2014,CACF,2014,ALL ABOUT KIDS PRESCHOOL,CHILD_SNACK_NT,26,17,4,28,49,5,1,9,15,0.5769
SAN DIEGO,Sep 2014,CACF,2014,ALL ABOUT KIDS PRESCHOOL,CHILD_SNACK_PM,26,17,4,28,49,188,44,311,543,20.8846
SAN DIEGO,Sep 2014,CACF,2014,ALL ABOUT KIDS PRESCHOOL,CHILD_SUPPER,26,17,4,28,49,14,3,22,39,1.5
SAN DIEGO,Sep 2014,CACF,2014,ALL ABOUT KIDS PRESCHOOL,OSCH_CHILD_BREAKFAST,26,6,5,10,21,43,36,72,151,5.8077
SAN DIEGO,Sep 2014,CACF,2014,ALL ABOUT KIDS PRESCHOOL,OSCH_CHILD_SNACK_NT,26,6,5,10,21,1,1,2,4,0.1538
SAN DIEGO,Sep 2014,CACF,2014,ALL ABOUT KIDS PRESCHOOL,OSCH_CHILD_SNACK_PM,26,6,5,10,21,53,44,89,186,7.1538
SAN DIEGO,Sep 2014,CACF,2014,ALL ABOUT KIDS PRESCHOOL,OSCH_CHILD_SUPPER,26,6,5,10,21,8,7,14,29,1.1154
SAN DIEGO,Oct 2013,CACF,2014,All Kids Academy Head Start Inc.,HS_CHILD_BREAKFAST,22,1126,0,0,1126,10842,0,0,10842,492.8182
SAN DIEGO,Oct 2013,CACF,2014,All Kids Academy Head Start Inc.,HS_CHILD_LUNCH,22,1126,0,0,1126,17603,0,0,17603,800.1364
SAN DIEGO,Oct 2013,CACF,2014,All Kids Academy Head Start Inc.,HS_CHILD_SNACK_PM,22,1126,0,0,1126,10084,0,0,10084,458.3636
SAN DIEGO,Nov 2013,CACF,2014,All Kids Academy Head Start Inc.,HS_CHILD_BREAKFAST,15,1126,0,0,1126,6827,0,0,6827,455.1333
SAN DIEGO,Nov 2013,CACF,2014,All Kids Academy Head Start Inc.,HS_CHILD_LUNCH,15,1126,0,0,1126,10727,0,0,10727,715.1333
SAN DIEGO,Nov 2013,CACF,2014,All Kids Academy Head Start Inc.,HS_CHILD_SNACK_PM,15,1126,0,0,1126,6223,0,0,6223,414.8667
SAN DIEGO,Dec 2013,CACF,2014,All Kids Academy Head Start Inc.,HS_CHILD_BREAKFAST,14,1126,0,0,1126,6891,0,0,6891,492.2143
SAN DIEGO,Dec 2013,CACF,2014,All Kids Academy Head Start Inc.,HS_CHILD_LUNCH,14,1126,0,0,1126,10809,0,0,10809,772.0714
SAN DIEGO,Dec 2013,CACF,2014,All Kids Academy Head Start Inc.,HS_CHILD_SNACK_PM,14,1126,0,0,1126,6096,0,0,6096,435.4286
SAN DIEGO,Jan 2014,CACF,2014,All Kids Academy Head Start Inc.,HS_CHILD_BREAKFAST,18,1126,0,0,1126,8589,0,0,8589,477.1667
SAN DIEGO,Jan 2014,CACF,2014,All Kids Academy Head Start Inc.,HS_CHILD_LUNCH,18,1126,0,0,1126,13501,0,0,13501,750.0556
SAN DIEGO,Jan 2014,CACF,2014,All Kids Academy Head Start Inc.,HS_CHILD_SNACK_PM,18,1126,0,0,1126,7706,0,0,7706,428.1111
SAN DIEGO,Feb 2014,CACF,2014,All Kids Academy Head Start Inc.,HS_CHILD_BREAKFAST,18,1126,0,0,1126,8631,0,0,8631,479.5
SAN DIEGO,Feb 2014,CACF,2014,All Kids Academy Head Start Inc.,HS_CHILD_LUNCH,18,1126,0,0,1126,13702,0,0,13702,761.2222
SAN DIEGO,Feb 2014,CACF,2014,All Kids Academy Head Start Inc.,HS_CHILD_SNACK_PM,18,1126,0,0,1126,7773,0,0,7773,431.8333
SAN DIEGO,Mar 2014,CACF,2014,All Kids Academy Head Start Inc.,HS_CHILD_BREAKFAST,19,1126,0,0,1126,9297,0,0,9297,489.3158
SAN DIEGO,Mar 2014,CACF,2014,All Kids Academy Head Start Inc.,HS_CHILD_LUNCH,19,1126,0,0,1126,14762,0,0,14762,776.9474
SAN DIEGO,Mar 2014,CACF,2014,All Kids Academy Head Start Inc.,HS_CHILD_SNACK_PM,19,1126,0,0,1126,8476,0,0,8476,446.1053
SAN DIEGO,Apr 2014,CACF,2014,All Kids Academy Head Start Inc.,HS_CHILD_BREAKFAST,17,1126,0,0,1126,7493,0,0,7493,440.7647
SAN DIEGO,Apr 2014,CACF,2014,All Kids Academy Head Start Inc.,HS_CHILD_LUNCH,17,1126,0,0,1126,12004,0,0,12004,706.1176
SAN DIEGO,Apr 2014,CACF,2014,All Kids Academy Head Start Inc.,HS_CHILD_SNACK_PM,17,1126,0,0,1126,6973,0,0,6973,410.1765
SAN DIEGO,May 2014,CACF,2014,All Kids Academy Head Start Inc.,HS_CHILD_BREAKFAST,18,1126,0,0,1126,8663,0,0,8663,481.2778
SAN DIEGO,May 2014,CACF,2014,All Kids Academy Head Start Inc.,HS_CHILD_LUNCH,18,1126,0,0,1126,13742,0,0,13742,763.4444
SAN DIEGO,May 2014,CACF,2014,All Kids Academy Head Start Inc.,HS_CHILD_SNACK_PM,18,1126,0,0,1126,7804,0,0,7804,433.5556
SAN DIEGO,Jun 2014,CACF,2014,All Kids Academy Head Start Inc.,HS_CHILD_BREAKFAST,9,1126,0,0,1126,3882,0,0,3882,431.3333
SAN DIEGO,Jun 2014,CACF,2014,All Kids Academy Head Start Inc.,HS_CHILD_LUNCH,9,1126,0,0,1126,6714,0,0,6714,746
SAN DIEGO,Jun 2014,CACF,2014,All Kids Academy Head Start Inc.,HS_CHILD_SNACK_PM,9,1126,0,0,1126,3756,0,0,3756,417.3333
SAN DIEGO,Aug 2014,CACF,2014,All Kids Academy Head Start Inc.,HS_CHILD_BREAKFAST,8,1126,0,0,1126,519,0,0,519,64.875
SAN DIEGO,Aug 2014,CACF,2014,All Kids Academy Head Start Inc.,HS_CHILD_LUNCH,8,1126,0,0,1126,968,0,0,968,121
SAN DIEGO,Aug 2014,CACF,2014,All Kids Academy Head Start Inc.,HS_CHILD_SNACK_PM,8,1126,0,0,1126,574,0,0,574,71.75
SAN DIEGO,Sep 2014,CACF,2014,All Kids Academy Head Start Inc.,HS_CHILD_BREAKFAST,21,1126,0,0,1126,6367,0,0,6367,303.1905
SAN DIEGO,Sep 2014,CACF,2014,All Kids Academy Head Start Inc.,HS_CHILD_LUNCH,21,1126,0,0,1126,9889,0,0,9889,470.9048
SAN DIEGO,Sep 2014,CACF,2014,All Kids Academy Head Start Inc.,HS_CHILD_SNACK_PM,21,1126,0,0,1126,5708,0,0,5708,271.8095
SAN DIEGO,Oct 2013,CACF,2014,AMERICARE ADHC INC ,ADULT_BREAKFAST,23,180,0,1,181,2118,0,12,2130,92.6087
SAN DIEGO,Oct 2013,CACF,2014,AMERICARE ADHC INC ,ADULT_LUNCH,23,180,0,1,181,2123,0,12,2135,92.8261
SAN DIEGO,Oct 2013,CACF,2014,AMERICARE ADHC INC ,ADULT_SNACK_AM,23,180,0,1,181,5,0,0,5,0.2174
SAN DIEGO,Oct 2013,CACF,2014,AMERICARE ADHC INC ,ADULT_SNACK_PM,23,180,0,1,181,437,0,2,439,19.087
SAN DIEGO,Nov 2013,CACF,2014,AMERICARE ADHC INC ,ADULT_BREAKFAST,19,180,0,1,181,1849,0,10,1859,97.8421
SAN DIEGO,Nov 2013,CACF,2014,AMERICARE ADHC INC ,ADULT_LUNCH,19,180,0,1,181,1854,0,10,1864,98.1053
SAN DIEGO,Nov 2013,CACF,2014,AMERICARE ADHC INC ,ADULT_SNACK_AM,19,180,0,1,181,5,0,0,5,0.2632
SAN DIEGO,Nov 2013,CACF,2014,AMERICARE ADHC INC ,ADULT_SNACK_PM,19,180,0,1,181,325,0,2,327,17.2105
SAN DIEGO,Dec 2013,CACF,2014,AMERICARE ADHC INC ,ADULT_BREAKFAST,21,180,0,1,181,1924,0,11,1935,92.1429
SAN DIEGO,Dec 2013,CACF,2014,AMERICARE ADHC INC ,ADULT_LUNCH,21,180,0,1,181,1939,0,11,1950,92.8571
SAN DIEGO,Dec 2013,CACF,2014,AMERICARE ADHC INC ,ADULT_SNACK_AM,21,180,0,1,181,15,0,0,15,0.7143
SAN DIEGO,Dec 2013,CACF,2014,AMERICARE ADHC INC ,ADULT_SNACK_PM,21,180,0,1,181,421,0,2,423,20.1429
SAN DIEGO,Jan 2014,CACF,2014,AMERICARE ADHC INC ,ADULT_BREAKFAST,22,180,0,1,181,2060,0,11,2071,94.1364
SAN DIEGO,Jan 2014,CACF,2014,AMERICARE ADHC INC ,ADULT_LUNCH,22,180,0,1,181,2067,0,11,2078,94.4545
SAN DIEGO,Jan 2014,CACF,2014,AMERICARE ADHC INC ,ADULT_SNACK_AM,22,180,0,1,181,7,0,0,7,0.3182
SAN DIEGO,Jan 2014,CACF,2014,AMERICARE ADHC INC ,ADULT_SNACK_PM,22,180,0,1,181,438,0,2,440,20
SAN DIEGO,Feb 2014,CACF,2014,AMERICARE ADHC INC ,ADULT_BREAKFAST,20,180,0,1,181,2120,0,12,2132,106.6
SAN DIEGO,Feb 2014,CACF,2014,AMERICARE ADHC INC ,ADULT_LUNCH,20,180,0,1,181,2135,0,12,2147,107.35
SAN DIEGO,Feb 2014,CACF,2014,AMERICARE ADHC INC ,ADULT_SNACK_AM,20,180,0,1,181,15,0,0,15,0.75
SAN DIEGO,Feb 2014,CACF,2014,AMERICARE ADHC INC ,ADULT_SNACK_PM,20,180,0,1,181,590,0,3,593,29.65
SAN DIEGO,Mar 2014,CACF,2014,AMERICARE ADHC INC ,ADULT_BREAKFAST,21,180,0,1,181,2344,0,13,2357,112.2381
SAN DIEGO,Mar 2014,CACF,2014,AMERICARE ADHC INC ,ADULT_LUNCH,21,180,0,1,181,2368,0,13,2381,113.381
SAN DIEGO,Mar 2014,CACF,2014,AMERICARE ADHC INC ,ADULT_SNACK_AM,21,180,0,1,181,25,0,0,25,1.1905
SAN DIEGO,Mar 2014,CACF,2014,AMERICARE ADHC INC ,ADULT_SNACK_PM,21,180,0,1,181,613,0,3,616,29.3333
SAN DIEGO,Apr 2014,CACF,2014,AMERICARE ADHC INC ,ADULT_BREAKFAST,22,180,0,1,181,2495,0,14,2509,114.0455
SAN DIEGO,Apr 2014,CACF,2014,AMERICARE ADHC INC ,ADULT_LUNCH,22,180,0,1,181,2519,0,14,2533,115.1364
SAN DIEGO,Apr 2014,CACF,2014,AMERICARE ADHC INC ,ADULT_SNACK_AM,22,180,0,1,181,22,0,0,22,1
SAN DIEGO,Apr 2014,CACF,2014,AMERICARE ADHC INC ,ADULT_SNACK_PM,22,180,0,1,181,551,0,3,554,25.1818
SAN DIEGO,May 2014,CACF,2014,AMERICARE ADHC INC ,ADULT_BREAKFAST,19,180,0,1,181,2207,0,12,2219,116.7895
SAN DIEGO,May 2014,CACF,2014,AMERICARE ADHC INC ,ADULT_LUNCH,19,180,0,1,181,2274,0,13,2287,120.3684
SAN DIEGO,May 2014,CACF,2014,AMERICARE ADHC INC ,ADULT_SNACK_AM,19,180,0,1,181,68,0,0,68,3.5789
SAN DIEGO,May 2014,CACF,2014,AMERICARE ADHC INC ,ADULT_SNACK_PM,19,180,0,1,181,571,0,3,574,30.2105
SAN DIEGO,Jun 2014,CACF,2014,AMERICARE ADHC INC ,ADULT_BREAKFAST,21,180,0,1,181,2455,0,14,2469,117.5714
SAN DIEGO,Jun 2014,CACF,2014,AMERICARE ADHC INC ,ADULT_LUNCH,21,180,0,1,181,2471,0,14,2485,118.3333
SAN DIEGO,Jun 2014,CACF,2014,AMERICARE ADHC INC ,ADULT_SNACK_AM,21,180,0,1,181,16,0,0,16,0.7619
SAN DIEGO,Jun 2014,CACF,2014,AMERICARE ADHC INC ,ADULT_SNACK_PM,21,180,0,1,181,536,0,3,539,25.6667
SAN DIEGO,Jul 2014,CACF,2014,AMERICARE ADHC INC ,ADULT_BREAKFAST,22,180,0,1,181,2575,0,14,2589,117.6818
SAN DIEGO,Jul 2014,CACF,2014,AMERICARE ADHC INC ,ADULT_LUNCH,22,180,0,1,181,2595,0,14,2609,118.5909
SAN DIEGO,Jul 2014,CACF,2014,AMERICARE ADHC INC ,ADULT_SNACK_AM,22,180,0,1,181,20,0,0,20,0.9091
SAN DIEGO,Jul 2014,CACF,2014,AMERICARE ADHC INC ,ADULT_SNACK_PM,22,180,0,1,181,630,0,3,633,28.7727
SAN DIEGO,Aug 2014,CACF,2014,AMERICARE ADHC INC ,ADULT_BREAKFAST,21,180,0,1,181,2504,0,14,2518,119.9048
SAN DIEGO,Aug 2014,CACF,2014,AMERICARE ADHC INC ,ADULT_LUNCH,21,180,0,1,181,2519,0,14,2533,120.619
SAN DIEGO,Aug 2014,CACF,2014,AMERICARE ADHC INC ,ADULT_SNACK_AM,21,180,0,1,181,15,0,0,15,0.7143
SAN DIEGO,Aug 2014,CACF,2014,AMERICARE ADHC INC ,ADULT_SNACK_PM,21,180,0,1,181,582,0,3,585,27.8571
SAN DIEGO,Sep 2014,CACF,2014,AMERICARE ADHC INC ,ADULT_BREAKFAST,21,180,0,1,181,2626,0,15,2641,125.7619
SAN DIEGO,Sep 2014,CACF,2014,AMERICARE ADHC INC ,ADULT_LUNCH,21,180,0,1,181,2677,0,15,2692,128.1905
SAN DIEGO,Sep 2014,CACF,2014,AMERICARE ADHC INC ,ADULT_SNACK_AM,21,180,0,1,181,51,0,0,51,2.4286
SAN DIEGO,Sep 2014,CACF,2014,AMERICARE ADHC INC ,ADULT_SNACK_PM,21,180,0,1,181,689,0,4,693,33
SAN DIEGO,Oct 2013,CACF,2014,ASSOC STUDENTS CSU SAN DIEGO CHILDRENS CENTER ,CHILD_BREAKFAST,23,51,3,156,210,527,31,1610,2168,94.2609
SAN DIEGO,Oct 2013,CACF,2014,ASSOC STUDENTS CSU SAN DIEGO CHILDRENS CENTER ,CHILD_LUNCH,23,51,3,156,210,816,48,2495,3359,146.0435
SAN DIEGO,Oct 2013,CACF,2014,ASSOC STUDENTS CSU SAN DIEGO CHILDRENS CENTER ,CHILD_SNACK_PM,23,51,3,156,210,776,46,2374,3196,138.9565
SAN DIEGO,Nov 2013,CACF,2014,ASSOC STUDENTS CSU SAN DIEGO CHILDRENS CENTER ,CHILD_BREAKFAST,18,51,3,156,210,424,25,1296,1745,96.9444
SAN DIEGO,Nov 2013,CACF,2014,ASSOC STUDENTS CSU SAN DIEGO CHILDRENS CENTER ,CHILD_LUNCH,18,51,3,156,210,651,38,1992,2681,148.9444
SAN DIEGO,Nov 2013,CACF,2014,ASSOC STUDENTS CSU SAN DIEGO CHILDRENS CENTER ,CHILD_SNACK_PM,18,51,3,156,210,617,36,1887,2540,141.1111
SAN DIEGO,Dec 2013,CACF,2014,ASSOC STUDENTS CSU SAN DIEGO CHILDRENS CENTER ,CHILD_BREAKFAST,15,51,3,156,210,337,20,1030,1387,92.4667
SAN DIEGO,Dec 2013,CACF,2014,ASSOC STUDENTS CSU SAN DIEGO CHILDRENS CENTER ,CHILD_LUNCH,15,51,3,156,210,528,31,1615,2174,144.9333
SAN DIEGO,Dec 2013,CACF,2014,ASSOC STUDENTS CSU SAN DIEGO CHILDRENS CENTER ,CHILD_SNACK_PM,15,51,3,156,210,492,29,1506,2027,135.1333
SAN DIEGO,Jan 2014,CACF,2014,ASSOC STUDENTS CSU SAN DIEGO CHILDRENS CENTER ,CHILD_BREAKFAST,19,51,3,156,210,380,22,1161,1563,82.2632
SAN DIEGO,Jan 2014,CACF,2014,ASSOC STUDENTS CSU SAN DIEGO CHILDRENS CENTER ,CHILD_LUNCH,19,51,3,156,210,574,34,1755,2363,124.3684
SAN DIEGO,Jan 2014,CACF,2014,ASSOC STUDENTS CSU SAN DIEGO CHILDRENS CENTER ,CHILD_SNACK_PM,19,51,3,156,210,542,32,1658,2232,117.4737
SAN DIEGO,Feb 2014,CACF,2014,ASSOC STUDENTS CSU SAN DIEGO CHILDRENS CENTER ,CHILD_BREAKFAST,20,51,3,156,210,465,27,1423,1915,95.75
SAN DIEGO,Feb 2014,CACF,2014,ASSOC STUDENTS CSU SAN DIEGO CHILDRENS CENTER ,CHILD_LUNCH,20,51,3,156,210,699,41,2136,2876,143.8
SAN DIEGO,Feb 2014,CACF,2014,ASSOC STUDENTS CSU SAN DIEGO CHILDRENS CENTER ,CHILD_SNACK_PM,20,51,3,156,210,659,39,2014,2712,135.6
SAN DIEGO,Mar 2014,CACF,2014,ASSOC STUDENTS CSU SAN DIEGO CHILDRENS CENTER ,CHILD_BREAKFAST,20,51,3,156,210,470,28,1436,1934,96.7
SAN DIEGO,Mar 2014,CACF,2014,ASSOC STUDENTS CSU SAN DIEGO CHILDRENS CENTER ,CHILD_LUNCH,20,51,3,156,210,743,44,2271,3058,152.9
SAN DIEGO,Mar 2014,CACF,2014,ASSOC STUDENTS CSU SAN DIEGO CHILDRENS CENTER ,CHILD_SNACK_PM,20,51,3,156,210,697,41,2133,2871,143.55
SAN DIEGO,Apr 2014,CACF,2014,ASSOC STUDENTS CSU SAN DIEGO CHILDRENS CENTER ,CHILD_BREAKFAST,22,51,3,156,210,464,27,1419,1910,86.8182
SAN DIEGO,Apr 2014,CACF,2014,ASSOC STUDENTS CSU SAN DIEGO CHILDRENS CENTER ,CHILD_LUNCH,22,51,3,156,210,736,43,2251,3030,137.7273
SAN DIEGO,Apr 2014,CACF,2014,ASSOC STUDENTS CSU SAN DIEGO CHILDRENS CENTER ,CHILD_SNACK_PM,22,51,3,156,210,703,41,2149,2893,131.5
SAN DIEGO,May 2014,CACF,2014,ASSOC STUDENTS CSU SAN DIEGO CHILDRENS CENTER ,CHILD_BREAKFAST,21,51,3,156,210,429,25,1311,1765,84.0476
SAN DIEGO,May 2014,CACF,2014,ASSOC STUDENTS CSU SAN DIEGO CHILDRENS CENTER ,CHILD_LUNCH,21,51,3,156,210,675,40,2063,2778,132.2857
SAN DIEGO,May 2014,CACF,2014,ASSOC STUDENTS CSU SAN DIEGO CHILDRENS CENTER ,CHILD_SNACK_PM,21,51,3,156,210,637,38,1949,2624,124.9524
SAN DIEGO,Jun 2014,CACF,2014,ASSOC STUDENTS CSU SAN DIEGO CHILDRENS CENTER ,CHILD_BREAKFAST,21,51,3,156,210,377,22,1154,1553,73.9524
SAN DIEGO,Jun 2014,CACF,2014,ASSOC STUDENTS CSU SAN DIEGO CHILDRENS CENTER ,CHILD_LUNCH,21,51,3,156,210,612,36,1871,2519,119.9524
SAN DIEGO,Jun 2014,CACF,2014,ASSOC STUDENTS CSU SAN DIEGO CHILDRENS CENTER ,CHILD_SNACK_PM,21,51,3,156,210,574,34,1756,2364,112.5714
SAN DIEGO,Jul 2014,CACF,2014,ASSOC STUDENTS CSU SAN DIEGO CHILDRENS CENTER ,CHILD_BREAKFAST,22,51,3,156,210,377,22,1154,1553,70.5909
SAN DIEGO,Jul 2014,CACF,2014,ASSOC STUDENTS CSU SAN DIEGO CHILDRENS CENTER ,CHILD_LUNCH,22,51,3,156,210,619,36,1894,2549,115.8636
SAN DIEGO,Jul 2014,CACF,2014,ASSOC STUDENTS CSU SAN DIEGO CHILDRENS CENTER ,CHILD_SNACK_PM,22,51,3,156,210,570,34,1741,2345,106.5909
SAN DIEGO,Aug 2014,CACF,2014,ASSOC STUDENTS CSU SAN DIEGO CHILDRENS CENTER ,CHILD_BREAKFAST,20,51,3,156,210,347,20,1063,1430,71.5
SAN DIEGO,Aug 2014,CACF,2014,ASSOC STUDENTS CSU SAN DIEGO CHILDRENS CENTER ,CHILD_LUNCH,20,51,3,156,210,563,33,1722,2318,115.9
SAN DIEGO,Aug 2014,CACF,2014,ASSOC STUDENTS CSU SAN DIEGO CHILDRENS CENTER ,CHILD_SNACK_PM,20,51,3,156,210,526,31,1608,2165,108.25
SAN DIEGO,Sep 2014,CACF,2014,ASSOC STUDENTS CSU SAN DIEGO CHILDRENS CENTER ,CHILD_BREAKFAST,21,51,3,156,210,486,29,1487,2002,95.3333
SAN DIEGO,Sep 2014,CACF,2014,ASSOC STUDENTS CSU SAN DIEGO CHILDRENS CENTER ,CHILD_LUNCH,21,51,3,156,210,760,45,2324,3129,149
SAN DIEGO,Sep 2014,CACF,2014,ASSOC STUDENTS CSU SAN DIEGO CHILDRENS CENTER ,CHILD_SNACK_PM,21,51,3,156,210,707,42,2163,2912,138.6667
SAN DIEGO,Oct 2013,CACF,2014,ATC PACIFIC LLC,CHILD_BREAKFAST,23,9,3,27,39,75,25,224,324,14.087
SAN DIEGO,Oct 2013,CACF,2014,ATC PACIFIC LLC,CHILD_LUNCH,23,9,3,27,39,114,38,343,495,21.5217
SAN DIEGO,Oct 2013,CACF,2014,ATC PACIFIC LLC,CHILD_SNACK_PM,23,9,3,27,39,102,34,305,441,19.1739
SAN DIEGO,Oct 2013,CACF,2014,ATC PACIFIC LLC,OSCH_CHILD_BREAKFAST,23,7,0,6,13,51,0,43,94,4.087
SAN DIEGO,Oct 2013,CACF,2014,ATC PACIFIC LLC,OSCH_CHILD_SNACK_PM,23,7,0,6,13,71,0,61,132,5.7391
SAN DIEGO,Nov 2013,CACF,2014,ATC PACIFIC LLC,CHILD_BREAKFAST,18,9,3,27,39,62,21,185,268,14.8889
SAN DIEGO,Nov 2013,CACF,2014,ATC PACIFIC LLC,CHILD_LUNCH,18,9,3,27,39,96,32,289,417,23.1667
SAN DIEGO,Nov 2013,CACF,2014,ATC PACIFIC LLC,CHILD_SNACK_PM,18,9,3,27,39,85,28,254,367,20.3889
SAN DIEGO,Nov 2013,CACF,2014,ATC PACIFIC LLC,OSCH_CHILD_BREAKFAST,18,9,0,6,15,52,0,35,87,4.8333
SAN DIEGO,Nov 2013,CACF,2014,ATC PACIFIC LLC,OSCH_CHILD_LUNCH,18,9,0,6,15,13,0,8,21,1.1667
SAN DIEGO,Nov 2013,CACF,2014,ATC PACIFIC LLC,OSCH_CHILD_SNACK_PM,18,9,0,6,15,82,0,55,137,7.6111
SAN DIEGO,Dec 2013,CACF,2014,ATC PACIFIC LLC,CHILD_BREAKFAST,19,9,3,27,39,81,27,242,350,18.4211
SAN DIEGO,Dec 2013,CACF,2014,ATC PACIFIC LLC,CHILD_LUNCH,19,9,3,27,39,95,32,285,412,21.6842
SAN DIEGO,Dec 2013,CACF,2014,ATC PACIFIC LLC,CHILD_SNACK_PM,19,9,3,27,39,85,28,255,368,19.3684
SAN DIEGO,Dec 2013,CACF,2014,ATC PACIFIC LLC,OSCH_CHILD_BREAKFAST,19,9,0,7,16,77,0,60,137,7.2105
SAN DIEGO,Dec 2013,CACF,2014,ATC PACIFIC LLC,OSCH_CHILD_LUNCH,19,9,0,7,16,4,0,3,7,0.3684
SAN DIEGO,Dec 2013,CACF,2014,ATC PACIFIC LLC,OSCH_CHILD_SNACK_PM,19,9,0,7,16,71,0,56,127,6.6842
SAN DIEGO,Jan 2014,CACF,2014,ATC PACIFIC LLC,CHILD_BREAKFAST,21,11,3,25,39,118,32,268,418,19.9048
SAN DIEGO,Jan 2014,CACF,2014,ATC PACIFIC LLC,CHILD_LUNCH,21,11,3,25,39,129,35,295,459,21.8571
SAN DIEGO,Jan 2014,CACF,2014,ATC PACIFIC LLC,CHILD_SNACK_PM,21,11,3,25,39,128,35,291,454,21.619
SAN DIEGO,Jan 2014,CACF,2014,ATC PACIFIC LLC,OSCH_CHILD_BREAKFAST,21,9,0,7,16,63,0,49,112,5.3333
SAN DIEGO,Jan 2014,CACF,2014,ATC PACIFIC LLC,OSCH_CHILD_LUNCH,21,9,0,7,16,5,0,4,9,0.4286
SAN DIEGO,Jan 2014,CACF,2014,ATC PACIFIC LLC,OSCH_CHILD_SNACK_PM,21,9,0,7,16,71,0,55,126,6
SAN DIEGO,Feb 2014,CACF,2014,ATC PACIFIC LLC,CHILD_BREAKFAST,19,11,4,28,43,119,43,305,467,24.5789
SAN DIEGO,Feb 2014,CACF,2014,ATC PACIFIC LLC,CHILD_LUNCH,19,11,4,28,43,111,40,282,433,22.7895
SAN DIEGO,Feb 2014,CACF,2014,ATC PACIFIC LLC,CHILD_SNACK_PM,19,11,4,28,43,106,39,269,414,21.7895
SAN DIEGO,Feb 2014,CACF,2014,ATC PACIFIC LLC,OSCH_CHILD_BREAKFAST,19,9,0,7,16,64,0,50,114,6
SAN DIEGO,Feb 2014,CACF,2014,ATC PACIFIC LLC,OSCH_CHILD_LUNCH,19,9,0,7,16,3,0,3,6,0.3158
SAN DIEGO,Feb 2014,CACF,2014,ATC PACIFIC LLC,OSCH_CHILD_SNACK_PM,19,9,0,7,16,69,0,53,122,6.4211
SAN DIEGO,Mar 2014,CACF,2014,ATC PACIFIC LLC,CHILD_BREAKFAST,21,14,4,30,48,96,27,207,330,15.7143
SAN DIEGO,Mar 2014,CACF,2014,ATC PACIFIC LLC,CHILD_LUNCH,21,14,4,30,48,144,41,307,492,23.4286
SAN DIEGO,Mar 2014,CACF,2014,ATC PACIFIC LLC,CHILD_SNACK_PM,21,14,4,30,48,132,38,281,451,21.4762
SAN DIEGO,Mar 2014,CACF,2014,ATC PACIFIC LLC,OSCH_CHILD_BREAKFAST,21,10,0,7,17,69,0,48,117,5.5714
SAN DIEGO,Mar 2014,CACF,2014,ATC PACIFIC LLC,OSCH_CHILD_LUNCH,21,10,0,7,17,1,0,0,1,0.0476
SAN DIEGO,Mar 2014,CACF,2014,ATC PACIFIC LLC,OSCH_CHILD_SNACK_PM,21,10,0,7,17,76,0,53,129,6.1429
SAN DIEGO,Apr 2014,CACF,2014,ATC PACIFIC LLC,CHILD_BREAKFAST,22,15,4,29,48,172,46,332,550,25
SAN DIEGO,Apr 2014,CACF,2014,ATC PACIFIC LLC,CHILD_LUNCH,22,15,4,29,48,177,47,343,567,25.7727
SAN DIEGO,Apr 2014,CACF,2014,ATC PACIFIC LLC,CHILD_SNACK_PM,22,15,4,29,48,160,43,308,511,23.2273
SAN DIEGO,Apr 2014,CACF,2014,ATC PACIFIC LLC,OSCH_CHILD_BREAKFAST,22,11,0,6,17,80,0,43,123,5.5909
SAN DIEGO,Apr 2014,CACF,2014,ATC PACIFIC LLC,OSCH_CHILD_LUNCH,22,11,0,6,17,32,0,17,49,2.2273
SAN DIEGO,Apr 2014,CACF,2014,ATC PACIFIC LLC,OSCH_CHILD_SNACK_PM,22,11,0,6,17,87,0,47,134,6.0909
SAN DIEGO,May 2014,CACF,2014,ATC PACIFIC LLC,CHILD_BREAKFAST,21,19,3,25,47,238,38,312,588,28
SAN DIEGO,May 2014,CACF,2014,ATC PACIFIC LLC,CHILD_LUNCH,21,19,3,25,47,246,39,324,609,29
SAN DIEGO,May 2014,CACF,2014,ATC PACIFIC LLC,CHILD_SNACK_PM,21,19,3,25,47,226,36,298,560,26.6667
SAN DIEGO,May 2014,CACF,2014,ATC PACIFIC LLC,OSCH_CHILD_BREAKFAST,21,11,0,6,17,75,0,41,116,5.5238
SAN DIEGO,May 2014,CACF,2014,ATC PACIFIC LLC,OSCH_CHILD_SNACK_PM,21,11,0,6,17,85,0,47,132,6.2857
SAN DIEGO,Jun 2014,CACF,2014,ATC PACIFIC LLC,CHILD_BREAKFAST,21,21,3,25,49,225,32,269,526,25.0476
SAN DIEGO,Jun 2014,CACF,2014,ATC PACIFIC LLC,CHILD_LUNCH,21,21,3,25,49,251,36,299,586,27.9048
SAN DIEGO,Jun 2014,CACF,2014,ATC PACIFIC LLC,CHILD_SNACK_PM,21,21,3,25,49,228,32,271,531,25.2857
SAN DIEGO,Jun 2014,CACF,2014,ATC PACIFIC LLC,OSCH_CHILD_BREAKFAST,21,11,0,6,17,60,0,33,93,4.4286
SAN DIEGO,Jun 2014,CACF,2014,ATC PACIFIC LLC,OSCH_CHILD_LUNCH,21,11,0,6,17,36,0,20,56,2.6667
SAN DIEGO,Jun 2014,CACF,2014,ATC PACIFIC LLC,OSCH_CHILD_SNACK_PM,21,11,0,6,17,86,0,47,133,6.3333
SAN DIEGO,Jul 2014,CACF,2014,ATC PACIFIC LLC,CHILD_BREAKFAST,22,21,3,25,49,252,36,300,588,26.7273
SAN DIEGO,Jul 2014,CACF,2014,ATC PACIFIC LLC,CHILD_LUNCH,22,21,3,25,49,247,35,295,577,26.2273
SAN DIEGO,Jul 2014,CACF,2014,ATC PACIFIC LLC,CHILD_SNACK_PM,22,21,3,25,49,207,29,246,482,21.9091
SAN DIEGO,Jul 2014,CACF,2014,ATC PACIFIC LLC,OSCH_CHILD_BREAKFAST,22,11,0,6,17,45,0,25,70,3.1818
SAN DIEGO,Jul 2014,CACF,2014,ATC PACIFIC LLC,OSCH_CHILD_LUNCH,22,11,0,6,17,76,0,41,117,5.3182
SAN DIEGO,Jul 2014,CACF,2014,ATC PACIFIC LLC,OSCH_CHILD_SNACK_PM,22,11,0,6,17,64,0,35,99,4.5
SAN DIEGO,Aug 2014,CACF,2014,ATC PACIFIC LLC,CHILD_BREAKFAST,21,21,3,25,49,231,33,275,539,25.6667
SAN DIEGO,Aug 2014,CACF,2014,ATC PACIFIC LLC,CHILD_LUNCH,21,21,3,25,49,220,31,263,514,24.4762
SAN DIEGO,Aug 2014,CACF,2014,ATC PACIFIC LLC,CHILD_SNACK_PM,21,21,3,25,49,217,31,258,506,24.0952
SAN DIEGO,Aug 2014,CACF,2014,ATC PACIFIC LLC,OSCH_CHILD_BREAKFAST,21,11,0,6,17,44,0,24,68,3.2381
SAN DIEGO,Aug 2014,CACF,2014,ATC PACIFIC LLC,OSCH_CHILD_LUNCH,21,11,0,6,17,73,0,40,113,5.381
SAN DIEGO,Aug 2014,CACF,2014,ATC PACIFIC LLC,OSCH_CHILD_SNACK_PM,21,11,0,6,17,62,0,34,96,4.5714
SAN DIEGO,Sep 2014,CACF,2014,ATC PACIFIC LLC,CHILD_BREAKFAST,21,21,3,25,49,205,29,245,479,22.8095
SAN DIEGO,Sep 2014,CACF,2014,ATC PACIFIC LLC,CHILD_LUNCH,21,21,3,25,49,187,27,223,437,20.8095
SAN DIEGO,Sep 2014,CACF,2014,ATC PACIFIC LLC,CHILD_SNACK_PM,21,21,3,25,49,151,22,180,353,16.8095
SAN DIEGO,Sep 2014,CACF,2014,ATC PACIFIC LLC,OSCH_CHILD_BREAKFAST,21,11,0,6,17,80,0,43,123,5.8571
SAN DIEGO,Sep 2014,CACF,2014,ATC PACIFIC LLC,OSCH_CHILD_SNACK_PM,21,11,0,6,17,86,0,47,133,6.3333
SAN DIEGO,Oct 2013,CACF,2014,Boys & Girls Club of Greater San Diego,CHILD_BREAKFAST,23,45,11,1,57,552,135,12,699,30.3913
SAN DIEGO,Oct 2013,CACF,2014,Boys & Girls Club of Greater San Diego,CHILD_LUNCH,23,45,11,1,57,722,176,16,914,39.7391
SAN DIEGO,Oct 2013,CACF,2014,Boys & Girls Club of Greater San Diego,CHILD_SNACK_PM,23,45,11,1,57,677,165,15,857,37.2609
SAN DIEGO,Oct 2013,CACF,2014,Boys & Girls Club of Greater San Diego,OSCH_CHILD_BREAKFAST,23,31,5,0,36,36,6,0,42,1.8261
SAN DIEGO,Oct 2013,CACF,2014,Boys & Girls Club of Greater San Diego,OSCH_CHILD_LUNCH,23,31,5,0,36,28,4,0,32,1.3913
SAN DIEGO,Oct 2013,CACF,2014,Boys & Girls Club of Greater San Diego,OSCH_CHILD_SNACK_PM,23,31,5,0,36,474,76,0,550,23.913
SAN DIEGO,Nov 2013,CACF,2014,Boys & Girls Club of Greater San Diego,CHILD_BREAKFAST,18,45,11,1,57,459,112,11,582,32.3333
SAN DIEGO,Nov 2013,CACF,2014,Boys & Girls Club of Greater San Diego,CHILD_LUNCH,18,45,11,1,57,629,154,14,797,44.2778
SAN DIEGO,Nov 2013,CACF,2014,Boys & Girls Club of Greater San Diego,CHILD_SNACK_PM,18,45,11,1,57,599,146,14,759,42.1667
SAN DIEGO,Nov 2013,CACF,2014,Boys & Girls Club of Greater San Diego,OSCH_CHILD_BREAKFAST,18,31,5,0,36,47,8,0,55,3.0556
SAN DIEGO,Nov 2013,CACF,2014,Boys & Girls Club of Greater San Diego,OSCH_CHILD_LUNCH,18,31,5,0,36,218,35,0,253,14.0556
SAN DIEGO,Nov 2013,CACF,2014,Boys & Girls Club of Greater San Diego,OSCH_CHILD_SNACK_PM,18,31,5,0,36,362,58,0,420,23.3333
SAN DIEGO,Dec 2013,CACF,2014,Boys & Girls Club of Greater San Diego,CHILD_BREAKFAST,17,45,11,1,57,436,107,9,552,32.4706
SAN DIEGO,Dec 2013,CACF,2014,Boys & Girls Club of Greater San Diego,CHILD_LUNCH,17,45,11,1,57,554,135,13,702,41.2941
SAN DIEGO,Dec 2013,CACF,2014,Boys & Girls Club of Greater San Diego,CHILD_SNACK_PM,17,45,11,1,57,518,127,11,656,38.5882
SAN DIEGO,Dec 2013,CACF,2014,Boys & Girls Club of Greater San Diego,OSCH_CHILD_BREAKFAST,17,31,5,0,36,10,2,0,12,0.7059
SAN DIEGO,Dec 2013,CACF,2014,Boys & Girls Club of Greater San Diego,OSCH_CHILD_LUNCH,17,31,5,0,36,166,27,0,193,11.3529
SAN DIEGO,Dec 2013,CACF,2014,Boys & Girls Club of Greater San Diego,OSCH_CHILD_SNACK_PM,17,31,5,0,36,285,46,0,331,19.4706
SAN DIEGO,Jan 2014,CACF,2014,Boys & Girls Club of Greater San Diego,CHILD_BREAKFAST,21,45,11,1,57,538,131,12,681,32.4286
SAN DIEGO,Jan 2014,CACF,2014,Boys & Girls Club of Greater San Diego,CHILD_LUNCH,21,45,11,1,57,681,167,15,863,41.0952
SAN DIEGO,Jan 2014,CACF,2014,Boys & Girls Club of Greater San Diego,CHILD_SNACK_PM,21,45,11,1,57,632,154,14,800,38.0952
SAN DIEGO,Jan 2014,CACF,2014,Boys & Girls Club of Greater San Diego,OSCH_CHILD_BREAKFAST,21,31,5,0,36,17,3,0,20,0.9524
SAN DIEGO,Jan 2014,CACF,2014,Boys & Girls Club of Greater San Diego,OSCH_CHILD_LUNCH,21,31,5,0,36,185,30,0,215,10.2381
SAN DIEGO,Jan 2014,CACF,2014,Boys & Girls Club of Greater San Diego,OSCH_CHILD_SNACK_PM,21,31,5,0,36,381,61,0,442,21.0476
SAN DIEGO,Feb 2014,CACF,2014,Boys & Girls Club of Greater San Diego,CHILD_BREAKFAST,20,45,11,1,57,512,125,11,648,32.4
SAN DIEGO,Feb 2014,CACF,2014,Boys & Girls Club of Greater San Diego,CHILD_LUNCH,20,45,11,1,57,681,167,15,863,43.15
SAN DIEGO,Feb 2014,CACF,2014,Boys & Girls Club of Greater San Diego,CHILD_SNACK_PM,20,45,11,1,57,604,148,13,765,38.25
SAN DIEGO,Feb 2014,CACF,2014,Boys & Girls Club of Greater San Diego,OSCH_CHILD_BREAKFAST,20,31,5,0,36,23,4,0,27,1.35
SAN DIEGO,Feb 2014,CACF,2014,Boys & Girls Club of Greater San Diego,OSCH_CHILD_LUNCH,20,31,5,0,36,178,29,0,207,10.35
SAN DIEGO,Feb 2014,CACF,2014,Boys & Girls Club of Greater San Diego,OSCH_CHILD_SNACK_PM,20,31,5,0,36,342,55,0,397,19.85
SAN DIEGO,Mar 2014,CACF,2014,Boys & Girls Club of Greater San Diego,CHILD_BREAKFAST,21,45,11,1,57,609,149,14,772,36.7619
SAN DIEGO,Mar 2014,CACF,2014,Boys & Girls Club of Greater San Diego,CHILD_LUNCH,21,45,11,1,57,712,174,16,902,42.9524
SAN DIEGO,Mar 2014,CACF,2014,Boys & Girls Club of Greater San Diego,CHILD_SNACK_PM,21,45,11,1,57,739,181,16,936,44.5714
SAN DIEGO,Mar 2014,CACF,2014,Boys & Girls Club of Greater San Diego,OSCH_CHILD_LUNCH,21,31,5,0,36,219,35,0,254,12.0952
SAN DIEGO,Mar 2014,CACF,2014,Boys & Girls Club of Greater San Diego,OSCH_CHILD_SNACK_PM,21,31,5,0,36,399,64,0,463,22.0476
SAN DIEGO,Apr 2014,CACF,2014,Boys & Girls Club of Greater San Diego,CHILD_BREAKFAST,22,45,11,1,57,716,175,16,907,41.2273
SAN DIEGO,Apr 2014,CACF,2014,Boys & Girls Club of Greater San Diego,CHILD_LUNCH,22,45,11,1,57,911,223,20,1154,52.4545
SAN DIEGO,Apr 2014,CACF,2014,Boys & Girls Club of Greater San Diego,CHILD_SNACK_PM,22,45,11,1,57,834,204,18,1056,48
SAN DIEGO,Apr 2014,CACF,2014,Boys & Girls Club of Greater San Diego,OSCH_CHILD_BREAKFAST,22,31,5,0,36,149,24,0,173,7.8636
SAN DIEGO,Apr 2014,CACF,2014,Boys & Girls Club of Greater San Diego,OSCH_CHILD_LUNCH,22,31,5,0,36,339,55,0,394,17.9091
SAN DIEGO,Apr 2014,CACF,2014,Boys & Girls Club of Greater San Diego,OSCH_CHILD_SNACK_PM,22,31,5,0,36,411,66,0,477,21.6818
SAN DIEGO,May 2014,CACF,2014,Boys & Girls Club of Greater San Diego,CHILD_BREAKFAST,21,45,11,1,57,669,164,15,848,40.381
SAN DIEGO,May 2014,CACF,2014,Boys & Girls Club of Greater San Diego,CHILD_LUNCH,21,45,11,1,57,861,210,19,1090,51.9048
SAN DIEGO,May 2014,CACF,2014,Boys & Girls Club of Greater San Diego,CHILD_SNACK_PM,21,45,11,1,57,786,192,18,996,47.4286
SAN DIEGO,May 2014,CACF,2014,Boys & Girls Club of Greater San Diego,OSCH_CHILD_BREAKFAST,21,31,5,0,36,7,1,0,8,0.381
SAN DIEGO,May 2014,CACF,2014,Boys & Girls Club of Greater San Diego,OSCH_CHILD_LUNCH,21,31,5,0,36,224,36,0,260,12.381
SAN DIEGO,May 2014,CACF,2014,Boys & Girls Club of Greater San Diego,OSCH_CHILD_SNACK_PM,21,31,5,0,36,380,61,0,441,21
SAN DIEGO,Jun 2014,CACF,2014,Boys & Girls Club of Greater San Diego,CHILD_BREAKFAST,21,45,11,1,57,688,168,15,871,41.4762
SAN DIEGO,Jun 2014,CACF,2014,Boys & Girls Club of Greater San Diego,CHILD_LUNCH,21,45,11,1,57,872,213,20,1105,52.619
SAN DIEGO,Jun 2014,CACF,2014,Boys & Girls Club of Greater San Diego,CHILD_SNACK_PM,21,45,11,1,57,825,202,18,1045,49.7619
SAN DIEGO,Jun 2014,CACF,2014,Boys & Girls Club of Greater San Diego,OSCH_CHILD_BREAKFAST,21,31,5,0,36,224,36,0,260,12.381
SAN DIEGO,Jun 2014,CACF,2014,Boys & Girls Club of Greater San Diego,OSCH_CHILD_LUNCH,21,31,5,0,36,377,61,0,438,20.8571
SAN DIEGO,Jun 2014,CACF,2014,Boys & Girls Club of Greater San Diego,OSCH_CHILD_SNACK_PM,21,31,5,0,36,387,63,0,450,21.4286
SAN DIEGO,Jul 2014,CACF,2014,Boys & Girls Club of Greater San Diego,CHILD_BREAKFAST,22,45,11,1,57,568,139,13,720,32.7273
SAN DIEGO,Jul 2014,CACF,2014,Boys & Girls Club of Greater San Diego,CHILD_LUNCH,22,45,11,1,57,701,171,16,888,40.3636
SAN DIEGO,Jul 2014,CACF,2014,Boys & Girls Club of Greater San Diego,CHILD_SNACK_PM,22,45,11,1,57,677,166,15,858,39
SAN DIEGO,Jul 2014,CACF,2014,Boys & Girls Club of Greater San Diego,OSCH_CHILD_BREAKFAST,22,31,5,0,36,547,88,0,635,28.8636
SAN DIEGO,Jul 2014,CACF,2014,Boys & Girls Club of Greater San Diego,OSCH_CHILD_LUNCH,22,31,5,0,36,644,104,0,748,34
SAN DIEGO,Jul 2014,CACF,2014,Boys & Girls Club of Greater San Diego,OSCH_CHILD_SNACK_PM,22,31,5,0,36,565,91,0,656,29.8182
SAN DIEGO,Aug 2014,CACF,2014,Boys & Girls Club of Greater San Diego,CHILD_BREAKFAST,21,45,11,1,57,546,134,12,692,32.9524
SAN DIEGO,Aug 2014,CACF,2014,Boys & Girls Club of Greater San Diego,CHILD_LUNCH,21,45,11,1,57,690,169,15,874,41.619
SAN DIEGO,Aug 2014,CACF,2014,Boys & Girls Club of Greater San Diego,CHILD_SNACK_PM,21,45,11,1,57,669,163,15,847,40.3333
SAN DIEGO,Aug 2014,CACF,2014,Boys & Girls Club of Greater San Diego,OSCH_CHILD_BREAKFAST,21,31,5,0,36,294,48,0,342,16.2857
SAN DIEGO,Aug 2014,CACF,2014,Boys & Girls Club of Greater San Diego,OSCH_CHILD_LUNCH,21,31,5,0,36,514,83,0,597,28.4286
SAN DIEGO,Aug 2014,CACF,2014,Boys & Girls Club of Greater San Diego,OSCH_CHILD_SNACK_PM,21,31,5,0,36,606,98,0,704,33.5238
SAN DIEGO,Sep 2014,CACF,2014,Boys & Girls Club of Greater San Diego,CHILD_BREAKFAST,21,45,11,1,57,568,139,13,720,34.2857
SAN DIEGO,Sep 2014,CACF,2014,Boys & Girls Club of Greater San Diego,CHILD_LUNCH,21,45,11,1,57,711,174,16,901,42.9048
SAN DIEGO,Sep 2014,CACF,2014,Boys & Girls Club of Greater San Diego,CHILD_SNACK_PM,21,45,11,1,57,708,173,16,897,42.7143
SAN DIEGO,Sep 2014,CACF,2014,Boys & Girls Club of Greater San Diego,OSCH_CHILD_LUNCH,21,31,5,0,36,321,52,0,373,17.7619
SAN DIEGO,Sep 2014,CACF,2014,Boys & Girls Club of Greater San Diego,OSCH_CHILD_SNACK_PM,21,31,5,0,36,596,96,0,692,32.9524
SAN DIEGO,Oct 2013,CACF,2014,BOYS & GIRLS CLUB OF IMPERIAL BEACH ,ATRISK_CHILD_SNACK,23,150,0,0,150,1620,0,0,1620,70.4348
SAN DIEGO,Nov 2013,CACF,2014,BOYS & GIRLS CLUB OF IMPERIAL BEACH ,ATRISK_CHILD_SNACK,18,150,0,0,150,1235,0,0,1235,68.6111
SAN DIEGO,Dec 2013,CACF,2014,BOYS & GIRLS CLUB OF IMPERIAL BEACH ,ATRISK_CHILD_SNACK,17,150,0,0,150,1145,0,0,1145,67.3529
SAN DIEGO,Jan 2014,CACF,2014,BOYS & GIRLS CLUB OF IMPERIAL BEACH ,ATRISK_CHILD_SNACK,14,150,0,0,150,1071,0,0,1071,76.5
SAN DIEGO,Feb 2014,CACF,2014,BOYS & GIRLS CLUB OF IMPERIAL BEACH ,ATRISK_CHILD_SNACK,19,150,0,0,150,1347,0,0,1347,70.8947
SAN DIEGO,Mar 2014,CACF,2014,BOYS & GIRLS CLUB OF IMPERIAL BEACH ,ATRISK_CHILD_SNACK,21,150,0,0,150,1648,0,0,1648,78.4762
SAN DIEGO,Apr 2014,CACF,2014,BOYS & GIRLS CLUB OF IMPERIAL BEACH ,ATRISK_CHILD_SNACK,22,150,0,0,150,1694,0,0,1694,77
SAN DIEGO,May 2014,CACF,2014,BOYS & GIRLS CLUB OF IMPERIAL BEACH ,ATRISK_CHILD_SNACK,21,150,0,0,150,1650,0,0,1650,78.5714
SAN DIEGO,Jun 2014,CACF,2014,BOYS & GIRLS CLUB OF IMPERIAL BEACH ,ATRISK_CHILD_SNACK,21,150,0,0,150,1376,0,0,1376,65.5238
SAN DIEGO,Sep 2014,CACF,2014,BOYS & GIRLS CLUB OF IMPERIAL BEACH ,ATRISK_CHILD_SNACK,21,150,0,0,150,1424,0,0,1424,67.8095
SAN DIEGO,Oct 2013,CACF,2014,CA RELIABLE MEDICAL SYSTEMS INC ,ADULT_BREAKFAST,26,448,0,0,448,4382,0,0,4382,168.5385
SAN DIEGO,Oct 2013,CACF,2014,CA RELIABLE MEDICAL SYSTEMS INC ,ADULT_LUNCH,26,448,0,0,448,4382,0,0,4382,168.5385
SAN DIEGO,Oct 2013,CACF,2014,CA RELIABLE MEDICAL SYSTEMS INC ,ADULT_SNACK_AM,26,448,0,0,448,4382,0,0,4382,168.5385
SAN DIEGO,Nov 2013,CACF,2014,CA RELIABLE MEDICAL SYSTEMS INC ,ADULT_BREAKFAST,26,448,0,0,448,4288,0,0,4288,164.9231
SAN DIEGO,Nov 2013,CACF,2014,CA RELIABLE MEDICAL SYSTEMS INC ,ADULT_LUNCH,26,448,0,0,448,4288,0,0,4288,164.9231
SAN DIEGO,Nov 2013,CACF,2014,CA RELIABLE MEDICAL SYSTEMS INC ,ADULT_SNACK_AM,26,448,0,0,448,4288,0,0,4288,164.9231
SAN DIEGO,Dec 2013,CACF,2014,CA RELIABLE MEDICAL SYSTEMS INC ,ADULT_BREAKFAST,31,448,0,0,448,4456,0,0,4456,143.7419
SAN DIEGO,Dec 2013,CACF,2014,CA RELIABLE MEDICAL SYSTEMS INC ,ADULT_LUNCH,31,448,0,0,448,4456,0,0,4456,143.7419
SAN DIEGO,Dec 2013,CACF,2014,CA RELIABLE MEDICAL SYSTEMS INC ,ADULT_SNACK_AM,31,448,0,0,448,4456,0,0,4456,143.7419
SAN DIEGO,Jan 2014,CACF,2014,CA RELIABLE MEDICAL SYSTEMS INC ,ADULT_BREAKFAST,31,448,0,0,448,4633,0,0,4633,149.4516
SAN DIEGO,Jan 2014,CACF,2014,CA RELIABLE MEDICAL SYSTEMS INC ,ADULT_LUNCH,31,448,0,0,448,4633,0,0,4633,149.4516
SAN DIEGO,Jan 2014,CACF,2014,CA RELIABLE MEDICAL SYSTEMS INC ,ADULT_SNACK_AM,31,448,0,0,448,4633,0,0,4633,149.4516
SAN DIEGO,Feb 2014,CACF,2014,CA RELIABLE MEDICAL SYSTEMS INC ,ADULT_BREAKFAST,28,448,0,0,448,4346,0,0,4346,155.2143
SAN DIEGO,Feb 2014,CACF,2014,CA RELIABLE MEDICAL SYSTEMS INC ,ADULT_LUNCH,28,448,0,0,448,4346,0,0,4346,155.2143
SAN DIEGO,Feb 2014,CACF,2014,CA RELIABLE MEDICAL SYSTEMS INC ,ADULT_SNACK_AM,28,448,0,0,448,4346,0,0,4346,155.2143
SAN DIEGO,Mar 2014,CACF,2014,CA RELIABLE MEDICAL SYSTEMS INC ,ADULT_BREAKFAST,31,448,0,0,448,4782,0,0,4782,154.2581
SAN DIEGO,Mar 2014,CACF,2014,CA RELIABLE MEDICAL SYSTEMS INC ,ADULT_LUNCH,31,448,0,0,448,4782,0,0,4782,154.2581
SAN DIEGO,Mar 2014,CACF,2014,CA RELIABLE MEDICAL SYSTEMS INC ,ADULT_SNACK_AM,31,448,0,0,448,4782,0,0,4782,154.2581
SAN DIEGO,Apr 2014,CACF,2014,CA RELIABLE MEDICAL SYSTEMS INC ,ADULT_BREAKFAST,30,448,0,0,448,4769,0,0,4769,158.9667
SAN DIEGO,Apr 2014,CACF,2014,CA RELIABLE MEDICAL SYSTEMS INC ,ADULT_LUNCH,30,448,0,0,448,4769,0,0,4769,158.9667
SAN DIEGO,Apr 2014,CACF,2014,CA RELIABLE MEDICAL SYSTEMS INC ,ADULT_SNACK_AM,30,448,0,0,448,4769,0,0,4769,158.9667
SAN DIEGO,May 2014,CACF,2014,CA RELIABLE MEDICAL SYSTEMS INC ,ADULT_BREAKFAST,31,448,0,0,448,5163,0,0,5163,166.5484
SAN DIEGO,May 2014,CACF,2014,CA RELIABLE MEDICAL SYSTEMS INC ,ADULT_LUNCH,31,448,0,0,448,5163,0,0,5163,166.5484
SAN DIEGO,May 2014,CACF,2014,CA RELIABLE MEDICAL SYSTEMS INC ,ADULT_SNACK_AM,31,448,0,0,448,5163,0,0,5163,166.5484
SAN DIEGO,Jun 2014,CACF,2014,CA RELIABLE MEDICAL SYSTEMS INC ,ADULT_BREAKFAST,30,448,0,0,448,5112,0,0,5112,170.4
SAN DIEGO,Jun 2014,CACF,2014,CA RELIABLE MEDICAL SYSTEMS INC ,ADULT_LUNCH,30,448,0,0,448,5112,0,0,5112,170.4
SAN DIEGO,Jun 2014,CACF,2014,CA RELIABLE MEDICAL SYSTEMS INC ,ADULT_SNACK_AM,30,448,0,0,448,5112,0,0,5112,170.4
SAN DIEGO,Jul 2014,CACF,2014,CA RELIABLE MEDICAL SYSTEMS INC ,ADULT_BREAKFAST,31,448,0,0,448,5342,0,0,5342,172.3226
SAN DIEGO,Jul 2014,CACF,2014,CA RELIABLE MEDICAL SYSTEMS INC ,ADULT_LUNCH,31,448,0,0,448,5342,0,0,5342,172.3226
SAN DIEGO,Jul 2014,CACF,2014,CA RELIABLE MEDICAL SYSTEMS INC ,ADULT_SNACK_AM,31,448,0,0,448,5342,0,0,5342,172.3226
SAN DIEGO,Aug 2014,CACF,2014,CA RELIABLE MEDICAL SYSTEMS INC ,ADULT_BREAKFAST,31,448,0,0,448,5057,0,0,5057,163.129
SAN DIEGO,Aug 2014,CACF,2014,CA RELIABLE MEDICAL SYSTEMS INC ,ADULT_LUNCH,31,448,0,0,448,5057,0,0,5057,163.129
SAN DIEGO,Aug 2014,CACF,2014,CA RELIABLE MEDICAL SYSTEMS INC ,ADULT_SNACK_AM,31,448,0,0,448,5057,0,0,5057,163.129
SAN DIEGO,Sep 2014,CACF,2014,CA RELIABLE MEDICAL SYSTEMS INC ,ADULT_BREAKFAST,30,448,0,0,448,5106,0,0,5106,170.2
SAN DIEGO,Sep 2014,CACF,2014,CA RELIABLE MEDICAL SYSTEMS INC ,ADULT_LUNCH,30,448,0,0,448,5106,0,0,5106,170.2
SAN DIEGO,Sep 2014,CACF,2014,CA RELIABLE MEDICAL SYSTEMS INC ,ADULT_SNACK_AM,30,448,0,0,448,5106,0,0,5106,170.2
SAN DIEGO,Oct 2013,CACF,2014,CASA DE AMPARO,CHILD_BREAKFAST,23,25,4,2,31,415,66,34,515,22.3913
SAN DIEGO,Oct 2013,CACF,2014,CASA DE AMPARO,CHILD_LUNCH,23,25,4,2,31,439,70,35,544,23.6522
SAN DIEGO,Oct 2013,CACF,2014,CASA DE AMPARO,CHILD_SNACK_PM,23,25,4,2,31,354,57,28,439,19.087
SAN DIEGO,Nov 2013,CACF,2014,CASA DE AMPARO,CHILD_BREAKFAST,19,27,5,2,34,313,58,23,394,20.7368
SAN DIEGO,Nov 2013,CACF,2014,CASA DE AMPARO,CHILD_LUNCH,19,27,5,2,34,379,70,28,477,25.1053
SAN DIEGO,Nov 2013,CACF,2014,CASA DE AMPARO,CHILD_SNACK_PM,19,27,5,2,34,275,51,20,346,18.2105
SAN DIEGO,Dec 2013,CACF,2014,CASA DE AMPARO,CHILD_BREAKFAST,19,27,5,2,34,335,62,25,422,22.2105
SAN DIEGO,Dec 2013,CACF,2014,CASA DE AMPARO,CHILD_LUNCH,19,27,5,2,34,371,69,27,467,24.5789
SAN DIEGO,Dec 2013,CACF,2014,CASA DE AMPARO,CHILD_SNACK_PM,19,27,5,2,34,284,53,21,358,18.8421
SAN DIEGO,Jan 2014,CACF,2014,CASA DE AMPARO,CHILD_BREAKFAST,19,27,5,2,34,358,66,27,451,23.7368
SAN DIEGO,Jan 2014,CACF,2014,CASA DE AMPARO,CHILD_LUNCH,19,27,5,2,34,391,72,29,492,25.8947
SAN DIEGO,Jan 2014,CACF,2014,CASA DE AMPARO,CHILD_SNACK_PM,19,27,5,2,34,268,50,19,337,17.7368
SAN DIEGO,Feb 2014,CACF,2014,CASA DE AMPARO,CHILD_BREAKFAST,19,27,5,2,34,304,56,23,383,20.1579
SAN DIEGO,Feb 2014,CACF,2014,CASA DE AMPARO,CHILD_LUNCH,19,27,5,2,34,361,67,26,454,23.8947
SAN DIEGO,Feb 2014,CACF,2014,CASA DE AMPARO,CHILD_SNACK_PM,19,27,5,2,34,280,52,20,352,18.5263
SAN DIEGO,Mar 2014,CACF,2014,CASA DE AMPARO,CHILD_BREAKFAST,21,27,5,2,34,331,61,25,417,19.8571
SAN DIEGO,Mar 2014,CACF,2014,CASA DE AMPARO,CHILD_LUNCH,21,27,5,2,34,363,67,27,457,21.7619
SAN DIEGO,Mar 2014,CACF,2014,CASA DE AMPARO,CHILD_SNACK_PM,21,27,5,2,34,273,51,20,344,16.381
SAN DIEGO,Apr 2014,CACF,2014,CASA DE AMPARO,CHILD_BREAKFAST,22,27,5,2,34,337,63,25,425,19.3182
SAN DIEGO,Apr 2014,CACF,2014,CASA DE AMPARO,CHILD_LUNCH,22,27,5,2,34,404,75,30,509,23.1364
SAN DIEGO,Apr 2014,CACF,2014,CASA DE AMPARO,CHILD_SNACK_PM,22,27,5,2,34,303,56,22,381,17.3182
SAN DIEGO,May 2014,CACF,2014,CASA DE AMPARO,CHILD_BREAKFAST,19,27,5,2,34,276,51,20,347,18.2632
SAN DIEGO,May 2014,CACF,2014,CASA DE AMPARO,CHILD_LUNCH,19,27,5,2,34,339,63,25,427,22.4737
SAN DIEGO,May 2014,CACF,2014,CASA DE AMPARO,CHILD_SNACK_PM,19,27,5,2,34,259,48,19,326,17.1579
SAN DIEGO,Jun 2014,CACF,2014,CASA DE AMPARO,CHILD_BREAKFAST,21,27,5,2,34,296,55,22,373,17.7619
SAN DIEGO,Jun 2014,CACF,2014,CASA DE AMPARO,CHILD_LUNCH,21,27,5,2,34,352,65,26,443,21.0952
SAN DIEGO,Jun 2014,CACF,2014,CASA DE AMPARO,CHILD_SNACK_PM,21,27,5,2,34,263,49,19,331,15.7619
SAN DIEGO,Jul 2014,CACF,2014,CASA DE AMPARO,CHILD_BREAKFAST,22,27,5,2,34,292,54,22,368,16.7273
SAN DIEGO,Jul 2014,CACF,2014,CASA DE AMPARO,CHILD_LUNCH,22,27,5,2,34,361,67,27,455,20.6818
SAN DIEGO,Jul 2014,CACF,2014,CASA DE AMPARO,CHILD_SNACK_PM,22,27,5,2,34,267,49,20,336,15.2727
SAN DIEGO,Aug 2014,CACF,2014,CASA DE AMPARO,CHILD_BREAKFAST,20,27,5,2,34,260,48,20,328,16.4
SAN DIEGO,Aug 2014,CACF,2014,CASA DE AMPARO,CHILD_LUNCH,20,27,5,2,34,315,58,24,397,19.85
SAN DIEGO,Aug 2014,CACF,2014,CASA DE AMPARO,CHILD_SNACK_PM,20,27,5,2,34,251,46,19,316,15.8
SAN DIEGO,Sep 2014,CACF,2014,CASA DE AMPARO,CHILD_BREAKFAST,21,23,4,1,28,324,56,14,394,18.7619
SAN DIEGO,Sep 2014,CACF,2014,CASA DE AMPARO,CHILD_LUNCH,21,23,4,1,28,359,62,16,437,20.8095
SAN DIEGO,Sep 2014,CACF,2014,CASA DE AMPARO,CHILD_SNACK_PM,21,23,4,1,28,281,49,12,342,16.2857
SAN DIEGO,Oct 2013,DCH,2014,CHICANO FEDERATION OF SAN DIEGO COUNTY INC,DCH_BREAKFAST,31,0,0,0,0,59691,0,0,59691,1925.5161
SAN DIEGO,Oct 2013,DCH,2014,CHICANO FEDERATION OF SAN DIEGO COUNTY INC,DCH_BREAKFAST,,0,0,0,0,0,789,1275,2064,0
SAN DIEGO,Oct 2013,DCH,2014,CHICANO FEDERATION OF SAN DIEGO COUNTY INC,DCH_BREAKFAST,23,0,0,0,0,0,0,0,0,0
SAN DIEGO,Oct 2013,DCH,2014,CHICANO FEDERATION OF SAN DIEGO COUNTY INC,DCH_BREAKFAST,23,0,0,0,0,0,0,0,0,0
SAN DIEGO,Oct 2013,DCH,2014,CHICANO FEDERATION OF SAN DIEGO COUNTY INC,DCH_BREAKFAST,23,0,0,0,0,0,0,0,0,0
SAN DIEGO,Oct 2013,DCH,2014,CHICANO FEDERATION OF SAN DIEGO COUNTY INC,DCH_LUNCH,31,0,0,0,0,81518,0,0,81518,2629.6129
SAN DIEGO,Oct 2013,DCH,2014,CHICANO FEDERATION OF SAN DIEGO COUNTY INC,DCH_LUNCH,,0,0,0,0,0,948,2548,3496,0
SAN DIEGO,Oct 2013,DCH,2014,CHICANO FEDERATION OF SAN DIEGO COUNTY INC,DCH_LUNCH,23,0,0,0,0,0,0,0,0,0
SAN DIEGO,Oct 2013,DCH,2014,CHICANO FEDERATION OF SAN DIEGO COUNTY INC,DCH_LUNCH,23,0,0,0,0,0,0,0,0,0
SAN DIEGO,Oct 2013,DCH,2014,CHICANO FEDERATION OF SAN DIEGO COUNTY INC,DCH_LUNCH,23,0,0,0,0,0,0,0,0,0
SAN DIEGO,Oct 2013,DCH,2014,CHICANO FEDERATION OF SAN DIEGO COUNTY INC,DCH_SNACK_AM,31,0,0,0,0,36910,0,0,36910,1190.6452
SAN DIEGO,Oct 2013,DCH,2014,CHICANO FEDERATION OF SAN DIEGO COUNTY INC,DCH_SNACK_AM,,0,0,0,0,0,500,1113,1613,0
SAN DIEGO,Oct 2013,DCH,2014,CHICANO FEDERATION OF SAN DIEGO COUNTY INC,DCH_SNACK_AM,23,0,0,0,0,0,0,0,0,0
SAN DIEGO,Oct 2013,DCH,2014,CHICANO FEDERATION OF SAN DIEGO COUNTY INC,DCH_SNACK_AM,23,0,0,0,0,0,0,0,0,0
SAN DIEGO,Oct 2013,DCH,2014,CHICANO FEDERATION OF SAN DIEGO COUNTY INC,DCH_SNACK_AM,23,0,0,0,0,0,0,0,0,0
SAN DIEGO,Oct 2013,DCH,2014,CHICANO FEDERATION OF SAN DIEGO COUNTY INC,DCH_SNACK_NT,31,0,0,0,0,11861,0,0,11861,382.6129
SAN DIEGO,Oct 2013,DCH,2014,CHICANO FEDERATION OF SAN DIEGO COUNTY INC,DCH_SNACK_NT,23,0,0,0,0,0,0,0,0,0
SAN DIEGO,Oct 2013,DCH,2014,CHICANO FEDERATION OF SAN DIEGO COUNTY INC,DCH_SNACK_NT,23,0,0,0,0,0,0,0,0,0
SAN DIEGO,Oct 2013,DCH,2014,CHICANO FEDERATION OF SAN DIEGO COUNTY INC,DCH_SNACK_NT,23,0,0,0,0,0,0,0,0,0
SAN DIEGO,Oct 2013,DCH,2014,CHICANO FEDERATION OF SAN DIEGO COUNTY INC,DCH_SNACK_PM,31,0,0,0,0,78486,0,0,78486,2531.8065
SAN DIEGO,Oct 2013,DCH,2014,CHICANO FEDERATION OF SAN DIEGO COUNTY INC,DCH_SNACK_PM,,0,0,0,0,0,756,1713,2469,0
SAN DIEGO,Oct 2013,DCH,2014,CHICANO FEDERATION OF SAN DIEGO COUNTY INC,DCH_SNACK_PM,23,0,0,0,0,0,0,0,0,0
SAN DIEGO,Oct 2013,DCH,2014,CHICANO FEDERATION OF SAN DIEGO COUNTY INC,DCH_SNACK_PM,23,0,0,0,0,0,0,0,0,0
SAN DIEGO,Oct 2013,DCH,2014,CHICANO FEDERATION OF SAN DIEGO COUNTY INC,DCH_SNACK_PM,23,0,0,0,0,0,0,0,0,0
SAN DIEGO,Oct 2013,DCH,2014,CHICANO FEDERATION OF SAN DIEGO COUNTY INC,DCH_SUPPER,31,0,0,0,0,98407,0,0,98407,3174.4194
SAN DIEGO,Oct 2013,DCH,2014,CHICANO FEDERATION OF SAN DIEGO COUNTY INC,DCH_SUPPER,,0,0,0,0,0,1006,1454,2460,0
SAN DIEGO,Oct 2013,DCH,2014,CHICANO FEDERATION OF SAN DIEGO COUNTY INC,DCH_SUPPER,23,0,0,0,0,0,0,0,0,0
SAN DIEGO,Oct 2013,DCH,2014,CHICANO FEDERATION OF SAN DIEGO COUNTY INC,DCH_SUPPER,23,0,0,0,0,0,0,0,0,0
SAN DIEGO,Oct 2013,DCH,2014,CHICANO FEDERATION OF SAN DIEGO COUNTY INC,DCH_SUPPER,23,0,0,0,0,0,0,0,0,0
SAN DIEGO,Nov 2013,DCH,2014,CHICANO FEDERATION OF SAN DIEGO COUNTY INC,DCH_BREAKFAST,28,0,0,0,0,47815,0,0,47815,1707.6786
SAN DIEGO,Nov 2013,DCH,2014,CHICANO FEDERATION OF SAN DIEGO COUNTY INC,DCH_BREAKFAST,,0,0,0,0,0,713,968,1681,0
SAN DIEGO,Nov 2013,DCH,2014,CHICANO FEDERATION OF SAN DIEGO COUNTY INC,DCH_BREAKFAST,19,0,0,0,0,0,0,0,0,0
SAN DIEGO,Nov 2013,DCH,2014,CHICANO FEDERATION OF SAN DIEGO COUNTY INC,DCH_BREAKFAST,19,0,0,0,0,0,0,0,0,0
SAN DIEGO,Nov 2013,DCH,2014,CHICANO FEDERATION OF SAN DIEGO COUNTY INC,DCH_BREAKFAST,19,0,0,0,0,0,0,0,0,0
SAN DIEGO,Nov 2013,DCH,2014,CHICANO FEDERATION OF SAN DIEGO COUNTY INC,DCH_LUNCH,28,0,0,0,0,70073,0,0,70073,2502.6071
SAN DIEGO,Nov 2013,DCH,2014,CHICANO FEDERATION OF SAN DIEGO COUNTY INC,DCH_LUNCH,,0,0,0,0,0,879,1979,2858,0
SAN DIEGO,Nov 2013,DCH,2014,CHICANO FEDERATION OF SAN DIEGO COUNTY INC,DCH_LUNCH,19,0,0,0,0,0,0,0,0,0
SAN DIEGO,Nov 2013,DCH,2014,CHICANO FEDERATION OF SAN DIEGO COUNTY INC,DCH_LUNCH,19,0,0,0,0,0,0,0,0,0
SAN DIEGO,Nov 2013,DCH,2014,CHICANO FEDERATION OF SAN DIEGO COUNTY INC,DCH_LUNCH,19,0,0,0,0,0,0,0,0,0
SAN DIEGO,Nov 2013,DCH,2014,CHICANO FEDERATION OF SAN DIEGO COUNTY INC,DCH_SNACK_AM,28,0,0,0,0,30809,0,0,30809,1100.3214
SAN DIEGO,Nov 2013,DCH,2014,CHICANO FEDERATION OF SAN DIEGO COUNTY INC,DCH_SNACK_AM,,0,0,0,0,0,439,879,1318,0
SAN DIEGO,Nov 2013,DCH,2014,CHICANO FEDERATION OF SAN DIEGO COUNTY INC,DCH_SNACK_AM,19,0,0,0,0,0,0,0,0,0
SAN DIEGO,Nov 2013,DCH,2014,CHICANO FEDERATION OF SAN DIEGO COUNTY INC,DCH_SNACK_AM,19,0,0,0,0,0,0,0,0,0
SAN DIEGO,Nov 2013,DCH,2014,CHICANO FEDERATION OF SAN DIEGO COUNTY INC,DCH_SNACK_AM,19,0,0,0,0,0,0,0,0,0
SAN DIEGO,Nov 2013,DCH,2014,CHICANO FEDERATION OF SAN DIEGO COUNTY INC,DCH_SNACK_NT,28,0,0,0,0,9398,0,0,9398,335.6429
SAN DIEGO,Nov 2013,DCH,2014,CHICANO FEDERATION OF SAN DIEGO COUNTY INC,DCH_SNACK_NT,19,0,0,0,0,0,0,0,0,0
SAN DIEGO,Nov 2013,DCH,2014,CHICANO FEDERATION OF SAN DIEGO COUNTY INC,DCH_SNACK_NT,19,0,0,0,0,0,0,0,0,0
SAN DIEGO,Nov 2013,DCH,2014,CHICANO FEDERATION OF SAN DIEGO COUNTY INC,DCH_SNACK_NT,19,0,0,0,0,0,0,0,0,0
SAN DIEGO,Nov 2013,DCH,2014,CHICANO FEDERATION OF SAN DIEGO COUNTY INC,DCH_SNACK_PM,28,0,0,0,0,65510,0,0,65510,2339.6429
SAN DIEGO,Nov 2013,DCH,2014,CHICANO FEDERATION OF SAN DIEGO COUNTY INC,DCH_SNACK_PM,,0,0,0,0,0,774,1252,2026,0
SAN DIEGO,Nov 2013,DCH,2014,CHICANO FEDERATION OF SAN DIEGO COUNTY INC,DCH_SNACK_PM,19,0,0,0,0,0,0,0,0,0
SAN DIEGO,Nov 2013,DCH,2014,CHICANO FEDERATION OF SAN DIEGO COUNTY INC,DCH_SNACK_PM,19,0,0,0,0,0,0,0,0,0
SAN DIEGO,Nov 2013,DCH,2014,CHICANO FEDERATION OF SAN DIEGO COUNTY INC,DCH_SNACK_PM,19,0,0,0,0,0,0,0,0,0
SAN DIEGO,Nov 2013,DCH,2014,CHICANO FEDERATION OF SAN DIEGO COUNTY INC,DCH_SUPPER,28,0,0,0,0,79586,0,0,79586,2842.3571
SAN DIEGO,Nov 2013,DCH,2014,CHICANO FEDERATION OF SAN DIEGO COUNTY INC,DCH_SUPPER,,0,0,0,0,0,966,1085,2051,0
SAN DIEGO,Nov 2013,DCH,2014,CHICANO FEDERATION OF SAN DIEGO COUNTY INC,DCH_SUPPER,19,0,0,0,0,0,0,0,0,0
SAN DIEGO,Nov 2013,DCH,2014,CHICANO FEDERATION OF SAN DIEGO COUNTY INC,DCH_SUPPER,19,0,0,0,0,0,0,0,0,0
SAN DIEGO,Nov 2013,DCH,2014,CHICANO FEDERATION OF SAN DIEGO COUNTY INC,DCH_SUPPER,19,0,0,0,0,0,0,0,0,0
SAN DIEGO,Dec 2013,DCH,2014,CHICANO FEDERATION OF SAN DIEGO COUNTY INC,DCH_BREAKFAST,30,0,0,0,0,50217,0,0,50217,1673.9
SAN DIEGO,Dec 2013,DCH,2014,CHICANO FEDERATION OF SAN DIEGO COUNTY INC,DCH_BREAKFAST,,0,0,0,0,0,675,900,1575,0
SAN DIEGO,Dec 2013,DCH,2014,CHICANO FEDERATION OF SAN DIEGO COUNTY INC,DCH_BREAKFAST,21,0,0,0,0,0,0,0,0,0
SAN DIEGO,Dec 2013,DCH,2014,CHICANO FEDERATION OF SAN DIEGO COUNTY INC,DCH_BREAKFAST,21,0,0,0,0,0,0,0,0,0
SAN DIEGO,Dec 2013,DCH,2014,CHICANO FEDERATION OF SAN DIEGO COUNTY INC,DCH_BREAKFAST,21,0,0,0,0,0,0,0,0,0
SAN DIEGO,Dec 2013,DCH,2014,CHICANO FEDERATION OF SAN DIEGO COUNTY INC,DCH_LUNCH,30,0,0,0,0,76509,0,0,76509,2550.3
SAN DIEGO,Dec 2013,DCH,2014,CHICANO FEDERATION OF SAN DIEGO COUNTY INC,DCH_LUNCH,,0,0,0,0,0,950,1938,2888,0
SAN DIEGO,Dec 2013,DCH,2014,CHICANO FEDERATION OF SAN DIEGO COUNTY INC,DCH_LUNCH,21,0,0,0,0,0,0,0,0,0
SAN DIEGO,Dec 2013,DCH,2014,CHICANO FEDERATION OF SAN DIEGO COUNTY INC,DCH_LUNCH,21,0,0,0,0,0,0,0,0,0
SAN DIEGO,Dec 2013,DCH,2014,CHICANO FEDERATION OF SAN DIEGO COUNTY INC,DCH_LUNCH,21,0,0,0,0,0,0,0,0,0
SAN DIEGO,Dec 2013,DCH,2014,CHICANO FEDERATION OF SAN DIEGO COUNTY INC,DCH_SNACK_AM,30,0,0,0,0,33483,0,0,33483,1116.1
SAN DIEGO,Dec 2013,DCH,2014,CHICANO FEDERATION OF SAN DIEGO COUNTY INC,DCH_SNACK_AM,,0,0,0,0,0,477,741,1218,0
SAN DIEGO,Dec 2013,DCH,2014,CHICANO FEDERATION OF SAN DIEGO COUNTY INC,DCH_SNACK_AM,21,0,0,0,0,0,0,0,0,0
SAN DIEGO,Dec 2013,DCH,2014,CHICANO FEDERATION OF SAN DIEGO COUNTY INC,DCH_SNACK_AM,21,0,0,0,0,0,0,0,0,0
SAN DIEGO,Dec 2013,DCH,2014,CHICANO FEDERATION OF SAN DIEGO COUNTY INC,DCH_SNACK_AM,21,0,0,0,0,0,0,0,0,0
SAN DIEGO,Dec 2013,DCH,2014,CHICANO FEDERATION OF SAN DIEGO COUNTY INC,DCH_SNACK_NT,30,0,0,0,0,9378,0,0,9378,312.6
SAN DIEGO,Dec 2013,DCH,2014,CHICANO FEDERATION OF SAN DIEGO COUNTY INC,DCH_SNACK_NT,21,0,0,0,0,0,0,0,0,0
SAN DIEGO,Dec 2013,DCH,2014,CHICANO FEDERATION OF SAN DIEGO COUNTY INC,DCH_SNACK_NT,21,0,0,0,0,0,0,0,0,0
SAN DIEGO,Dec 2013,DCH,2014,CHICANO FEDERATION OF SAN DIEGO COUNTY INC,DCH_SNACK_NT,21,0,0,0,0,0,0,0,0,0
SAN DIEGO,Dec 2013,DCH,2014,CHICANO FEDERATION OF SAN DIEGO COUNTY INC,DCH_SNACK_PM,30,0,0,0,0,69747,0,0,69747,2324.9
SAN DIEGO,Dec 2013,DCH,2014,CHICANO FEDERATION OF SAN DIEGO COUNTY INC,DCH_SNACK_PM,,0,0,0,0,0,778,1362,2140,0
SAN DIEGO,Dec 2013,DCH,2014,CHICANO FEDERATION OF SAN DIEGO COUNTY INC,DCH_SNACK_PM,21,0,0,0,0,0,0,0,0,0
SAN DIEGO,Dec 2013,DCH,2014,CHICANO FEDERATION OF SAN DIEGO COUNTY INC,DCH_SNACK_PM,21,0,0,0,0,0,0,0,0,0
SAN DIEGO,Dec 2013,DCH,2014,CHICANO FEDERATION OF SAN DIEGO COUNTY INC,DCH_SNACK_PM,21,0,0,0,0,0,0,0,0,0
SAN DIEGO,Dec 2013,DCH,2014,CHICANO FEDERATION OF SAN DIEGO COUNTY INC,DCH_SUPPER,30,0,0,0,0,85315,0,0,85315,2843.8333
SAN DIEGO,Dec 2013,DCH,2014,CHICANO FEDERATION OF SAN DIEGO COUNTY INC,DCH_SUPPER,,0,0,0,0,0,1033,1187,2220,0
SAN DIEGO,Dec 2013,DCH,2014,CHICANO FEDERATION OF SAN DIEGO COUNTY INC,DCH_SUPPER,21,0,0,0,0,0,0,0,0,0
SAN DIEGO,Dec 2013,DCH,2014,CHICANO FEDERATION OF SAN DIEGO COUNTY INC,DCH_SUPPER,21,0,0,0,0,0,0,0,0,0
SAN DIEGO,Dec 2013,DCH,2014,CHICANO FEDERATION OF SAN DIEGO COUNTY INC,DCH_SUPPER,21,0,0,0,0,0,0,0,0,0
SAN DIEGO,Jan 2014,DCH,2014,CHICANO FEDERATION OF SAN DIEGO COUNTY INC,DCH_BREAKFAST,29,0,0,0,0,52241,0,0,52241,1801.4138
SAN DIEGO,Jan 2014,DCH,2014,CHICANO FEDERATION OF SAN DIEGO COUNTY INC,DCH_BREAKFAST,,0,0,0,0,0,673,1238,1911,0
SAN DIEGO,Jan 2014,DCH,2014,CHICANO FEDERATION OF SAN DIEGO COUNTY INC,DCH_BREAKFAST,21,0,0,0,0,0,0,0,0,0
SAN DIEGO,Jan 2014,DCH,2014,CHICANO FEDERATION OF SAN DIEGO COUNTY INC,DCH_BREAKFAST,21,0,0,0,0,0,0,0,0,0
SAN DIEGO,Jan 2014,DCH,2014,CHICANO FEDERATION OF SAN DIEGO COUNTY INC,DCH_BREAKFAST,21,0,0,0,0,0,0,0,0,0
SAN DIEGO,Jan 2014,DCH,2014,CHICANO FEDERATION OF SAN DIEGO COUNTY INC,DCH_LUNCH,29,0,0,0,0,83157,0,0,83157,2867.4828
SAN DIEGO,Jan 2014,DCH,2014,CHICANO FEDERATION OF SAN DIEGO COUNTY INC,DCH_LUNCH,,0,0,0,0,0,985,2283,3268,0
SAN DIEGO,Jan 2014,DCH,2014,CHICANO FEDERATION OF SAN DIEGO COUNTY INC,DCH_LUNCH,21,0,0,0,0,0,0,0,0,0
SAN DIEGO,Jan 2014,DCH,2014,CHICANO FEDERATION OF SAN DIEGO COUNTY INC,DCH_LUNCH,21,0,0,0,0,0,0,0,0,0
SAN DIEGO,Jan 2014,DCH,2014,CHICANO FEDERATION OF SAN DIEGO COUNTY INC,DCH_LUNCH,21,0,0,0,0,0,0,0,0,0
SAN DIEGO,Jan 2014,DCH,2014,CHICANO FEDERATION OF SAN DIEGO COUNTY INC,DCH_SNACK_AM,29,0,0,0,0,36484,0,0,36484,1258.069
SAN DIEGO,Jan 2014,DCH,2014,CHICANO FEDERATION OF SAN DIEGO COUNTY INC,DCH_SNACK_AM,,0,0,0,0,0,492,1017,1509,0
SAN DIEGO,Jan 2014,DCH,2014,CHICANO FEDERATION OF SAN DIEGO COUNTY INC,DCH_SNACK_AM,21,0,0,0,0,0,0,0,0,0
SAN DIEGO,Jan 2014,DCH,2014,CHICANO FEDERATION OF SAN DIEGO COUNTY INC,DCH_SNACK_AM,21,0,0,0,0,0,0,0,0,0
SAN DIEGO,Jan 2014,DCH,2014,CHICANO FEDERATION OF SAN DIEGO COUNTY INC,DCH_SNACK_AM,21,0,0,0,0,0,0,0,0,0
SAN DIEGO,Jan 2014,DCH,2014,CHICANO FEDERATION OF SAN DIEGO COUNTY INC,DCH_SNACK_NT,29,0,0,0,0,9560,0,0,9560,329.6552
SAN DIEGO,Jan 2014,DCH,2014,CHICANO FEDERATION OF SAN DIEGO COUNTY INC,DCH_SNACK_NT,,0,0,0,0,0,0,21,21,0
SAN DIEGO,Jan 2014,DCH,2014,CHICANO FEDERATION OF SAN DIEGO COUNTY INC,DCH_SNACK_NT,21,0,0,0,0,0,0,0,0,0
SAN DIEGO,Jan 2014,DCH,2014,CHICANO FEDERATION OF SAN DIEGO COUNTY INC,DCH_SNACK_NT,21,0,0,0,0,0,0,0,0,0
SAN DIEGO,Jan 2014,DCH,2014,CHICANO FEDERATION OF SAN DIEGO COUNTY INC,DCH_SNACK_NT,21,0,0,0,0,0,0,0,0,0
SAN DIEGO,Jan 2014,DCH,2014,CHICANO FEDERATION OF SAN DIEGO COUNTY INC,DCH_SNACK_PM,29,0,0,0,0,74922,0,0,74922,2583.5172
SAN DIEGO,Jan 2014,DCH,2014,CHICANO FEDERATION OF SAN DIEGO COUNTY INC,DCH_SNACK_PM,,0,0,0,0,0,769,1442,2211,0
SAN DIEGO,Jan 2014,DCH,2014,CHICANO FEDERATION OF SAN DIEGO COUNTY INC,DCH_SNACK_PM,21,0,0,0,0,0,0,0,0,0
SAN DIEGO,Jan 2014,DCH,2014,CHICANO FEDERATION OF SAN DIEGO COUNTY INC,DCH_SNACK_PM,21,0,0,0,0,0,0,0,0,0
SAN DIEGO,Jan 2014,DCH,2014,CHICANO FEDERATION OF SAN DIEGO COUNTY INC,DCH_SNACK_PM,21,0,0,0,0,0,0,0,0,0
SAN DIEGO,Jan 2014,DCH,2014,CHICANO FEDERATION OF SAN DIEGO COUNTY INC,DCH_SUPPER,29,0,0,0,0,89748,0,0,89748,3094.7586
SAN DIEGO,Jan 2014,DCH,2014,CHICANO FEDERATION OF SAN DIEGO COUNTY INC,DCH_SUPPER,,0,0,0,0,0,989,1172,2161,0
SAN DIEGO,Jan 2014,DCH,2014,CHICANO FEDERATION OF SAN DIEGO COUNTY INC,DCH_SUPPER,21,0,0,0,0,0,0,0,0,0
SAN DIEGO,Jan 2014,DCH,2014,CHICANO FEDERATION OF SAN DIEGO COUNTY INC,DCH_SUPPER,21,0,0,0,0,0,0,0,0,0
SAN DIEGO,Jan 2014,DCH,2014,CHICANO FEDERATION OF SAN DIEGO COUNTY INC,DCH_SUPPER,21,0,0,0,0,0,0,0,0,0
SAN DIEGO,Feb 2014,DCH,2014,CHICANO FEDERATION OF SAN DIEGO COUNTY INC,DCH_BREAKFAST,27,0,0,0,0,53493,0,0,53493,1981.2222
SAN DIEGO,Feb 2014,DCH,2014,CHICANO FEDERATION OF SAN DIEGO COUNTY INC,DCH_BREAKFAST,,0,0,0,0,0,722,1254,1976,0
SAN DIEGO,Feb 2014,DCH,2014,CHICANO FEDERATION OF SAN DIEGO COUNTY INC,DCH_BREAKFAST,19,0,0,0,0,0,0,0,0,0
SAN DIEGO,Feb 2014,DCH,2014,CHICANO FEDERATION OF SAN DIEGO COUNTY INC,DCH_BREAKFAST,19,0,0,0,0,0,0,0,0,0
SAN DIEGO,Feb 2014,DCH,2014,CHICANO FEDERATION OF SAN DIEGO COUNTY INC,DCH_BREAKFAST,19,0,0,0,0,0,0,0,0,0
SAN DIEGO,Feb 2014,DCH,2014,CHICANO FEDERATION OF SAN DIEGO COUNTY INC,DCH_LUNCH,27,0,0,0,0,69137,0,0,69137,2560.6296
SAN DIEGO,Feb 2014,DCH,2014,CHICANO FEDERATION OF SAN DIEGO COUNTY INC,DCH_LUNCH,,0,0,0,0,0,755,2463,3218,0
SAN DIEGO,Feb 2014,DCH,2014,CHICANO FEDERATION OF SAN DIEGO COUNTY INC,DCH_LUNCH,19,0,0,0,0,0,0,0,0,0
SAN DIEGO,Feb 2014,DCH,2014,CHICANO FEDERATION OF SAN DIEGO COUNTY INC,DCH_LUNCH,19,0,0,0,0,0,0,0,0,0
SAN DIEGO,Feb 2014,DCH,2014,CHICANO FEDERATION OF SAN DIEGO COUNTY INC,DCH_LUNCH,19,0,0,0,0,0,0,0,0,0
SAN DIEGO,Feb 2014,DCH,2014,CHICANO FEDERATION OF SAN DIEGO COUNTY INC,DCH_SNACK_AM,27,0,0,0,0,32029,0,0,32029,1186.2593
SAN DIEGO,Feb 2014,DCH,2014,CHICANO FEDERATION OF SAN DIEGO COUNTY INC,DCH_SNACK_AM,,0,0,0,0,0,454,1272,1726,0
SAN DIEGO,Feb 2014,DCH,2014,CHICANO FEDERATION OF SAN DIEGO COUNTY INC,DCH_SNACK_AM,19,0,0,0,0,0,0,0,0,0
SAN DIEGO,Feb 2014,DCH,2014,CHICANO FEDERATION OF SAN DIEGO COUNTY INC,DCH_SNACK_AM,19,0,0,0,0,0,0,0,0,0
SAN DIEGO,Feb 2014,DCH,2014,CHICANO FEDERATION OF SAN DIEGO COUNTY INC,DCH_SNACK_AM,19,0,0,0,0,0,0,0,0,0
SAN DIEGO,Feb 2014,DCH,2014,CHICANO FEDERATION OF SAN DIEGO COUNTY INC,DCH_SNACK_NT,27,0,0,0,0,10208,0,0,10208,378.0741
SAN DIEGO,Feb 2014,DCH,2014,CHICANO FEDERATION OF SAN DIEGO COUNTY INC,DCH_SNACK_NT,,0,0,0,0,0,0,28,28,0
SAN DIEGO,Feb 2014,DCH,2014,CHICANO FEDERATION OF SAN DIEGO COUNTY INC,DCH_SNACK_NT,19,0,0,0,0,0,0,0,0,0
SAN DIEGO,Feb 2014,DCH,2014,CHICANO FEDERATION OF SAN DIEGO COUNTY INC,DCH_SNACK_NT,19,0,0,0,0,0,0,0,0,0
SAN DIEGO,Feb 2014,DCH,2014,CHICANO FEDERATION OF SAN DIEGO COUNTY INC,DCH_SNACK_NT,19,0,0,0,0,0,0,0,0,0
SAN DIEGO,Feb 2014,DCH,2014,CHICANO FEDERATION OF SAN DIEGO COUNTY INC,DCH_SNACK_PM,27,0,0,0,0,67621,0,0,67621,2504.4815
SAN DIEGO,Feb 2014,DCH,2014,CHICANO FEDERATION OF SAN DIEGO COUNTY INC,DCH_SNACK_PM,,0,0,0,0,0,629,1278,1907,0
SAN DIEGO,Feb 2014,DCH,2014,CHICANO FEDERATION OF SAN DIEGO COUNTY INC,DCH_SNACK_PM,19,0,0,0,0,0,0,0,0,0
SAN DIEGO,Feb 2014,DCH,2014,CHICANO FEDERATION OF SAN DIEGO COUNTY INC,DCH_SNACK_PM,19,0,0,0,0,0,0,0,0,0
SAN DIEGO,Feb 2014,DCH,2014,CHICANO FEDERATION OF SAN DIEGO COUNTY INC,DCH_SNACK_PM,19,0,0,0,0,0,0,0,0,0
SAN DIEGO,Feb 2014,DCH,2014,CHICANO FEDERATION OF SAN DIEGO COUNTY INC,DCH_SUPPER,27,0,0,0,0,83436,0,0,83436,3090.2222
SAN DIEGO,Feb 2014,DCH,2014,CHICANO FEDERATION OF SAN DIEGO COUNTY INC,DCH_SUPPER,,0,0,0,0,0,897,1179,2076,0
SAN DIEGO,Feb 2014,DCH,2014,CHICANO FEDERATION OF SAN DIEGO COUNTY INC,DCH_SUPPER,19,0,0,0,0,0,0,0,0,0
SAN DIEGO,Feb 2014,DCH,2014,CHICANO FEDERATION OF SAN DIEGO COUNTY INC,DCH_SUPPER,19,0,0,0,0,0,0,0,0,0
SAN DIEGO,Feb 2014,DCH,2014,CHICANO FEDERATION OF SAN DIEGO COUNTY INC,DCH_SUPPER,19,0,0,0,0,0,0,0,0,0
SAN DIEGO,Mar 2014,DCH,2014,CHICANO FEDERATION OF SAN DIEGO COUNTY INC,DCH_BREAKFAST,31,0,0,0,0,56195,0,0,56195,1812.7419
SAN DIEGO,Mar 2014,DCH,2014,CHICANO FEDERATION OF SAN DIEGO COUNTY INC,DCH_BREAKFAST,,0,0,0,0,0,720,1226,1946,0
SAN DIEGO,Mar 2014,DCH,2014,CHICANO FEDERATION OF SAN DIEGO COUNTY INC,DCH_BREAKFAST,21,0,0,0,0,0,0,0,0,0
SAN DIEGO,Mar 2014,DCH,2014,CHICANO FEDERATION OF SAN DIEGO COUNTY INC,DCH_BREAKFAST,21,0,0,0,0,0,0,0,0,0
SAN DIEGO,Mar 2014,DCH,2014,CHICANO FEDERATION OF SAN DIEGO COUNTY INC,DCH_BREAKFAST,21,0,0,0,0,0,0,0,0,0
SAN DIEGO,Mar 2014,DCH,2014,CHICANO FEDERATION OF SAN DIEGO COUNTY INC,DCH_LUNCH,31,0,0,0,0,82547,0,0,82547,2662.8065
SAN DIEGO,Mar 2014,DCH,2014,CHICANO FEDERATION OF SAN DIEGO COUNTY INC,DCH_LUNCH,,0,0,0,0,0,1040,2615,3655,0
SAN DIEGO,Mar 2014,DCH,2014,CHICANO FEDERATION OF SAN DIEGO COUNTY INC,DCH_LUNCH,21,0,0,0,0,0,0,0,0,0
SAN DIEGO,Mar 2014,DCH,2014,CHICANO FEDERATION OF SAN DIEGO COUNTY INC,DCH_LUNCH,21,0,0,0,0,0,0,0,0,0
SAN DIEGO,Mar 2014,DCH,2014,CHICANO FEDERATION OF SAN DIEGO COUNTY INC,DCH_LUNCH,21,0,0,0,0,0,0,0,0,0
SAN DIEGO,Mar 2014,DCH,2014,CHICANO FEDERATION OF SAN DIEGO COUNTY INC,DCH_SNACK_AM,31,0,0,0,0,36672,0,0,36672,1182.9677
SAN DIEGO,Mar 2014,DCH,2014,CHICANO FEDERATION OF SAN DIEGO COUNTY INC,DCH_SNACK_AM,,0,0,0,0,0,608,1379,1987,0
SAN DIEGO,Mar 2014,DCH,2014,CHICANO FEDERATION OF SAN DIEGO COUNTY INC,DCH_SNACK_AM,21,0,0,0,0,0,0,0,0,0
SAN DIEGO,Mar 2014,DCH,2014,CHICANO FEDERATION OF SAN DIEGO COUNTY INC,DCH_SNACK_AM,21,0,0,0,0,0,0,0,0,0
SAN DIEGO,Mar 2014,DCH,2014,CHICANO FEDERATION OF SAN DIEGO COUNTY INC,DCH_SNACK_AM,21,0,0,0,0,0,0,0,0,0
SAN DIEGO,Mar 2014,DCH,2014,CHICANO FEDERATION OF SAN DIEGO COUNTY INC,DCH_SNACK_NT,31,0,0,0,0,10491,0,0,10491,338.4194
SAN DIEGO,Mar 2014,DCH,2014,CHICANO FEDERATION OF SAN DIEGO COUNTY INC,DCH_SNACK_NT,,0,0,0,0,0,0,42,42,0
SAN DIEGO,Mar 2014,DCH,2014,CHICANO FEDERATION OF SAN DIEGO COUNTY INC,DCH_SNACK_NT,21,0,0,0,0,0,0,0,0,0
SAN DIEGO,Mar 2014,DCH,2014,CHICANO FEDERATION OF SAN DIEGO COUNTY INC,DCH_SNACK_NT,21,0,0,0,0,0,0,0,0,0
SAN DIEGO,Mar 2014,DCH,2014,CHICANO FEDERATION OF SAN DIEGO COUNTY INC,DCH_SNACK_NT,21,0,0,0,0,0,0,0,0,0
SAN DIEGO,Mar 2014,DCH,2014,CHICANO FEDERATION OF SAN DIEGO COUNTY INC,DCH_SNACK_PM,31,0,0,0,0,77129,0,0,77129,2488.0323
SAN DIEGO,Mar 2014,DCH,2014,CHICANO FEDERATION OF SAN DIEGO COUNTY INC,DCH_SNACK_PM,,0,0,0,0,0,757,1321,2078,0
SAN DIEGO,Mar 2014,DCH,2014,CHICANO FEDERATION OF SAN DIEGO COUNTY INC,DCH_SNACK_PM,21,0,0,0,0,0,0,0,0,0
SAN DIEGO,Mar 2014,DCH,2014,CHICANO FEDERATION OF SAN DIEGO COUNTY INC,DCH_SNACK_PM,21,0,0,0,0,0,0,0,0,0
SAN DIEGO,Mar 2014,DCH,2014,CHICANO FEDERATION OF SAN DIEGO COUNTY INC,DCH_SNACK_PM,21,0,0,0,0,0,0,0,0,0
SAN DIEGO,Mar 2014,DCH,2014,CHICANO FEDERATION OF SAN DIEGO COUNTY INC,DCH_SUPPER,31,0,0,0,0,92683,0,0,92683,2989.7742
SAN DIEGO,Mar 2014,DCH,2014,CHICANO FEDERATION OF SAN DIEGO COUNTY INC,DCH_SUPPER,,0,0,0,0,0,1049,1296,2345,0
SAN DIEGO,Mar 2014,DCH,2014,CHICANO FEDERATION OF SAN DIEGO COUNTY INC,DCH_SUPPER,21,0,0,0,0,0,0,0,0,0
SAN DIEGO,Mar 2014,DCH,2014,CHICANO FEDERATION OF SAN DIEGO COUNTY INC,DCH_SUPPER,21,0,0,0,0,0,0,0,0,0
SAN DIEGO,Mar 2014,DCH,2014,CHICANO FEDERATION OF SAN DIEGO COUNTY INC,DCH_SUPPER,21,0,0,0,0,0,0,0,0,0
SAN DIEGO,Apr 2014,DCH,2014,CHICANO FEDERATION OF SAN DIEGO COUNTY INC,DCH_BREAKFAST,30,0,0,0,0,56989,0,0,56989,1899.6333
SAN DIEGO,Apr 2014,DCH,2014,CHICANO FEDERATION OF SAN DIEGO COUNTY INC,DCH_BREAKFAST,,0,0,0,0,0,796,1379,2175,0
SAN DIEGO,Apr 2014,DCH,2014,CHICANO FEDERATION OF SAN DIEGO COUNTY INC,DCH_BREAKFAST,22,0,0,0,0,0,0,0,0,0
SAN DIEGO,Apr 2014,DCH,2014,CHICANO FEDERATION OF SAN DIEGO COUNTY INC,DCH_BREAKFAST,22,0,0,0,0,0,0,0,0,0
SAN DIEGO,Apr 2014,DCH,2014,CHICANO FEDERATION OF SAN DIEGO COUNTY INC,DCH_BREAKFAST,22,0,0,0,0,0,0,0,0,0
SAN DIEGO,Apr 2014,DCH,2014,CHICANO FEDERATION OF SAN DIEGO COUNTY INC,DCH_LUNCH,30,0,0,0,0,92974,0,0,92974,3099.1333
SAN DIEGO,Apr 2014,DCH,2014,CHICANO FEDERATION OF SAN DIEGO COUNTY INC,DCH_LUNCH,,0,0,0,0,0,1042,2881,3923,0
SAN DIEGO,Apr 2014,DCH,2014,CHICANO FEDERATION OF SAN DIEGO COUNTY INC,DCH_LUNCH,22,0,0,0,0,0,0,0,0,0
SAN DIEGO,Apr 2014,DCH,2014,CHICANO FEDERATION OF SAN DIEGO COUNTY INC,DCH_LUNCH,22,0,0,0,0,0,0,0,0,0
SAN DIEGO,Apr 2014,DCH,2014,CHICANO FEDERATION OF SAN DIEGO COUNTY INC,DCH_LUNCH,22,0,0,0,0,0,0,0,0,0
SAN DIEGO,Apr 2014,DCH,2014,CHICANO FEDERATION OF SAN DIEGO COUNTY INC,DCH_SNACK_AM,30,0,0,0,0,41041,0,0,41041,1368.0333
SAN DIEGO,Apr 2014,DCH,2014,CHICANO FEDERATION OF SAN DIEGO COUNTY INC,DCH_SNACK_AM,,0,0,0,0,0,616,1506,2122,0
SAN DIEGO,Apr 2014,DCH,2014,CHICANO FEDERATION OF SAN DIEGO COUNTY INC,DCH_SNACK_AM,22,0,0,0,0,0,0,0,0,0
SAN DIEGO,Apr 2014,DCH,2014,CHICANO FEDERATION OF SAN DIEGO COUNTY INC,DCH_SNACK_AM,22,0,0,0,0,0,0,0,0,0
SAN DIEGO,Apr 2014,DCH,2014,CHICANO FEDERATION OF SAN DIEGO COUNTY INC,DCH_SNACK_AM,22,0,0,0,0,0,0,0,0,0
SAN DIEGO,Apr 2014,DCH,2014,CHICANO FEDERATION OF SAN DIEGO COUNTY INC,DCH_SNACK_NT,30,0,0,0,0,10108,0,0,10108,336.9333
SAN DIEGO,Apr 2014,DCH,2014,CHICANO FEDERATION OF SAN DIEGO COUNTY INC,DCH_SNACK_NT,,0,0,0,0,0,0,44,44,0
SAN DIEGO,Apr 2014,DCH,2014,CHICANO FEDERATION OF SAN DIEGO COUNTY INC,DCH_SNACK_NT,22,0,0,0,0,0,0,0,0,0
SAN DIEGO,Apr 2014,DCH,2014,CHICANO FEDERATION OF SAN DIEGO COUNTY INC,DCH_SNACK_NT,22,0,0,0,0,0,0,0,0,0
SAN DIEGO,Apr 2014,DCH,2014,CHICANO FEDERATION OF SAN DIEGO COUNTY INC,DCH_SNACK_NT,22,0,0,0,0,0,0,0,0,0
SAN DIEGO,Apr 2014,DCH,2014,CHICANO FEDERATION OF SAN DIEGO COUNTY INC,DCH_SNACK_PM,30,0,0,0,0,81139,0,0,81139,2704.6333
SAN DIEGO,Apr 2014,DCH,2014,CHICANO FEDERATION OF SAN DIEGO COUNTY INC,DCH_SNACK_PM,,0,0,0,0,0,762,1427,2189,0
SAN DIEGO,Apr 2014,DCH,2014,CHICANO FEDERATION OF SAN DIEGO COUNTY INC,DCH_SNACK_PM,22,0,0,0,0,0,0,0,0,0
SAN DIEGO,Apr 2014,DCH,2014,CHICANO FEDERATION OF SAN DIEGO COUNTY INC,DCH_SNACK_PM,22,0,0,0,0,0,0,0,0,0
SAN DIEGO,Apr 2014,DCH,2014,CHICANO FEDERATION OF SAN DIEGO COUNTY INC,DCH_SNACK_PM,22,0,0,0,0,0,0,0,0,0
SAN DIEGO,Apr 2014,DCH,2014,CHICANO FEDERATION OF SAN DIEGO COUNTY INC,DCH_SUPPER,30,0,0,0,0,96254,0,0,96254,3208.4667
SAN DIEGO,Apr 2014,DCH,2014,CHICANO FEDERATION OF SAN DIEGO COUNTY INC,DCH_SUPPER,,0,0,0,0,0,1077,1483,2560,0
SAN DIEGO,Apr 2014,DCH,2014,CHICANO FEDERATION OF SAN DIEGO COUNTY INC,DCH_SUPPER,22,0,0,0,0,0,0,0,0,0
SAN DIEGO,Apr 2014,DCH,2014,CHICANO FEDERATION OF SAN DIEGO COUNTY INC,DCH_SUPPER,22,0,0,0,0,0,0,0,0,0
SAN DIEGO,Apr 2014,DCH,2014,CHICANO FEDERATION OF SAN DIEGO COUNTY INC,DCH_SUPPER,22,0,0,0,0,0,0,0,0,0
SAN DIEGO,May 2014,DCH,2014,CHICANO FEDERATION OF SAN DIEGO COUNTY INC,DCH_BREAKFAST,30,0,0,0,0,62152,0,0,62152,2071.7333
SAN DIEGO,May 2014,DCH,2014,CHICANO FEDERATION OF SAN DIEGO COUNTY INC,DCH_BREAKFAST,,0,0,0,0,0,752,1332,2084,0
SAN DIEGO,May 2014,DCH,2014,CHICANO FEDERATION OF SAN DIEGO COUNTY INC,DCH_BREAKFAST,21,0,0,0,0,0,0,0,0,0
SAN DIEGO,May 2014,DCH,2014,CHICANO FEDERATION OF SAN DIEGO COUNTY INC,DCH_BREAKFAST,21,0,0,0,0,0,0,0,0,0
SAN DIEGO,May 2014,DCH,2014,CHICANO FEDERATION OF SAN DIEGO COUNTY INC,DCH_BREAKFAST,21,0,0,0,0,0,0,0,0,0
SAN DIEGO,May 2014,DCH,2014,CHICANO FEDERATION OF SAN DIEGO COUNTY INC,DCH_LUNCH,30,0,0,0,0,80647,0,0,80647,2688.2333
SAN DIEGO,May 2014,DCH,2014,CHICANO FEDERATION OF SAN DIEGO COUNTY INC,DCH_LUNCH,,0,0,0,0,0,881,2675,3556,0
SAN DIEGO,May 2014,DCH,2014,CHICANO FEDERATION OF SAN DIEGO COUNTY INC,DCH_LUNCH,21,0,0,0,0,0,0,0,0,0
SAN DIEGO,May 2014,DCH,2014,CHICANO FEDERATION OF SAN DIEGO COUNTY INC,DCH_LUNCH,21,0,0,0,0,0,0,0,0,0
SAN DIEGO,May 2014,DCH,2014,CHICANO FEDERATION OF SAN DIEGO COUNTY INC,DCH_LUNCH,21,0,0,0,0,0,0,0,0,0
SAN DIEGO,May 2014,DCH,2014,CHICANO FEDERATION OF SAN DIEGO COUNTY INC,DCH_SNACK_AM,30,0,0,0,0,37247,0,0,37247,1241.5667
SAN DIEGO,May 2014,DCH,2014,CHICANO FEDERATION OF SAN DIEGO COUNTY INC,DCH_SNACK_AM,,0,0,0,0,0,470,1330,1800,0
SAN DIEGO,May 2014,DCH,2014,CHICANO FEDERATION OF SAN DIEGO COUNTY INC,DCH_SNACK_AM,21,0,0,0,0,0,0,0,0,0
SAN DIEGO,May 2014,DCH,2014,CHICANO FEDERATION OF SAN DIEGO COUNTY INC,DCH_SNACK_AM,21,0,0,0,0,0,0,0,0,0
SAN DIEGO,May 2014,DCH,2014,CHICANO FEDERATION OF SAN DIEGO COUNTY INC,DCH_SNACK_AM,21,0,0,0,0,0,0,0,0,0
SAN DIEGO,May 2014,DCH,2014,CHICANO FEDERATION OF SAN DIEGO COUNTY INC,DCH_SNACK_NT,30,0,0,0,0,11302,0,0,11302,376.7333
SAN DIEGO,May 2014,DCH,2014,CHICANO FEDERATION OF SAN DIEGO COUNTY INC,DCH_SNACK_NT,,0,0,0,0,0,0,40,40,0
SAN DIEGO,May 2014,DCH,2014,CHICANO FEDERATION OF SAN DIEGO COUNTY INC,DCH_SNACK_NT,21,0,0,0,0,0,0,0,0,0
SAN DIEGO,May 2014,DCH,2014,CHICANO FEDERATION OF SAN DIEGO COUNTY INC,DCH_SNACK_NT,21,0,0,0,0,0,0,0,0,0
SAN DIEGO,May 2014,DCH,2014,CHICANO FEDERATION OF SAN DIEGO COUNTY INC,DCH_SNACK_NT,21,0,0,0,0,0,0,0,0,0
SAN DIEGO,May 2014,DCH,2014,CHICANO FEDERATION OF SAN DIEGO COUNTY INC,DCH_SNACK_PM,30,0,0,0,0,77057,0,0,77057,2568.5667
SAN DIEGO,May 2014,DCH,2014,CHICANO FEDERATION OF SAN DIEGO COUNTY INC,DCH_SNACK_PM,,0,0,0,0,0,742,1484,2226,0
SAN DIEGO,May 2014,DCH,2014,CHICANO FEDERATION OF SAN DIEGO COUNTY INC,DCH_SNACK_PM,21,0,0,0,0,0,0,0,0,0
SAN DIEGO,May 2014,DCH,2014,CHICANO FEDERATION OF SAN DIEGO COUNTY INC,DCH_SNACK_PM,21,0,0,0,0,0,0,0,0,0
SAN DIEGO,May 2014,DCH,2014,CHICANO FEDERATION OF SAN DIEGO COUNTY INC,DCH_SNACK_PM,21,0,0,0,0,0,0,0,0,0
SAN DIEGO,May 2014,DCH,2014,CHICANO FEDERATION OF SAN DIEGO COUNTY INC,DCH_SUPPER,30,0,0,0,0,92973,0,0,92973,3099.1
SAN DIEGO,May 2014,DCH,2014,CHICANO FEDERATION OF SAN DIEGO COUNTY INC,DCH_SUPPER,,0,0,0,0,0,1034,1475,2509,0
SAN DIEGO,May 2014,DCH,2014,CHICANO FEDERATION OF SAN DIEGO COUNTY INC,DCH_SUPPER,21,0,0,0,0,0,0,0,0,0
SAN DIEGO,May 2014,DCH,2014,CHICANO FEDERATION OF SAN DIEGO COUNTY INC,DCH_SUPPER,21,0,0,0,0,0,0,0,0,0
SAN DIEGO,May 2014,DCH,2014,CHICANO FEDERATION OF SAN DIEGO COUNTY INC,DCH_SUPPER,21,0,0,0,0,0,0,0,0,0
SAN DIEGO,Jun 2014,DCH,2014,CHICANO FEDERATION OF SAN DIEGO COUNTY INC,DCH_BREAKFAST,30,0,0,0,0,48441,0,0,48441,1614.7
SAN DIEGO,Jun 2014,DCH,2014,CHICANO FEDERATION OF SAN DIEGO COUNTY INC,DCH_BREAKFAST,,0,0,0,0,0,429,1176,1605,0
SAN DIEGO,Jun 2014,DCH,2014,CHICANO FEDERATION OF SAN DIEGO COUNTY INC,DCH_BREAKFAST,21,0,0,0,0,0,0,0,0,0
SAN DIEGO,Jun 2014,DCH,2014,CHICANO FEDERATION OF SAN DIEGO COUNTY INC,DCH_BREAKFAST,21,0,0,0,0,0,0,0,0,0
SAN DIEGO,Jun 2014,DCH,2014,CHICANO FEDERATION OF SAN DIEGO COUNTY INC,DCH_BREAKFAST,21,0,0,0,0,0,0,0,0,0
SAN DIEGO,Jun 2014,DCH,2014,CHICANO FEDERATION OF SAN DIEGO COUNTY INC,DCH_LUNCH,30,0,0,0,0,96528,0,0,96528,3217.6
SAN DIEGO,Jun 2014,DCH,2014,CHICANO FEDERATION OF SAN DIEGO COUNTY INC,DCH_LUNCH,,0,0,0,0,0,1214,2605,3819,0
SAN DIEGO,Jun 2014,DCH,2014,CHICANO FEDERATION OF SAN DIEGO COUNTY INC,DCH_LUNCH,21,0,0,0,0,0,0,0,0,0
SAN DIEGO,Jun 2014,DCH,2014,CHICANO FEDERATION OF SAN DIEGO COUNTY INC,DCH_LUNCH,21,0,0,0,0,0,0,0,0,0
SAN DIEGO,Jun 2014,DCH,2014,CHICANO FEDERATION OF SAN DIEGO COUNTY INC,DCH_LUNCH,21,0,0,0,0,0,0,0,0,0
SAN DIEGO,Jun 2014,DCH,2014,CHICANO FEDERATION OF SAN DIEGO COUNTY INC,DCH_SNACK_AM,30,0,0,0,0,40605,0,0,40605,1353.5
SAN DIEGO,Jun 2014,DCH,2014,CHICANO FEDERATION OF SAN DIEGO COUNTY INC,DCH_SNACK_AM,,0,0,0,0,0,645,1268,1913,0
SAN DIEGO,Jun 2014,DCH,2014,CHICANO FEDERATION OF SAN DIEGO COUNTY INC,DCH_SNACK_AM,21,0,0,0,0,0,0,0,0,0
SAN DIEGO,Jun 2014,DCH,2014,CHICANO FEDERATION OF SAN DIEGO COUNTY INC,DCH_SNACK_AM,21,0,0,0,0,0,0,0,0,0
SAN DIEGO,Jun 2014,DCH,2014,CHICANO FEDERATION OF SAN DIEGO COUNTY INC,DCH_SNACK_AM,21,0,0,0,0,0,0,0,0,0
SAN DIEGO,Jun 2014,DCH,2014,CHICANO FEDERATION OF SAN DIEGO COUNTY INC,DCH_SNACK_NT,30,0,0,0,0,8112,0,0,8112,270.4
SAN DIEGO,Jun 2014,DCH,2014,CHICANO FEDERATION OF SAN DIEGO COUNTY INC,DCH_SNACK_NT,,0,0,0,0,0,0,42,42,0
SAN DIEGO,Jun 2014,DCH,2014,CHICANO FEDERATION OF SAN DIEGO COUNTY INC,DCH_SNACK_NT,21,0,0,0,0,0,0,0,0,0
SAN DIEGO,Jun 2014,DCH,2014,CHICANO FEDERATION OF SAN DIEGO COUNTY INC,DCH_SNACK_NT,21,0,0,0,0,0,0,0,0,0
SAN DIEGO,Jun 2014,DCH,2014,CHICANO FEDERATION OF SAN DIEGO COUNTY INC,DCH_SNACK_NT,21,0,0,0,0,0,0,0,0,0
SAN DIEGO,Jun 2014,DCH,2014,CHICANO FEDERATION OF SAN DIEGO COUNTY INC,DCH_SNACK_PM,30,0,0,0,0,78092,0,0,78092,2603.0667
SAN DIEGO,Jun 2014,DCH,2014,CHICANO FEDERATION OF SAN DIEGO COUNTY INC,DCH_SNACK_PM,,0,0,0,0,0,747,1403,2150,0
SAN DIEGO,Jun 2014,DCH,2014,CHICANO FEDERATION OF SAN DIEGO COUNTY INC,DCH_SNACK_PM,21,0,0,0,0,0,0,0,0,0
SAN DIEGO,Jun 2014,DCH,2014,CHICANO FEDERATION OF SAN DIEGO COUNTY INC,DCH_SNACK_PM,21,0,0,0,0,0,0,0,0,0
SAN DIEGO,Jun 2014,DCH,2014,CHICANO FEDERATION OF SAN DIEGO COUNTY INC,DCH_SNACK_PM,21,0,0,0,0,0,0,0,0,0
SAN DIEGO,Jun 2014,DCH,2014,CHICANO FEDERATION OF SAN DIEGO COUNTY INC,DCH_SUPPER,30,0,0,0,0,88893,0,0,88893,2963.1
SAN DIEGO,Jun 2014,DCH,2014,CHICANO FEDERATION OF SAN DIEGO COUNTY INC,DCH_SUPPER,,0,0,0,0,0,1037,1376,2413,0
SAN DIEGO,Jun 2014,DCH,2014,CHICANO FEDERATION OF SAN DIEGO COUNTY INC,DCH_SUPPER,21,0,0,0,0,0,0,0,0,0
SAN DIEGO,Jun 2014,DCH,2014,CHICANO FEDERATION OF SAN DIEGO COUNTY INC,DCH_SUPPER,21,0,0,0,0,0,0,0,0,0
SAN DIEGO,Jun 2014,DCH,2014,CHICANO FEDERATION OF SAN DIEGO COUNTY INC,DCH_SUPPER,21,0,0,0,0,0,0,0,0,0
SAN DIEGO,Jul 2014,DCH,2014,CHICANO FEDERATION OF SAN DIEGO COUNTY INC,DCH_BREAKFAST,30,0,0,0,0,44840,0,0,44840,1494.6667
SAN DIEGO,Jul 2014,DCH,2014,CHICANO FEDERATION OF SAN DIEGO COUNTY INC,DCH_BREAKFAST,,0,0,0,0,0,342,1069,1411,0
SAN DIEGO,Jul 2014,DCH,2014,CHICANO FEDERATION OF SAN DIEGO COUNTY INC,DCH_BREAKFAST,22,0,0,0,0,0,0,0,0,0
SAN DIEGO,Jul 2014,DCH,2014,CHICANO FEDERATION OF SAN DIEGO COUNTY INC,DCH_BREAKFAST,24,0,0,0,0,0,0,0,0,0
SAN DIEGO,Jul 2014,DCH,2014,CHICANO FEDERATION OF SAN DIEGO COUNTY INC,DCH_BREAKFAST,22,0,0,0,0,0,0,0,0,0
SAN DIEGO,Jul 2014,DCH,2014,CHICANO FEDERATION OF SAN DIEGO COUNTY INC,DCH_LUNCH,30,0,0,0,0,110676,0,0,110676,3689.2
SAN DIEGO,Jul 2014,DCH,2014,CHICANO FEDERATION OF SAN DIEGO COUNTY INC,DCH_LUNCH,,0,0,0,0,0,786,3031,3817,0
SAN DIEGO,Jul 2014,DCH,2014,CHICANO FEDERATION OF SAN DIEGO COUNTY INC,DCH_LUNCH,22,0,0,0,0,0,0,0,0,0
SAN DIEGO,Jul 2014,DCH,2014,CHICANO FEDERATION OF SAN DIEGO COUNTY INC,DCH_LUNCH,24,0,0,0,0,0,0,0,0,0
SAN DIEGO,Jul 2014,DCH,2014,CHICANO FEDERATION OF SAN DIEGO COUNTY INC,DCH_LUNCH,22,0,0,0,0,0,0,0,0,0
SAN DIEGO,Jul 2014,DCH,2014,CHICANO FEDERATION OF SAN DIEGO COUNTY INC,DCH_SNACK_AM,30,0,0,0,0,45544,0,0,45544,1518.1333
SAN DIEGO,Jul 2014,DCH,2014,CHICANO FEDERATION OF SAN DIEGO COUNTY INC,DCH_SNACK_AM,,0,0,0,0,0,357,1299,1656,0
SAN DIEGO,Jul 2014,DCH,2014,CHICANO FEDERATION OF SAN DIEGO COUNTY INC,DCH_SNACK_AM,22,0,0,0,0,0,0,0,0,0
SAN DIEGO,Jul 2014,DCH,2014,CHICANO FEDERATION OF SAN DIEGO COUNTY INC,DCH_SNACK_AM,24,0,0,0,0,0,0,0,0,0
SAN DIEGO,Jul 2014,DCH,2014,CHICANO FEDERATION OF SAN DIEGO COUNTY INC,DCH_SNACK_AM,22,0,0,0,0,0,0,0,0,0
SAN DIEGO,Jul 2014,DCH,2014,CHICANO FEDERATION OF SAN DIEGO COUNTY INC,DCH_SNACK_NT,30,0,0,0,0,7966,0,0,7966,265.5333
SAN DIEGO,Jul 2014,DCH,2014,CHICANO FEDERATION OF SAN DIEGO COUNTY INC,DCH_SNACK_NT,,0,0,0,0,0,0,44,44,0
SAN DIEGO,Jul 2014,DCH,2014,CHICANO FEDERATION OF SAN DIEGO COUNTY INC,DCH_SNACK_NT,22,0,0,0,0,0,0,0,0,0
SAN DIEGO,Jul 2014,DCH,2014,CHICANO FEDERATION OF SAN DIEGO COUNTY INC,DCH_SNACK_NT,24,0,0,0,0,0,0,0,0,0
SAN DIEGO,Jul 2014,DCH,2014,CHICANO FEDERATION OF SAN DIEGO COUNTY INC,DCH_SNACK_NT,22,0,0,0,0,0,0,0,0,0
SAN DIEGO,Jul 2014,DCH,2014,CHICANO FEDERATION OF SAN DIEGO COUNTY INC,DCH_SNACK_PM,30,0,0,0,0,81251,0,0,81251,2708.3667
SAN DIEGO,Jul 2014,DCH,2014,CHICANO FEDERATION OF SAN DIEGO COUNTY INC,DCH_SNACK_PM,,0,0,0,0,0,572,1918,2490,0
SAN DIEGO,Jul 2014,DCH,2014,CHICANO FEDERATION OF SAN DIEGO COUNTY INC,DCH_SNACK_PM,22,0,0,0,0,0,0,0,0,0
SAN DIEGO,Jul 2014,DCH,2014,CHICANO FEDERATION OF SAN DIEGO COUNTY INC,DCH_SNACK_PM,24,0,0,0,0,0,0,0,0,0
SAN DIEGO,Jul 2014,DCH,2014,CHICANO FEDERATION OF SAN DIEGO COUNTY INC,DCH_SNACK_PM,22,0,0,0,0,0,0,0,0,0
SAN DIEGO,Jul 2014,DCH,2014,CHICANO FEDERATION OF SAN DIEGO COUNTY INC,DCH_SUPPER,30,0,0,0,0,91543,0,0,91543,3051.4333
SAN DIEGO,Jul 2014,DCH,2014,CHICANO FEDERATION OF SAN DIEGO COUNTY INC,DCH_SUPPER,,0,0,0,0,0,680,2000,2680,0
SAN DIEGO,Jul 2014,DCH,2014,CHICANO FEDERATION OF SAN DIEGO COUNTY INC,DCH_SUPPER,22,0,0,0,0,0,0,0,0,0
SAN DIEGO,Jul 2014,DCH,2014,CHICANO FEDERATION OF SAN DIEGO COUNTY INC,DCH_SUPPER,24,0,0,0,0,0,0,0,0,0
SAN DIEGO,Jul 2014,DCH,2014,CHICANO FEDERATION OF SAN DIEGO COUNTY INC,DCH_SUPPER,22,0,0,0,0,0,0,0,0,0
SAN DIEGO,Aug 2014,DCH,2014,CHICANO FEDERATION OF SAN DIEGO COUNTY INC,DCH_BREAKFAST,21,0,0,0,0,0,0,0,0,0
SAN DIEGO,Aug 2014,DCH,2014,CHICANO FEDERATION OF SAN DIEGO COUNTY INC,DCH_BREAKFAST,26,0,0,0,0,0,0,0,0,0
SAN DIEGO,Aug 2014,DCH,2014,CHICANO FEDERATION OF SAN DIEGO COUNTY INC,DCH_BREAKFAST,21,0,0,0,0,0,0,0,0,0
SAN DIEGO,Aug 2014,DCH,2014,CHICANO FEDERATION OF SAN DIEGO COUNTY INC,DCH_BREAKFAST,,0,0,0,0,0,620,931,1551,0
SAN DIEGO,Aug 2014,DCH,2014,CHICANO FEDERATION OF SAN DIEGO COUNTY INC,DCH_BREAKFAST,31,0,0,0,0,50611,0,0,50611,1632.6129
SAN DIEGO,Aug 2014,DCH,2014,CHICANO FEDERATION OF SAN DIEGO COUNTY INC,DCH_LUNCH,21,0,0,0,0,0,0,0,0,0
SAN DIEGO,Aug 2014,DCH,2014,CHICANO FEDERATION OF SAN DIEGO COUNTY INC,DCH_LUNCH,26,0,0,0,0,0,0,0,0,0
SAN DIEGO,Aug 2014,DCH,2014,CHICANO FEDERATION OF SAN DIEGO COUNTY INC,DCH_LUNCH,21,0,0,0,0,0,0,0,0,0
SAN DIEGO,Aug 2014,DCH,2014,CHICANO FEDERATION OF SAN DIEGO COUNTY INC,DCH_LUNCH,,0,0,0,0,0,819,2272,3091,0
SAN DIEGO,Aug 2014,DCH,2014,CHICANO FEDERATION OF SAN DIEGO COUNTY INC,DCH_LUNCH,31,0,0,0,0,92405,0,0,92405,2980.8065
SAN DIEGO,Aug 2014,DCH,2014,CHICANO FEDERATION OF SAN DIEGO COUNTY INC,DCH_SNACK_AM,31,0,0,0,0,39800,0,0,39800,1283.871
SAN DIEGO,Aug 2014,DCH,2014,CHICANO FEDERATION OF SAN DIEGO COUNTY INC,DCH_SNACK_AM,,0,0,0,0,0,471,861,1332,0
SAN DIEGO,Aug 2014,DCH,2014,CHICANO FEDERATION OF SAN DIEGO COUNTY INC,DCH_SNACK_AM,21,0,0,0,0,0,0,0,0,0
SAN DIEGO,Aug 2014,DCH,2014,CHICANO FEDERATION OF SAN DIEGO COUNTY INC,DCH_SNACK_AM,26,0,0,0,0,0,0,0,0,0
SAN DIEGO,Aug 2014,DCH,2014,CHICANO FEDERATION OF SAN DIEGO COUNTY INC,DCH_SNACK_AM,21,0,0,0,0,0,0,0,0,0
SAN DIEGO,Aug 2014,DCH,2014,CHICANO FEDERATION OF SAN DIEGO COUNTY INC,DCH_SNACK_NT,21,0,0,0,0,0,0,0,0,0
SAN DIEGO,Aug 2014,DCH,2014,CHICANO FEDERATION OF SAN DIEGO COUNTY INC,DCH_SNACK_NT,26,0,0,0,0,0,0,0,0,0
SAN DIEGO,Aug 2014,DCH,2014,CHICANO FEDERATION OF SAN DIEGO COUNTY INC,DCH_SNACK_NT,21,0,0,0,0,0,0,0,0,0
SAN DIEGO,Aug 2014,DCH,2014,CHICANO FEDERATION OF SAN DIEGO COUNTY INC,DCH_SNACK_NT,,0,0,0,0,0,27,51,78,0
SAN DIEGO,Aug 2014,DCH,2014,CHICANO FEDERATION OF SAN DIEGO COUNTY INC,DCH_SNACK_NT,31,0,0,0,0,9389,0,0,9389,302.871
SAN DIEGO,Aug 2014,DCH,2014,CHICANO FEDERATION OF SAN DIEGO COUNTY INC,DCH_SNACK_PM,31,0,0,0,0,75390,0,0,75390,2431.9355
SAN DIEGO,Aug 2014,DCH,2014,CHICANO FEDERATION OF SAN DIEGO COUNTY INC,DCH_SNACK_PM,,0,0,0,0,0,625,1635,2260,0
SAN DIEGO,Aug 2014,DCH,2014,CHICANO FEDERATION OF SAN DIEGO COUNTY INC,DCH_SNACK_PM,21,0,0,0,0,0,0,0,0,0
SAN DIEGO,Aug 2014,DCH,2014,CHICANO FEDERATION OF SAN DIEGO COUNTY INC,DCH_SNACK_PM,26,0,0,0,0,0,0,0,0,0
SAN DIEGO,Aug 2014,DCH,2014,CHICANO FEDERATION OF SAN DIEGO COUNTY INC,DCH_SNACK_PM,21,0,0,0,0,0,0,0,0,0
SAN DIEGO,Aug 2014,DCH,2014,CHICANO FEDERATION OF SAN DIEGO COUNTY INC,DCH_SUPPER,21,0,0,0,0,0,0,0,0,0
SAN DIEGO,Aug 2014,DCH,2014,CHICANO FEDERATION OF SAN DIEGO COUNTY INC,DCH_SUPPER,26,0,0,0,0,0,0,0,0,0
SAN DIEGO,Aug 2014,DCH,2014,CHICANO FEDERATION OF SAN DIEGO COUNTY INC,DCH_SUPPER,21,0,0,0,0,0,0,0,0,0
SAN DIEGO,Aug 2014,DCH,2014,CHICANO FEDERATION OF SAN DIEGO COUNTY INC,DCH_SUPPER,,0,0,0,0,0,888,1566,2454,0
SAN DIEGO,Aug 2014,DCH,2014,CHICANO FEDERATION OF SAN DIEGO COUNTY INC,DCH_SUPPER,31,0,0,0,0,88963,0,0,88963,2869.7742
SAN DIEGO,Sep 2014,DCH,2014,CHICANO FEDERATION OF SAN DIEGO COUNTY INC,DCH_BREAKFAST,29,0,0,0,0,56507,0,0,56507,1948.5172
SAN DIEGO,Sep 2014,DCH,2014,CHICANO FEDERATION OF SAN DIEGO COUNTY INC,DCH_BREAKFAST,,0,0,0,0,0,619,1087,1706,0
SAN DIEGO,Sep 2014,DCH,2014,CHICANO FEDERATION OF SAN DIEGO COUNTY INC,DCH_BREAKFAST,21,0,0,0,0,0,0,0,0,0
SAN DIEGO,Sep 2014,DCH,2014,CHICANO FEDERATION OF SAN DIEGO COUNTY INC,DCH_BREAKFAST,22,0,0,0,0,0,0,0,0,0
SAN DIEGO,Sep 2014,DCH,2014,CHICANO FEDERATION OF SAN DIEGO COUNTY INC,DCH_BREAKFAST,21,0,0,0,0,0,0,0,0,0
SAN DIEGO,Sep 2014,DCH,2014,CHICANO FEDERATION OF SAN DIEGO COUNTY INC,DCH_LUNCH,21,0,0,0,0,0,0,0,0,0
SAN DIEGO,Sep 2014,DCH,2014,CHICANO FEDERATION OF SAN DIEGO COUNTY INC,DCH_LUNCH,22,0,0,0,0,0,0,0,0,0
SAN DIEGO,Sep 2014,DCH,2014,CHICANO FEDERATION OF SAN DIEGO COUNTY INC,DCH_LUNCH,21,0,0,0,0,0,0,0,0,0
SAN DIEGO,Sep 2014,DCH,2014,CHICANO FEDERATION OF SAN DIEGO COUNTY INC,DCH_LUNCH,,0,0,0,0,0,891,2208,3099,0
SAN DIEGO,Sep 2014,DCH,2014,CHICANO FEDERATION OF SAN DIEGO COUNTY INC,DCH_LUNCH,29,0,0,0,0,77422,0,0,77422,2669.7241
SAN DIEGO,Sep 2014,DCH,2014,CHICANO FEDERATION OF SAN DIEGO COUNTY INC,DCH_SNACK_AM,29,0,0,0,0,35381,0,0,35381,1220.0345
SAN DIEGO,Sep 2014,DCH,2014,CHICANO FEDERATION OF SAN DIEGO COUNTY INC,DCH_SNACK_AM,,0,0,0,0,0,500,822,1322,0
SAN DIEGO,Sep 2014,DCH,2014,CHICANO FEDERATION OF SAN DIEGO COUNTY INC,DCH_SNACK_AM,21,0,0,0,0,0,0,0,0,0
SAN DIEGO,Sep 2014,DCH,2014,CHICANO FEDERATION OF SAN DIEGO COUNTY INC,DCH_SNACK_AM,22,0,0,0,0,0,0,0,0,0
SAN DIEGO,Sep 2014,DCH,2014,CHICANO FEDERATION OF SAN DIEGO COUNTY INC,DCH_SNACK_AM,21,0,0,0,0,0,0,0,0,0
SAN DIEGO,Sep 2014,DCH,2014,CHICANO FEDERATION OF SAN DIEGO COUNTY INC,DCH_SNACK_NT,21,0,0,0,0,0,0,0,0,0
SAN DIEGO,Sep 2014,DCH,2014,CHICANO FEDERATION OF SAN DIEGO COUNTY INC,DCH_SNACK_NT,22,0,0,0,0,0,0,0,0,0
SAN DIEGO,Sep 2014,DCH,2014,CHICANO FEDERATION OF SAN DIEGO COUNTY INC,DCH_SNACK_NT,21,0,0,0,0,0,0,0,0,0
SAN DIEGO,Sep 2014,DCH,2014,CHICANO FEDERATION OF SAN DIEGO COUNTY INC,DCH_SNACK_NT,,0,0,0,0,0,61,42,103,0
SAN DIEGO,Sep 2014,DCH,2014,CHICANO FEDERATION OF SAN DIEGO COUNTY INC,DCH_SNACK_NT,29,0,0,0,0,11073,0,0,11073,381.8276
SAN DIEGO,Sep 2014,DCH,2014,CHICANO FEDERATION OF SAN DIEGO COUNTY INC,DCH_SNACK_PM,29,0,0,0,0,75453,0,0,75453,2601.8276
SAN DIEGO,Sep 2014,DCH,2014,CHICANO FEDERATION OF SAN DIEGO COUNTY INC,DCH_SNACK_PM,,0,0,0,0,0,615,1728,2343,0
SAN DIEGO,Sep 2014,DCH,2014,CHICANO FEDERATION OF SAN DIEGO COUNTY INC,DCH_SNACK_PM,21,0,0,0,0,0,0,0,0,0
SAN DIEGO,Sep 2014,DCH,2014,CHICANO FEDERATION OF SAN DIEGO COUNTY INC,DCH_SNACK_PM,22,0,0,0,0,0,0,0,0,0
SAN DIEGO,Sep 2014,DCH,2014,CHICANO FEDERATION OF SAN DIEGO COUNTY INC,DCH_SNACK_PM,21,0,0,0,0,0,0,0,0,0
SAN DIEGO,Sep 2014,DCH,2014,CHICANO FEDERATION OF SAN DIEGO COUNTY INC,DCH_SUPPER,21,0,0,0,0,0,0,0,0,0
SAN DIEGO,Sep 2014,DCH,2014,CHICANO FEDERATION OF SAN DIEGO COUNTY INC,DCH_SUPPER,22,0,0,0,0,0,0,0,0,0
SAN DIEGO,Sep 2014,DCH,2014,CHICANO FEDERATION OF SAN DIEGO COUNTY INC,DCH_SUPPER,21,0,0,0,0,0,0,0,0,0
SAN DIEGO,Sep 2014,DCH,2014,CHICANO FEDERATION OF SAN DIEGO COUNTY INC,DCH_SUPPER,,0,0,0,0,0,858,1493,2351,0
SAN DIEGO,Sep 2014,DCH,2014,CHICANO FEDERATION OF SAN DIEGO COUNTY INC,DCH_SUPPER,29,0,0,0,0,89753,0,0,89753,3094.931
SAN DIEGO,Oct 2013,CACF,2014,CHILD DEVELOPMENT ASSOC INC ,CHILD_BREAKFAST,23,225,103,47,375,2747,1258,574,4579,199.087
SAN DIEGO,Oct 2013,CACF,2014,CHILD DEVELOPMENT ASSOC INC ,CHILD_LUNCH,23,225,103,47,375,3499,1602,730,5831,253.5217
SAN DIEGO,Oct 2013,CACF,2014,CHILD DEVELOPMENT ASSOC INC ,CHILD_SNACK_AM,23,225,103,47,375,103,47,22,172,7.4783
SAN DIEGO,Oct 2013,CACF,2014,CHILD DEVELOPMENT ASSOC INC ,CHILD_SNACK_PM,23,225,103,47,375,2968,1359,620,4947,215.087
SAN DIEGO,Oct 2013,DCH,2014,CHILD DEVELOPMENT ASSOC INC ,DCH_BREAKFAST,27,0,0,0,0,110337,0,0,110337,4086.5556
SAN DIEGO,Oct 2013,DCH,2014,CHILD DEVELOPMENT ASSOC INC ,DCH_BREAKFAST,,0,0,0,0,0,484,9921,10405,0
SAN DIEGO,Oct 2013,DCH,2014,CHILD DEVELOPMENT ASSOC INC ,DCH_BREAKFAST,27,0,0,0,0,0,0,0,0,0
SAN DIEGO,Oct 2013,DCH,2014,CHILD DEVELOPMENT ASSOC INC ,DCH_BREAKFAST,27,0,0,0,0,0,0,0,0,0
SAN DIEGO,Oct 2013,DCH,2014,CHILD DEVELOPMENT ASSOC INC ,DCH_BREAKFAST,27,0,0,0,0,0,0,0,0,0
SAN DIEGO,Oct 2013,DCH,2014,CHILD DEVELOPMENT ASSOC INC ,DCH_LUNCH,27,0,0,0,0,122821,0,0,122821,4548.9259
SAN DIEGO,Oct 2013,DCH,2014,CHILD DEVELOPMENT ASSOC INC ,DCH_LUNCH,,0,0,0,0,0,451,15056,15507,0
SAN DIEGO,Oct 2013,DCH,2014,CHILD DEVELOPMENT ASSOC INC ,DCH_LUNCH,27,0,0,0,0,0,0,0,0,0
SAN DIEGO,Oct 2013,DCH,2014,CHILD DEVELOPMENT ASSOC INC ,DCH_LUNCH,27,0,0,0,0,0,0,0,0,0
SAN DIEGO,Oct 2013,DCH,2014,CHILD DEVELOPMENT ASSOC INC ,DCH_LUNCH,27,0,0,0,0,0,0,0,0,0
SAN DIEGO,Oct 2013,DCH,2014,CHILD DEVELOPMENT ASSOC INC ,DCH_SNACK_AM,27,0,0,0,0,56426,0,0,56426,2089.8519
SAN DIEGO,Oct 2013,DCH,2014,CHILD DEVELOPMENT ASSOC INC ,DCH_SNACK_AM,,0,0,0,0,0,325,7638,7963,0
SAN DIEGO,Oct 2013,DCH,2014,CHILD DEVELOPMENT ASSOC INC ,DCH_SNACK_AM,27,0,0,0,0,0,0,0,0,0
SAN DIEGO,Oct 2013,DCH,2014,CHILD DEVELOPMENT ASSOC INC ,DCH_SNACK_AM,27,0,0,0,0,0,0,0,0,0
SAN DIEGO,Oct 2013,DCH,2014,CHILD DEVELOPMENT ASSOC INC ,DCH_SNACK_AM,27,0,0,0,0,0,0,0,0,0
SAN DIEGO,Oct 2013,DCH,2014,CHILD DEVELOPMENT ASSOC INC ,DCH_SNACK_NT,27,0,0,0,0,12491,0,0,12491,462.6296
SAN DIEGO,Oct 2013,DCH,2014,CHILD DEVELOPMENT ASSOC INC ,DCH_SNACK_NT,,0,0,0,0,0,239,198,437,0
SAN DIEGO,Oct 2013,DCH,2014,CHILD DEVELOPMENT ASSOC INC ,DCH_SNACK_NT,27,0,0,0,0,0,0,0,0,0
SAN DIEGO,Oct 2013,DCH,2014,CHILD DEVELOPMENT ASSOC INC ,DCH_SNACK_NT,27,0,0,0,0,0,0,0,0,0
SAN DIEGO,Oct 2013,DCH,2014,CHILD DEVELOPMENT ASSOC INC ,DCH_SNACK_NT,27,0,0,0,0,0,0,0,0,0
SAN DIEGO,Oct 2013,DCH,2014,CHILD DEVELOPMENT ASSOC INC ,DCH_SNACK_PM,27,0,0,0,0,121559,0,0,121559,4502.1852
SAN DIEGO,Oct 2013,DCH,2014,CHILD DEVELOPMENT ASSOC INC ,DCH_SNACK_PM,,0,0,0,0,0,640,11260,11900,0
SAN DIEGO,Oct 2013,DCH,2014,CHILD DEVELOPMENT ASSOC INC ,DCH_SNACK_PM,27,0,0,0,0,0,0,0,0,0
SAN DIEGO,Oct 2013,DCH,2014,CHILD DEVELOPMENT ASSOC INC ,DCH_SNACK_PM,27,0,0,0,0,0,0,0,0,0
SAN DIEGO,Oct 2013,DCH,2014,CHILD DEVELOPMENT ASSOC INC ,DCH_SNACK_PM,27,0,0,0,0,0,0,0,0,0
SAN DIEGO,Oct 2013,DCH,2014,CHILD DEVELOPMENT ASSOC INC ,DCH_SUPPER,27,0,0,0,0,89177,0,0,89177,3302.8519
SAN DIEGO,Oct 2013,DCH,2014,CHILD DEVELOPMENT ASSOC INC ,DCH_SUPPER,,0,0,0,0,0,676,6092,6768,0
SAN DIEGO,Oct 2013,DCH,2014,CHILD DEVELOPMENT ASSOC INC ,DCH_SUPPER,27,0,0,0,0,0,0,0,0,0
SAN DIEGO,Oct 2013,DCH,2014,CHILD DEVELOPMENT ASSOC INC ,DCH_SUPPER,27,0,0,0,0,0,0,0,0,0
SAN DIEGO,Oct 2013,DCH,2014,CHILD DEVELOPMENT ASSOC INC ,DCH_SUPPER,27,0,0,0,0,0,0,0,0,0
SAN DIEGO,Nov 2013,CACF,2014,CHILD DEVELOPMENT ASSOC INC ,CHILD_BREAKFAST,19,225,103,47,375,2265,1037,473,3775,198.6842
SAN DIEGO,Nov 2013,CACF,2014,CHILD DEVELOPMENT ASSOC INC ,CHILD_LUNCH,19,225,103,47,375,2933,1343,613,4889,257.3158
SAN DIEGO,Nov 2013,CACF,2014,CHILD DEVELOPMENT ASSOC INC ,CHILD_SNACK_AM,19,225,103,47,375,105,48,22,175,9.2105
SAN DIEGO,Nov 2013,CACF,2014,CHILD DEVELOPMENT ASSOC INC ,CHILD_SNACK_PM,19,225,103,47,375,2505,1147,523,4175,219.7368
SAN DIEGO,Nov 2013,DCH,2014,CHILD DEVELOPMENT ASSOC INC ,DCH_BREAKFAST,25,0,0,0,0,90184,0,0,90184,3607.36
SAN DIEGO,Nov 2013,DCH,2014,CHILD DEVELOPMENT ASSOC INC ,DCH_BREAKFAST,,0,0,0,0,0,332,8019,8351,0
SAN DIEGO,Nov 2013,DCH,2014,CHILD DEVELOPMENT ASSOC INC ,DCH_BREAKFAST,25,0,0,0,0,0,0,0,0,0
SAN DIEGO,Nov 2013,DCH,2014,CHILD DEVELOPMENT ASSOC INC ,DCH_BREAKFAST,24,0,0,0,0,0,0,0,0,0
SAN DIEGO,Nov 2013,DCH,2014,CHILD DEVELOPMENT ASSOC INC ,DCH_BREAKFAST,24,0,0,0,0,0,0,0,0,0
SAN DIEGO,Nov 2013,DCH,2014,CHILD DEVELOPMENT ASSOC INC ,DCH_LUNCH,25,0,0,0,0,109650,0,0,109650,4386
SAN DIEGO,Nov 2013,DCH,2014,CHILD DEVELOPMENT ASSOC INC ,DCH_LUNCH,,0,0,0,0,0,505,12704,13209,0
SAN DIEGO,Nov 2013,DCH,2014,CHILD DEVELOPMENT ASSOC INC ,DCH_LUNCH,25,0,0,0,0,0,0,0,0,0
SAN DIEGO,Nov 2013,DCH,2014,CHILD DEVELOPMENT ASSOC INC ,DCH_LUNCH,24,0,0,0,0,0,0,0,0,0
SAN DIEGO,Nov 2013,DCH,2014,CHILD DEVELOPMENT ASSOC INC ,DCH_LUNCH,24,0,0,0,0,0,0,0,0,0
SAN DIEGO,Nov 2013,DCH,2014,CHILD DEVELOPMENT ASSOC INC ,DCH_SNACK_AM,25,0,0,0,0,49338,0,0,49338,1973.52
SAN DIEGO,Nov 2013,DCH,2014,CHILD DEVELOPMENT ASSOC INC ,DCH_SNACK_AM,,0,0,0,0,0,301,6436,6737,0
SAN DIEGO,Nov 2013,DCH,2014,CHILD DEVELOPMENT ASSOC INC ,DCH_SNACK_AM,25,0,0,0,0,0,0,0,0,0
SAN DIEGO,Nov 2013,DCH,2014,CHILD DEVELOPMENT ASSOC INC ,DCH_SNACK_AM,24,0,0,0,0,0,0,0,0,0
SAN DIEGO,Nov 2013,DCH,2014,CHILD DEVELOPMENT ASSOC INC ,DCH_SNACK_AM,24,0,0,0,0,0,0,0,0,0
SAN DIEGO,Nov 2013,DCH,2014,CHILD DEVELOPMENT ASSOC INC ,DCH_SNACK_NT,25,0,0,0,0,9676,0,0,9676,387.04
SAN DIEGO,Nov 2013,DCH,2014,CHILD DEVELOPMENT ASSOC INC ,DCH_SNACK_NT,,0,0,0,0,0,211,151,362,0
SAN DIEGO,Nov 2013,DCH,2014,CHILD DEVELOPMENT ASSOC INC ,DCH_SNACK_NT,25,0,0,0,0,0,0,0,0,0
SAN DIEGO,Nov 2013,DCH,2014,CHILD DEVELOPMENT ASSOC INC ,DCH_SNACK_NT,24,0,0,0,0,0,0,0,0,0
SAN DIEGO,Nov 2013,DCH,2014,CHILD DEVELOPMENT ASSOC INC ,DCH_SNACK_NT,24,0,0,0,0,0,0,0,0,0
SAN DIEGO,Nov 2013,DCH,2014,CHILD DEVELOPMENT ASSOC INC ,DCH_SNACK_PM,25,0,0,0,0,100338,0,0,100338,4013.52
SAN DIEGO,Nov 2013,DCH,2014,CHILD DEVELOPMENT ASSOC INC ,DCH_SNACK_PM,,0,0,0,0,0,614,9256,9870,0
SAN DIEGO,Nov 2013,DCH,2014,CHILD DEVELOPMENT ASSOC INC ,DCH_SNACK_PM,25,0,0,0,0,0,0,0,0,0
SAN DIEGO,Nov 2013,DCH,2014,CHILD DEVELOPMENT ASSOC INC ,DCH_SNACK_PM,24,0,0,0,0,0,0,0,0,0
SAN DIEGO,Nov 2013,DCH,2014,CHILD DEVELOPMENT ASSOC INC ,DCH_SNACK_PM,24,0,0,0,0,0,0,0,0,0
SAN DIEGO,Nov 2013,DCH,2014,CHILD DEVELOPMENT ASSOC INC ,DCH_SUPPER,25,0,0,0,0,74114,0,0,74114,2964.56
SAN DIEGO,Nov 2013,DCH,2014,CHILD DEVELOPMENT ASSOC INC ,DCH_SUPPER,,0,0,0,0,0,648,4956,5604,0
SAN DIEGO,Nov 2013,DCH,2014,CHILD DEVELOPMENT ASSOC INC ,DCH_SUPPER,25,0,0,0,0,0,0,0,0,0
SAN DIEGO,Nov 2013,DCH,2014,CHILD DEVELOPMENT ASSOC INC ,DCH_SUPPER,24,0,0,0,0,0,0,0,0,0
SAN DIEGO,Nov 2013,DCH,2014,CHILD DEVELOPMENT ASSOC INC ,DCH_SUPPER,24,0,0,0,0,0,0,0,0,0
SAN DIEGO,Dec 2013,CACF,2014,CHILD DEVELOPMENT ASSOC INC ,CHILD_BREAKFAST,17,225,103,47,375,1916,877,400,3193,187.8235
SAN DIEGO,Dec 2013,CACF,2014,CHILD DEVELOPMENT ASSOC INC ,CHILD_LUNCH,17,225,103,47,375,2600,1190,543,4333,254.8824
SAN DIEGO,Dec 2013,CACF,2014,CHILD DEVELOPMENT ASSOC INC ,CHILD_SNACK_AM,17,225,103,47,375,115,52,24,191,11.2353
SAN DIEGO,Dec 2013,CACF,2014,CHILD DEVELOPMENT ASSOC INC ,CHILD_SNACK_PM,17,225,103,47,375,2219,1016,463,3698,217.5294
SAN DIEGO,Dec 2013,DCH,2014,CHILD DEVELOPMENT ASSOC INC ,DCH_BREAKFAST,25,0,0,0,0,90146,0,0,90146,3605.84
SAN DIEGO,Dec 2013,DCH,2014,CHILD DEVELOPMENT ASSOC INC ,DCH_BREAKFAST,,0,0,0,0,0,402,7566,7968,0
SAN DIEGO,Dec 2013,DCH,2014,CHILD DEVELOPMENT ASSOC INC ,DCH_BREAKFAST,25,0,0,0,0,0,0,0,0,0
SAN DIEGO,Dec 2013,DCH,2014,CHILD DEVELOPMENT ASSOC INC ,DCH_BREAKFAST,25,0,0,0,0,0,0,0,0,0
SAN DIEGO,Dec 2013,DCH,2014,CHILD DEVELOPMENT ASSOC INC ,DCH_BREAKFAST,25,0,0,0,0,0,0,0,0,0
SAN DIEGO,Dec 2013,DCH,2014,CHILD DEVELOPMENT ASSOC INC ,DCH_LUNCH,25,0,0,0,0,111692,0,0,111692,4467.68
SAN DIEGO,Dec 2013,DCH,2014,CHILD DEVELOPMENT ASSOC INC ,DCH_LUNCH,,0,0,0,0,0,558,11833,12391,0
SAN DIEGO,Dec 2013,DCH,2014,CHILD DEVELOPMENT ASSOC INC ,DCH_LUNCH,25,0,0,0,0,0,0,0,0,0
SAN DIEGO,Dec 2013,DCH,2014,CHILD DEVELOPMENT ASSOC INC ,DCH_LUNCH,25,0,0,0,0,0,0,0,0,0
SAN DIEGO,Dec 2013,DCH,2014,CHILD DEVELOPMENT ASSOC INC ,DCH_LUNCH,25,0,0,0,0,0,0,0,0,0
SAN DIEGO,Dec 2013,DCH,2014,CHILD DEVELOPMENT ASSOC INC ,DCH_SNACK_AM,25,0,0,0,0,50222,0,0,50222,2008.88
SAN DIEGO,Dec 2013,DCH,2014,CHILD DEVELOPMENT ASSOC INC ,DCH_SNACK_AM,,0,0,0,0,0,368,5919,6287,0
SAN DIEGO,Dec 2013,DCH,2014,CHILD DEVELOPMENT ASSOC INC ,DCH_SNACK_AM,25,0,0,0,0,0,0,0,0,0
SAN DIEGO,Dec 2013,DCH,2014,CHILD DEVELOPMENT ASSOC INC ,DCH_SNACK_AM,25,0,0,0,0,0,0,0,0,0
SAN DIEGO,Dec 2013,DCH,2014,CHILD DEVELOPMENT ASSOC INC ,DCH_SNACK_AM,25,0,0,0,0,0,0,0,0,0
SAN DIEGO,Dec 2013,DCH,2014,CHILD DEVELOPMENT ASSOC INC ,DCH_SNACK_NT,25,0,0,0,0,9633,0,0,9633,385.32
SAN DIEGO,Dec 2013,DCH,2014,CHILD DEVELOPMENT ASSOC INC ,DCH_SNACK_NT,,0,0,0,0,0,215,150,365,0
SAN DIEGO,Dec 2013,DCH,2014,CHILD DEVELOPMENT ASSOC INC ,DCH_SNACK_NT,25,0,0,0,0,0,0,0,0,0
SAN DIEGO,Dec 2013,DCH,2014,CHILD DEVELOPMENT ASSOC INC ,DCH_SNACK_NT,25,0,0,0,0,0,0,0,0,0
SAN DIEGO,Dec 2013,DCH,2014,CHILD DEVELOPMENT ASSOC INC ,DCH_SNACK_NT,25,0,0,0,0,0,0,0,0,0
SAN DIEGO,Dec 2013,DCH,2014,CHILD DEVELOPMENT ASSOC INC ,DCH_SNACK_PM,25,0,0,0,0,101615,0,0,101615,4064.6
SAN DIEGO,Dec 2013,DCH,2014,CHILD DEVELOPMENT ASSOC INC ,DCH_SNACK_PM,,0,0,0,0,0,511,8701,9212,0
SAN DIEGO,Dec 2013,DCH,2014,CHILD DEVELOPMENT ASSOC INC ,DCH_SNACK_PM,25,0,0,0,0,0,0,0,0,0
SAN DIEGO,Dec 2013,DCH,2014,CHILD DEVELOPMENT ASSOC INC ,DCH_SNACK_PM,25,0,0,0,0,0,0,0,0,0
SAN DIEGO,Dec 2013,DCH,2014,CHILD DEVELOPMENT ASSOC INC ,DCH_SNACK_PM,25,0,0,0,0,0,0,0,0,0
SAN DIEGO,Dec 2013,DCH,2014,CHILD DEVELOPMENT ASSOC INC ,DCH_SUPPER,25,0,0,0,0,75442,0,0,75442,3017.68
SAN DIEGO,Dec 2013,DCH,2014,CHILD DEVELOPMENT ASSOC INC ,DCH_SUPPER,,0,0,0,0,0,571,4733,5304,0
SAN DIEGO,Dec 2013,DCH,2014,CHILD DEVELOPMENT ASSOC INC ,DCH_SUPPER,25,0,0,0,0,0,0,0,0,0
SAN DIEGO,Dec 2013,DCH,2014,CHILD DEVELOPMENT ASSOC INC ,DCH_SUPPER,25,0,0,0,0,0,0,0,0,0
SAN DIEGO,Dec 2013,DCH,2014,CHILD DEVELOPMENT ASSOC INC ,DCH_SUPPER,25,0,0,0,0,0,0,0,0,0
SAN DIEGO,Jan 2014,CACF,2014,CHILD DEVELOPMENT ASSOC INC ,CHILD_BREAKFAST,21,225,103,47,375,2396,1097,500,3993,190.1429
SAN DIEGO,Jan 2014,CACF,2014,CHILD DEVELOPMENT ASSOC INC ,CHILD_LUNCH,21,225,103,47,375,3225,1477,673,5375,255.9524
SAN DIEGO,Jan 2014,CACF,2014,CHILD DEVELOPMENT ASSOC INC ,CHILD_SNACK_AM,21,225,103,47,375,136,62,29,227,10.8095
SAN DIEGO,Jan 2014,CACF,2014,CHILD DEVELOPMENT ASSOC INC ,CHILD_SNACK_PM,21,225,103,47,375,2874,1316,600,4790,228.0952
SAN DIEGO,Jan 2014,DCH,2014,CHILD DEVELOPMENT ASSOC INC ,DCH_BREAKFAST,26,0,0,0,0,100494,0,0,100494,3865.1538
SAN DIEGO,Jan 2014,DCH,2014,CHILD DEVELOPMENT ASSOC INC ,DCH_BREAKFAST,,0,0,0,0,0,421,9091,9512,0
SAN DIEGO,Jan 2014,DCH,2014,CHILD DEVELOPMENT ASSOC INC ,DCH_BREAKFAST,26,0,0,0,0,0,0,0,0,0
SAN DIEGO,Jan 2014,DCH,2014,CHILD DEVELOPMENT ASSOC INC ,DCH_BREAKFAST,26,0,0,0,0,0,0,0,0,0
SAN DIEGO,Jan 2014,DCH,2014,CHILD DEVELOPMENT ASSOC INC ,DCH_BREAKFAST,26,0,0,0,0,0,0,0,0,0
SAN DIEGO,Jan 2014,DCH,2014,CHILD DEVELOPMENT ASSOC INC ,DCH_LUNCH,26,0,0,0,0,123613,0,0,123613,4754.3462
SAN DIEGO,Jan 2014,DCH,2014,CHILD DEVELOPMENT ASSOC INC ,DCH_LUNCH,,0,0,0,0,0,463,14268,14731,0
SAN DIEGO,Jan 2014,DCH,2014,CHILD DEVELOPMENT ASSOC INC ,DCH_LUNCH,26,0,0,0,0,0,0,0,0,0
SAN DIEGO,Jan 2014,DCH,2014,CHILD DEVELOPMENT ASSOC INC ,DCH_LUNCH,26,0,0,0,0,0,0,0,0,0
SAN DIEGO,Jan 2014,DCH,2014,CHILD DEVELOPMENT ASSOC INC ,DCH_LUNCH,26,0,0,0,0,0,0,0,0,0
SAN DIEGO,Jan 2014,DCH,2014,CHILD DEVELOPMENT ASSOC INC ,DCH_SNACK_AM,26,0,0,0,0,55818,0,0,55818,2146.8462
SAN DIEGO,Jan 2014,DCH,2014,CHILD DEVELOPMENT ASSOC INC ,DCH_SNACK_AM,,0,0,0,0,0,342,7482,7824,0
SAN DIEGO,Jan 2014,DCH,2014,CHILD DEVELOPMENT ASSOC INC ,DCH_SNACK_AM,26,0,0,0,0,0,0,0,0,0
SAN DIEGO,Jan 2014,DCH,2014,CHILD DEVELOPMENT ASSOC INC ,DCH_SNACK_AM,26,0,0,0,0,0,0,0,0,0
SAN DIEGO,Jan 2014,DCH,2014,CHILD DEVELOPMENT ASSOC INC ,DCH_SNACK_AM,26,0,0,0,0,0,0,0,0,0
SAN DIEGO,Jan 2014,DCH,2014,CHILD DEVELOPMENT ASSOC INC ,DCH_SNACK_NT,26,0,0,0,0,10917,0,0,10917,419.8846
SAN DIEGO,Jan 2014,DCH,2014,CHILD DEVELOPMENT ASSOC INC ,DCH_SNACK_NT,,0,0,0,0,0,265,147,412,0
SAN DIEGO,Jan 2014,DCH,2014,CHILD DEVELOPMENT ASSOC INC ,DCH_SNACK_NT,26,0,0,0,0,0,0,0,0,0
SAN DIEGO,Jan 2014,DCH,2014,CHILD DEVELOPMENT ASSOC INC ,DCH_SNACK_NT,26,0,0,0,0,0,0,0,0,0
SAN DIEGO,Jan 2014,DCH,2014,CHILD DEVELOPMENT ASSOC INC ,DCH_SNACK_NT,26,0,0,0,0,0,0,0,0,0
SAN DIEGO,Jan 2014,DCH,2014,CHILD DEVELOPMENT ASSOC INC ,DCH_SNACK_PM,26,0,0,0,0,112484,0,0,112484,4326.3077
SAN DIEGO,Jan 2014,DCH,2014,CHILD DEVELOPMENT ASSOC INC ,DCH_SNACK_PM,,0,0,0,0,0,533,10032,10565,0
SAN DIEGO,Jan 2014,DCH,2014,CHILD DEVELOPMENT ASSOC INC ,DCH_SNACK_PM,26,0,0,0,0,0,0,0,0,0
SAN DIEGO,Jan 2014,DCH,2014,CHILD DEVELOPMENT ASSOC INC ,DCH_SNACK_PM,26,0,0,0,0,0,0,0,0,0
SAN DIEGO,Jan 2014,DCH,2014,CHILD DEVELOPMENT ASSOC INC ,DCH_SNACK_PM,26,0,0,0,0,0,0,0,0,0
SAN DIEGO,Jan 2014,DCH,2014,CHILD DEVELOPMENT ASSOC INC ,DCH_SUPPER,26,0,0,0,0,82651,0,0,82651,3178.8846
SAN DIEGO,Jan 2014,DCH,2014,CHILD DEVELOPMENT ASSOC INC ,DCH_SUPPER,,0,0,0,0,0,508,5471,5979,0
SAN DIEGO,Jan 2014,DCH,2014,CHILD DEVELOPMENT ASSOC INC ,DCH_SUPPER,26,0,0,0,0,0,0,0,0,0
SAN DIEGO,Jan 2014,DCH,2014,CHILD DEVELOPMENT ASSOC INC ,DCH_SUPPER,26,0,0,0,0,0,0,0,0,0
SAN DIEGO,Jan 2014,DCH,2014,CHILD DEVELOPMENT ASSOC INC ,DCH_SUPPER,26,0,0,0,0,0,0,0,0,0
SAN DIEGO,Feb 2014,CACF,2014,CHILD DEVELOPMENT ASSOC INC ,CHILD_BREAKFAST,19,225,103,47,375,2531,1159,528,4218,222
SAN DIEGO,Feb 2014,CACF,2014,CHILD DEVELOPMENT ASSOC INC ,CHILD_LUNCH,19,225,103,47,375,3310,1516,691,5517,290.3684
SAN DIEGO,Feb 2014,CACF,2014,CHILD DEVELOPMENT ASSOC INC ,CHILD_SNACK_AM,19,225,103,47,375,140,64,29,233,12.2632
SAN DIEGO,Feb 2014,CACF,2014,CHILD DEVELOPMENT ASSOC INC ,CHILD_SNACK_PM,19,225,103,47,375,2910,1332,608,4850,255.2632
SAN DIEGO,Feb 2014,DCH,2014,CHILD DEVELOPMENT ASSOC INC ,DCH_BREAKFAST,24,0,0,0,0,95004,0,0,95004,3958.5
SAN DIEGO,Feb 2014,DCH,2014,CHILD DEVELOPMENT ASSOC INC ,DCH_BREAKFAST,,0,0,0,0,0,587,8575,9162,0
SAN DIEGO,Feb 2014,DCH,2014,CHILD DEVELOPMENT ASSOC INC ,DCH_BREAKFAST,24,0,0,0,0,0,0,0,0,0
SAN DIEGO,Feb 2014,DCH,2014,CHILD DEVELOPMENT ASSOC INC ,DCH_BREAKFAST,24,0,0,0,0,0,0,0,0,0
SAN DIEGO,Feb 2014,DCH,2014,CHILD DEVELOPMENT ASSOC INC ,DCH_BREAKFAST,24,0,0,0,0,0,0,0,0,0
SAN DIEGO,Feb 2014,DCH,2014,CHILD DEVELOPMENT ASSOC INC ,DCH_LUNCH,24,0,0,0,0,109719,0,0,109719,4571.625
SAN DIEGO,Feb 2014,DCH,2014,CHILD DEVELOPMENT ASSOC INC ,DCH_LUNCH,,0,0,0,0,0,526,13003,13529,0
SAN DIEGO,Feb 2014,DCH,2014,CHILD DEVELOPMENT ASSOC INC ,DCH_LUNCH,24,0,0,0,0,0,0,0,0,0
SAN DIEGO,Feb 2014,DCH,2014,CHILD DEVELOPMENT ASSOC INC ,DCH_LUNCH,24,0,0,0,0,0,0,0,0,0
SAN DIEGO,Feb 2014,DCH,2014,CHILD DEVELOPMENT ASSOC INC ,DCH_LUNCH,24,0,0,0,0,0,0,0,0,0
SAN DIEGO,Feb 2014,DCH,2014,CHILD DEVELOPMENT ASSOC INC ,DCH_SNACK_AM,24,0,0,0,0,50165,0,0,50165,2090.2083
SAN DIEGO,Feb 2014,DCH,2014,CHILD DEVELOPMENT ASSOC INC ,DCH_SNACK_AM,,0,0,0,0,0,425,6821,7246,0
SAN DIEGO,Feb 2014,DCH,2014,CHILD DEVELOPMENT ASSOC INC ,DCH_SNACK_AM,24,0,0,0,0,0,0,0,0,0
SAN DIEGO,Feb 2014,DCH,2014,CHILD DEVELOPMENT ASSOC INC ,DCH_SNACK_AM,24,0,0,0,0,0,0,0,0,0
SAN DIEGO,Feb 2014,DCH,2014,CHILD DEVELOPMENT ASSOC INC ,DCH_SNACK_AM,24,0,0,0,0,0,0,0,0,0
SAN DIEGO,Feb 2014,DCH,2014,CHILD DEVELOPMENT ASSOC INC ,DCH_SNACK_NT,24,0,0,0,0,10380,0,0,10380,432.5
SAN DIEGO,Feb 2014,DCH,2014,CHILD DEVELOPMENT ASSOC INC ,DCH_SNACK_NT,,0,0,0,0,0,256,139,395,0
SAN DIEGO,Feb 2014,DCH,2014,CHILD DEVELOPMENT ASSOC INC ,DCH_SNACK_NT,24,0,0,0,0,0,0,0,0,0
SAN DIEGO,Feb 2014,DCH,2014,CHILD DEVELOPMENT ASSOC INC ,DCH_SNACK_NT,24,0,0,0,0,0,0,0,0,0
SAN DIEGO,Feb 2014,DCH,2014,CHILD DEVELOPMENT ASSOC INC ,DCH_SNACK_NT,24,0,0,0,0,0,0,0,0,0
SAN DIEGO,Feb 2014,DCH,2014,CHILD DEVELOPMENT ASSOC INC ,DCH_SNACK_PM,24,0,0,0,0,104337,0,0,104337,4347.375
SAN DIEGO,Feb 2014,DCH,2014,CHILD DEVELOPMENT ASSOC INC ,DCH_SNACK_PM,,0,0,0,0,0,580,9411,9991,0
SAN DIEGO,Feb 2014,DCH,2014,CHILD DEVELOPMENT ASSOC INC ,DCH_SNACK_PM,24,0,0,0,0,0,0,0,0,0
SAN DIEGO,Feb 2014,DCH,2014,CHILD DEVELOPMENT ASSOC INC ,DCH_SNACK_PM,24,0,0,0,0,0,0,0,0,0
SAN DIEGO,Feb 2014,DCH,2014,CHILD DEVELOPMENT ASSOC INC ,DCH_SNACK_PM,24,0,0,0,0,0,0,0,0,0
SAN DIEGO,Feb 2014,DCH,2014,CHILD DEVELOPMENT ASSOC INC ,DCH_SUPPER,24,0,0,0,0,76669,0,0,76669,3194.5417
SAN DIEGO,Feb 2014,DCH,2014,CHILD DEVELOPMENT ASSOC INC ,DCH_SUPPER,,0,0,0,0,0,476,4894,5370,0
SAN DIEGO,Feb 2014,DCH,2014,CHILD DEVELOPMENT ASSOC INC ,DCH_SUPPER,24,0,0,0,0,0,0,0,0,0
SAN DIEGO,Feb 2014,DCH,2014,CHILD DEVELOPMENT ASSOC INC ,DCH_SUPPER,24,0,0,0,0,0,0,0,0,0
SAN DIEGO,Feb 2014,DCH,2014,CHILD DEVELOPMENT ASSOC INC ,DCH_SUPPER,24,0,0,0,0,0,0,0,0,0
SAN DIEGO,Mar 2014,CACF,2014,CHILD DEVELOPMENT ASSOC INC ,CHILD_BREAKFAST,21,225,103,47,375,2729,1249,570,4548,216.5714
SAN DIEGO,Mar 2014,CACF,2014,CHILD DEVELOPMENT ASSOC INC ,CHILD_LUNCH,21,225,103,47,375,3606,1651,753,6010,286.1905
SAN DIEGO,Mar 2014,CACF,2014,CHILD DEVELOPMENT ASSOC INC ,CHILD_SNACK_AM,21,225,103,47,375,155,71,32,258,12.2857
SAN DIEGO,Mar 2014,CACF,2014,CHILD DEVELOPMENT ASSOC INC ,CHILD_SNACK_PM,21,225,103,47,375,3151,1443,658,5252,250.0952
SAN DIEGO,Mar 2014,DCH,2014,CHILD DEVELOPMENT ASSOC INC ,DCH_BREAKFAST,26,0,0,0,0,104201,0,0,104201,4007.7308
SAN DIEGO,Mar 2014,DCH,2014,CHILD DEVELOPMENT ASSOC INC ,DCH_BREAKFAST,,0,0,0,0,0,482,9146,9628,0
SAN DIEGO,Mar 2014,DCH,2014,CHILD DEVELOPMENT ASSOC INC ,DCH_BREAKFAST,26,0,0,0,0,0,0,0,0,0
SAN DIEGO,Mar 2014,DCH,2014,CHILD DEVELOPMENT ASSOC INC ,DCH_BREAKFAST,26,0,0,0,0,0,0,0,0,0
SAN DIEGO,Mar 2014,DCH,2014,CHILD DEVELOPMENT ASSOC INC ,DCH_BREAKFAST,26,0,0,0,0,0,0,0,0,0
SAN DIEGO,Mar 2014,DCH,2014,CHILD DEVELOPMENT ASSOC INC ,DCH_LUNCH,26,0,0,0,0,125227,0,0,125227,4816.4231
SAN DIEGO,Mar 2014,DCH,2014,CHILD DEVELOPMENT ASSOC INC ,DCH_LUNCH,,0,0,0,0,0,417,14129,14546,0
SAN DIEGO,Mar 2014,DCH,2014,CHILD DEVELOPMENT ASSOC INC ,DCH_LUNCH,26,0,0,0,0,0,0,0,0,0
SAN DIEGO,Mar 2014,DCH,2014,CHILD DEVELOPMENT ASSOC INC ,DCH_LUNCH,26,0,0,0,0,0,0,0,0,0
SAN DIEGO,Mar 2014,DCH,2014,CHILD DEVELOPMENT ASSOC INC ,DCH_LUNCH,26,0,0,0,0,0,0,0,0,0
SAN DIEGO,Mar 2014,DCH,2014,CHILD DEVELOPMENT ASSOC INC ,DCH_SNACK_AM,26,0,0,0,0,57586,0,0,57586,2214.8462
SAN DIEGO,Mar 2014,DCH,2014,CHILD DEVELOPMENT ASSOC INC ,DCH_SNACK_AM,,0,0,0,0,0,307,7381,7688,0
SAN DIEGO,Mar 2014,DCH,2014,CHILD DEVELOPMENT ASSOC INC ,DCH_SNACK_AM,26,0,0,0,0,0,0,0,0,0
SAN DIEGO,Mar 2014,DCH,2014,CHILD DEVELOPMENT ASSOC INC ,DCH_SNACK_AM,26,0,0,0,0,0,0,0,0,0
SAN DIEGO,Mar 2014,DCH,2014,CHILD DEVELOPMENT ASSOC INC ,DCH_SNACK_AM,26,0,0,0,0,0,0,0,0,0
SAN DIEGO,Mar 2014,DCH,2014,CHILD DEVELOPMENT ASSOC INC ,DCH_SNACK_NT,26,0,0,0,0,11300,0,0,11300,434.6154
SAN DIEGO,Mar 2014,DCH,2014,CHILD DEVELOPMENT ASSOC INC ,DCH_SNACK_NT,,0,0,0,0,0,259,146,405,0
SAN DIEGO,Mar 2014,DCH,2014,CHILD DEVELOPMENT ASSOC INC ,DCH_SNACK_NT,26,0,0,0,0,0,0,0,0,0
SAN DIEGO,Mar 2014,DCH,2014,CHILD DEVELOPMENT ASSOC INC ,DCH_SNACK_NT,26,0,0,0,0,0,0,0,0,0
SAN DIEGO,Mar 2014,DCH,2014,CHILD DEVELOPMENT ASSOC INC ,DCH_SNACK_NT,26,0,0,0,0,0,0,0,0,0
SAN DIEGO,Mar 2014,DCH,2014,CHILD DEVELOPMENT ASSOC INC ,DCH_SNACK_PM,26,0,0,0,0,114670,0,0,114670,4410.3846
SAN DIEGO,Mar 2014,DCH,2014,CHILD DEVELOPMENT ASSOC INC ,DCH_SNACK_PM,,0,0,0,0,0,599,9950,10549,0
SAN DIEGO,Mar 2014,DCH,2014,CHILD DEVELOPMENT ASSOC INC ,DCH_SNACK_PM,26,0,0,0,0,0,0,0,0,0
SAN DIEGO,Mar 2014,DCH,2014,CHILD DEVELOPMENT ASSOC INC ,DCH_SNACK_PM,26,0,0,0,0,0,0,0,0,0
SAN DIEGO,Mar 2014,DCH,2014,CHILD DEVELOPMENT ASSOC INC ,DCH_SNACK_PM,26,0,0,0,0,0,0,0,0,0
SAN DIEGO,Mar 2014,DCH,2014,CHILD DEVELOPMENT ASSOC INC ,DCH_SUPPER,26,0,0,0,0,83272,0,0,83272,3202.7692
SAN DIEGO,Mar 2014,DCH,2014,CHILD DEVELOPMENT ASSOC INC ,DCH_SUPPER,,0,0,0,0,0,517,5498,6015,0
SAN DIEGO,Mar 2014,DCH,2014,CHILD DEVELOPMENT ASSOC INC ,DCH_SUPPER,26,0,0,0,0,0,0,0,0,0
SAN DIEGO,Mar 2014,DCH,2014,CHILD DEVELOPMENT ASSOC INC ,DCH_SUPPER,26,0,0,0,0,0,0,0,0,0
SAN DIEGO,Mar 2014,DCH,2014,CHILD DEVELOPMENT ASSOC INC ,DCH_SUPPER,26,0,0,0,0,0,0,0,0,0
SAN DIEGO,Apr 2014,CACF,2014,CHILD DEVELOPMENT ASSOC INC ,CHILD_BREAKFAST,22,225,103,47,375,2845,1302,594,4741,215.5
SAN DIEGO,Apr 2014,CACF,2014,CHILD DEVELOPMENT ASSOC INC ,CHILD_LUNCH,22,225,103,47,375,3766,1724,787,6277,285.3182
SAN DIEGO,Apr 2014,CACF,2014,CHILD DEVELOPMENT ASSOC INC ,CHILD_SNACK_AM,22,225,103,47,375,170,78,36,284,12.9091
SAN DIEGO,Apr 2014,CACF,2014,CHILD DEVELOPMENT ASSOC INC ,CHILD_SNACK_PM,22,225,103,47,375,3324,1522,694,5540,251.8182
SAN DIEGO,Apr 2014,DCH,2014,CHILD DEVELOPMENT ASSOC INC ,DCH_BREAKFAST,26,0,0,0,0,107208,0,0,107208,4123.3846
SAN DIEGO,Apr 2014,DCH,2014,CHILD DEVELOPMENT ASSOC INC ,DCH_BREAKFAST,,0,0,0,0,0,435,9696,10131,0
SAN DIEGO,Apr 2014,DCH,2014,CHILD DEVELOPMENT ASSOC INC ,DCH_BREAKFAST,26,0,0,0,0,0,0,0,0,0
SAN DIEGO,Apr 2014,DCH,2014,CHILD DEVELOPMENT ASSOC INC ,DCH_BREAKFAST,26,0,0,0,0,0,0,0,0,0
SAN DIEGO,Apr 2014,DCH,2014,CHILD DEVELOPMENT ASSOC INC ,DCH_BREAKFAST,26,0,0,0,0,0,0,0,0,0
SAN DIEGO,Apr 2014,DCH,2014,CHILD DEVELOPMENT ASSOC INC ,DCH_LUNCH,26,0,0,0,0,132707,0,0,132707,5104.1154
SAN DIEGO,Apr 2014,DCH,2014,CHILD DEVELOPMENT ASSOC INC ,DCH_LUNCH,,0,0,0,0,0,466,15177,15643,0
SAN DIEGO,Apr 2014,DCH,2014,CHILD DEVELOPMENT ASSOC INC ,DCH_LUNCH,26,0,0,0,0,0,0,0,0,0
SAN DIEGO,Apr 2014,DCH,2014,CHILD DEVELOPMENT ASSOC INC ,DCH_LUNCH,26,0,0,0,0,0,0,0,0,0
SAN DIEGO,Apr 2014,DCH,2014,CHILD DEVELOPMENT ASSOC INC ,DCH_LUNCH,26,0,0,0,0,0,0,0,0,0
SAN DIEGO,Apr 2014,DCH,2014,CHILD DEVELOPMENT ASSOC INC ,DCH_SNACK_AM,26,0,0,0,0,60988,0,0,60988,2345.6923
SAN DIEGO,Apr 2014,DCH,2014,CHILD DEVELOPMENT ASSOC INC ,DCH_SNACK_AM,,0,0,0,0,0,336,7888,8224,0
SAN DIEGO,Apr 2014,DCH,2014,CHILD DEVELOPMENT ASSOC INC ,DCH_SNACK_AM,26,0,0,0,0,0,0,0,0,0
SAN DIEGO,Apr 2014,DCH,2014,CHILD DEVELOPMENT ASSOC INC ,DCH_SNACK_AM,26,0,0,0,0,0,0,0,0,0
SAN DIEGO,Apr 2014,DCH,2014,CHILD DEVELOPMENT ASSOC INC ,DCH_SNACK_AM,26,0,0,0,0,0,0,0,0,0
SAN DIEGO,Apr 2014,DCH,2014,CHILD DEVELOPMENT ASSOC INC ,DCH_SNACK_NT,26,0,0,0,0,10833,0,0,10833,416.6538
SAN DIEGO,Apr 2014,DCH,2014,CHILD DEVELOPMENT ASSOC INC ,DCH_SNACK_NT,,0,0,0,0,0,246,156,402,0
SAN DIEGO,Apr 2014,DCH,2014,CHILD DEVELOPMENT ASSOC INC ,DCH_SNACK_NT,26,0,0,0,0,0,0,0,0,0
SAN DIEGO,Apr 2014,DCH,2014,CHILD DEVELOPMENT ASSOC INC ,DCH_SNACK_NT,26,0,0,0,0,0,0,0,0,0
SAN DIEGO,Apr 2014,DCH,2014,CHILD DEVELOPMENT ASSOC INC ,DCH_SNACK_NT,26,0,0,0,0,0,0,0,0,0
SAN DIEGO,Apr 2014,DCH,2014,CHILD DEVELOPMENT ASSOC INC ,DCH_SNACK_PM,26,0,0,0,0,116692,0,0,116692,4488.1538
SAN DIEGO,Apr 2014,DCH,2014,CHILD DEVELOPMENT ASSOC INC ,DCH_SNACK_PM,,0,0,0,0,0,553,10564,11117,0
SAN DIEGO,Apr 2014,DCH,2014,CHILD DEVELOPMENT ASSOC INC ,DCH_SNACK_PM,26,0,0,0,0,0,0,0,0,0
SAN DIEGO,Apr 2014,DCH,2014,CHILD DEVELOPMENT ASSOC INC ,DCH_SNACK_PM,26,0,0,0,0,0,0,0,0,0
SAN DIEGO,Apr 2014,DCH,2014,CHILD DEVELOPMENT ASSOC INC ,DCH_SNACK_PM,26,0,0,0,0,0,0,0,0,0
SAN DIEGO,Apr 2014,DCH,2014,CHILD DEVELOPMENT ASSOC INC ,DCH_SUPPER,26,0,0,0,0,84297,0,0,84297,3242.1923
SAN DIEGO,Apr 2014,DCH,2014,CHILD DEVELOPMENT ASSOC INC ,DCH_SUPPER,,0,0,0,0,0,543,5697,6240,0
SAN DIEGO,Apr 2014,DCH,2014,CHILD DEVELOPMENT ASSOC INC ,DCH_SUPPER,26,0,0,0,0,0,0,0,0,0
SAN DIEGO,Apr 2014,DCH,2014,CHILD DEVELOPMENT ASSOC INC ,DCH_SUPPER,26,0,0,0,0,0,0,0,0,0
SAN DIEGO,Apr 2014,DCH,2014,CHILD DEVELOPMENT ASSOC INC ,DCH_SUPPER,26,0,0,0,0,0,0,0,0,0
SAN DIEGO,May 2014,CACF,2014,CHILD DEVELOPMENT ASSOC INC ,CHILD_BREAKFAST,21,225,103,47,375,2806,1285,586,4677,222.7143
SAN DIEGO,May 2014,CACF,2014,CHILD DEVELOPMENT ASSOC INC ,CHILD_LUNCH,21,225,103,47,375,3773,1728,788,6289,299.4762
SAN DIEGO,May 2014,CACF,2014,CHILD DEVELOPMENT ASSOC INC ,CHILD_SNACK_AM,21,225,103,47,375,158,73,33,264,12.5714
SAN DIEGO,May 2014,CACF,2014,CHILD DEVELOPMENT ASSOC INC ,CHILD_SNACK_PM,21,225,103,47,375,3263,1494,682,5439,259
SAN DIEGO,May 2014,DCH,2014,CHILD DEVELOPMENT ASSOC INC ,DCH_BREAKFAST,26,0,0,0,0,105386,0,0,105386,4053.3077
SAN DIEGO,May 2014,DCH,2014,CHILD DEVELOPMENT ASSOC INC ,DCH_BREAKFAST,,0,0,0,0,0,378,9336,9714,0
SAN DIEGO,May 2014,DCH,2014,CHILD DEVELOPMENT ASSOC INC ,DCH_BREAKFAST,26,0,0,0,0,0,0,0,0,0
SAN DIEGO,May 2014,DCH,2014,CHILD DEVELOPMENT ASSOC INC ,DCH_BREAKFAST,26,0,0,0,0,0,0,0,0,0
SAN DIEGO,May 2014,DCH,2014,CHILD DEVELOPMENT ASSOC INC ,DCH_BREAKFAST,26,0,0,0,0,0,0,0,0,0
SAN DIEGO,May 2014,DCH,2014,CHILD DEVELOPMENT ASSOC INC ,DCH_LUNCH,26,0,0,0,0,122238,0,0,122238,4701.4615
SAN DIEGO,May 2014,DCH,2014,CHILD DEVELOPMENT ASSOC INC ,DCH_LUNCH,,0,0,0,0,0,332,14567,14899,0
SAN DIEGO,May 2014,DCH,2014,CHILD DEVELOPMENT ASSOC INC ,DCH_LUNCH,26,0,0,0,0,0,0,0,0,0
SAN DIEGO,May 2014,DCH,2014,CHILD DEVELOPMENT ASSOC INC ,DCH_LUNCH,26,0,0,0,0,0,0,0,0,0
SAN DIEGO,May 2014,DCH,2014,CHILD DEVELOPMENT ASSOC INC ,DCH_LUNCH,26,0,0,0,0,0,0,0,0,0
SAN DIEGO,May 2014,DCH,2014,CHILD DEVELOPMENT ASSOC INC ,DCH_SNACK_AM,26,0,0,0,0,57113,0,0,57113,2196.6538
SAN DIEGO,May 2014,DCH,2014,CHILD DEVELOPMENT ASSOC INC ,DCH_SNACK_AM,,0,0,0,0,0,235,7730,7965,0
SAN DIEGO,May 2014,DCH,2014,CHILD DEVELOPMENT ASSOC INC ,DCH_SNACK_AM,26,0,0,0,0,0,0,0,0,0
SAN DIEGO,May 2014,DCH,2014,CHILD DEVELOPMENT ASSOC INC ,DCH_SNACK_AM,26,0,0,0,0,0,0,0,0,0
SAN DIEGO,May 2014,DCH,2014,CHILD DEVELOPMENT ASSOC INC ,DCH_SNACK_AM,26,0,0,0,0,0,0,0,0,0
SAN DIEGO,May 2014,DCH,2014,CHILD DEVELOPMENT ASSOC INC ,DCH_SNACK_NT,26,0,0,0,0,11066,0,0,11066,425.6154
SAN DIEGO,May 2014,DCH,2014,CHILD DEVELOPMENT ASSOC INC ,DCH_SNACK_NT,,0,0,0,0,0,242,166,408,0
SAN DIEGO,May 2014,DCH,2014,CHILD DEVELOPMENT ASSOC INC ,DCH_SNACK_NT,26,0,0,0,0,0,0,0,0,0
SAN DIEGO,May 2014,DCH,2014,CHILD DEVELOPMENT ASSOC INC ,DCH_SNACK_NT,26,0,0,0,0,0,0,0,0,0
SAN DIEGO,May 2014,DCH,2014,CHILD DEVELOPMENT ASSOC INC ,DCH_SNACK_NT,26,0,0,0,0,0,0,0,0,0
SAN DIEGO,May 2014,DCH,2014,CHILD DEVELOPMENT ASSOC INC ,DCH_SNACK_PM,26,0,0,0,0,114221,0,0,114221,4393.1154
SAN DIEGO,May 2014,DCH,2014,CHILD DEVELOPMENT ASSOC INC ,DCH_SNACK_PM,,0,0,0,0,0,585,10268,10853,0
SAN DIEGO,May 2014,DCH,2014,CHILD DEVELOPMENT ASSOC INC ,DCH_SNACK_PM,26,0,0,0,0,0,0,0,0,0
SAN DIEGO,May 2014,DCH,2014,CHILD DEVELOPMENT ASSOC INC ,DCH_SNACK_PM,26,0,0,0,0,0,0,0,0,0
SAN DIEGO,May 2014,DCH,2014,CHILD DEVELOPMENT ASSOC INC ,DCH_SNACK_PM,26,0,0,0,0,0,0,0,0,0
SAN DIEGO,May 2014,DCH,2014,CHILD DEVELOPMENT ASSOC INC ,DCH_SUPPER,26,0,0,0,0,83474,0,0,83474,3210.5385
SAN DIEGO,May 2014,DCH,2014,CHILD DEVELOPMENT ASSOC INC ,DCH_SUPPER,,0,0,0,0,0,554,5794,6348,0
SAN DIEGO,May 2014,DCH,2014,CHILD DEVELOPMENT ASSOC INC ,DCH_SUPPER,26,0,0,0,0,0,0,0,0,0
SAN DIEGO,May 2014,DCH,2014,CHILD DEVELOPMENT ASSOC INC ,DCH_SUPPER,26,0,0,0,0,0,0,0,0,0
SAN DIEGO,May 2014,DCH,2014,CHILD DEVELOPMENT ASSOC INC ,DCH_SUPPER,26,0,0,0,0,0,0,0,0,0
SAN DIEGO,Jun 2014,CACF,2014,CHILD DEVELOPMENT ASSOC INC ,CHILD_BREAKFAST,21,225,103,47,375,2465,1128,515,4108,195.619
SAN DIEGO,Jun 2014,CACF,2014,CHILD DEVELOPMENT ASSOC INC ,CHILD_LUNCH,21,225,103,47,375,3382,1548,706,5636,268.381
SAN DIEGO,Jun 2014,CACF,2014,CHILD DEVELOPMENT ASSOC INC ,CHILD_SNACK_AM,21,225,103,47,375,154,71,32,257,12.2381
SAN DIEGO,Jun 2014,CACF,2014,CHILD DEVELOPMENT ASSOC INC ,CHILD_SNACK_PM,21,225,103,47,375,3010,1378,628,5016,238.8571
SAN DIEGO,Jun 2014,DCH,2014,CHILD DEVELOPMENT ASSOC INC ,DCH_BREAKFAST,25,0,0,0,0,96533,0,0,96533,3861.32
SAN DIEGO,Jun 2014,DCH,2014,CHILD DEVELOPMENT ASSOC INC ,DCH_BREAKFAST,,0,0,0,0,0,587,8716,9303,0
SAN DIEGO,Jun 2014,DCH,2014,CHILD DEVELOPMENT ASSOC INC ,DCH_BREAKFAST,25,0,0,0,0,0,0,0,0,0
SAN DIEGO,Jun 2014,DCH,2014,CHILD DEVELOPMENT ASSOC INC ,DCH_BREAKFAST,25,0,0,0,0,0,0,0,0,0
SAN DIEGO,Jun 2014,DCH,2014,CHILD DEVELOPMENT ASSOC INC ,DCH_BREAKFAST,25,0,0,0,0,0,0,0,0,0
SAN DIEGO,Jun 2014,DCH,2014,CHILD DEVELOPMENT ASSOC INC ,DCH_LUNCH,25,0,0,0,0,142882,0,0,142882,5715.28
SAN DIEGO,Jun 2014,DCH,2014,CHILD DEVELOPMENT ASSOC INC ,DCH_LUNCH,,0,0,0,0,0,721,14839,15560,0
SAN DIEGO,Jun 2014,DCH,2014,CHILD DEVELOPMENT ASSOC INC ,DCH_LUNCH,25,0,0,0,0,0,0,0,0,0
SAN DIEGO,Jun 2014,DCH,2014,CHILD DEVELOPMENT ASSOC INC ,DCH_LUNCH,25,0,0,0,0,0,0,0,0,0
SAN DIEGO,Jun 2014,DCH,2014,CHILD DEVELOPMENT ASSOC INC ,DCH_LUNCH,25,0,0,0,0,0,0,0,0,0
SAN DIEGO,Jun 2014,DCH,2014,CHILD DEVELOPMENT ASSOC INC ,DCH_SNACK_AM,25,0,0,0,0,62723,0,0,62723,2508.92
SAN DIEGO,Jun 2014,DCH,2014,CHILD DEVELOPMENT ASSOC INC ,DCH_SNACK_AM,,0,0,0,0,0,596,7782,8378,0
SAN DIEGO,Jun 2014,DCH,2014,CHILD DEVELOPMENT ASSOC INC ,DCH_SNACK_AM,25,0,0,0,0,0,0,0,0,0
SAN DIEGO,Jun 2014,DCH,2014,CHILD DEVELOPMENT ASSOC INC ,DCH_SNACK_AM,25,0,0,0,0,0,0,0,0,0
SAN DIEGO,Jun 2014,DCH,2014,CHILD DEVELOPMENT ASSOC INC ,DCH_SNACK_AM,25,0,0,0,0,0,0,0,0,0
SAN DIEGO,Jun 2014,DCH,2014,CHILD DEVELOPMENT ASSOC INC ,DCH_SNACK_NT,25,0,0,0,0,9164,0,0,9164,366.56
SAN DIEGO,Jun 2014,DCH,2014,CHILD DEVELOPMENT ASSOC INC ,DCH_SNACK_NT,,0,0,0,0,0,192,111,303,0
SAN DIEGO,Jun 2014,DCH,2014,CHILD DEVELOPMENT ASSOC INC ,DCH_SNACK_NT,25,0,0,0,0,0,0,0,0,0
SAN DIEGO,Jun 2014,DCH,2014,CHILD DEVELOPMENT ASSOC INC ,DCH_SNACK_NT,25,0,0,0,0,0,0,0,0,0
SAN DIEGO,Jun 2014,DCH,2014,CHILD DEVELOPMENT ASSOC INC ,DCH_SNACK_NT,25,0,0,0,0,0,0,0,0,0
SAN DIEGO,Jun 2014,DCH,2014,CHILD DEVELOPMENT ASSOC INC ,DCH_SNACK_PM,25,0,0,0,0,108948,0,0,108948,4357.92
SAN DIEGO,Jun 2014,DCH,2014,CHILD DEVELOPMENT ASSOC INC ,DCH_SNACK_PM,,0,0,0,0,0,440,9360,9800,0
SAN DIEGO,Jun 2014,DCH,2014,CHILD DEVELOPMENT ASSOC INC ,DCH_SNACK_PM,25,0,0,0,0,0,0,0,0,0
SAN DIEGO,Jun 2014,DCH,2014,CHILD DEVELOPMENT ASSOC INC ,DCH_SNACK_PM,25,0,0,0,0,0,0,0,0,0
SAN DIEGO,Jun 2014,DCH,2014,CHILD DEVELOPMENT ASSOC INC ,DCH_SNACK_PM,25,0,0,0,0,0,0,0,0,0
SAN DIEGO,Jun 2014,DCH,2014,CHILD DEVELOPMENT ASSOC INC ,DCH_SUPPER,25,0,0,0,0,79472,0,0,79472,3178.88
SAN DIEGO,Jun 2014,DCH,2014,CHILD DEVELOPMENT ASSOC INC ,DCH_SUPPER,,0,0,0,0,0,478,5586,6064,0
SAN DIEGO,Jun 2014,DCH,2014,CHILD DEVELOPMENT ASSOC INC ,DCH_SUPPER,25,0,0,0,0,0,0,0,0,0
SAN DIEGO,Jun 2014,DCH,2014,CHILD DEVELOPMENT ASSOC INC ,DCH_SUPPER,25,0,0,0,0,0,0,0,0,0
SAN DIEGO,Jun 2014,DCH,2014,CHILD DEVELOPMENT ASSOC INC ,DCH_SUPPER,25,0,0,0,0,0,0,0,0,0
SAN DIEGO,Jul 2014,CACF,2014,CHILD DEVELOPMENT ASSOC INC ,CHILD_BREAKFAST,22,225,103,47,375,2499,1144,522,4165,189.3182
SAN DIEGO,Jul 2014,CACF,2014,CHILD DEVELOPMENT ASSOC INC ,CHILD_LUNCH,22,225,103,47,375,3562,1631,743,5936,269.8182
SAN DIEGO,Jul 2014,CACF,2014,CHILD DEVELOPMENT ASSOC INC ,CHILD_SNACK_AM,22,225,103,47,375,143,66,30,239,10.8636
SAN DIEGO,Jul 2014,CACF,2014,CHILD DEVELOPMENT ASSOC INC ,CHILD_SNACK_PM,22,225,103,47,375,3061,1402,639,5102,231.9091
SAN DIEGO,Jul 2014,DCH,2014,CHILD DEVELOPMENT ASSOC INC ,DCH_BREAKFAST,26,0,0,0,0,94854,0,0,94854,3648.2308
SAN DIEGO,Jul 2014,DCH,2014,CHILD DEVELOPMENT ASSOC INC ,DCH_BREAKFAST,,0,0,0,0,0,106,7216,7322,0
SAN DIEGO,Jul 2014,DCH,2014,CHILD DEVELOPMENT ASSOC INC ,DCH_BREAKFAST,26,0,0,0,0,0,0,0,0,0
SAN DIEGO,Jul 2014,DCH,2014,CHILD DEVELOPMENT ASSOC INC ,DCH_BREAKFAST,22,0,0,0,0,0,0,0,0,0
SAN DIEGO,Jul 2014,DCH,2014,CHILD DEVELOPMENT ASSOC INC ,DCH_LUNCH,26,0,0,0,0,157678,0,0,157678,6064.5385
SAN DIEGO,Jul 2014,DCH,2014,CHILD DEVELOPMENT ASSOC INC ,DCH_LUNCH,,0,0,0,0,0,308,13247,13555,0
SAN DIEGO,Jul 2014,DCH,2014,CHILD DEVELOPMENT ASSOC INC ,DCH_LUNCH,26,0,0,0,0,0,0,0,0,0
SAN DIEGO,Jul 2014,DCH,2014,CHILD DEVELOPMENT ASSOC INC ,DCH_LUNCH,22,0,0,0,0,0,0,0,0,0
SAN DIEGO,Jul 2014,DCH,2014,CHILD DEVELOPMENT ASSOC INC ,DCH_SNACK_AM,26,0,0,0,0,68544,0,0,68544,2636.3077
SAN DIEGO,Jul 2014,DCH,2014,CHILD DEVELOPMENT ASSOC INC ,DCH_SNACK_AM,,0,0,0,0,0,218,7163,7381,0
SAN DIEGO,Jul 2014,DCH,2014,CHILD DEVELOPMENT ASSOC INC ,DCH_SNACK_AM,26,0,0,0,0,0,0,0,0,0
SAN DIEGO,Jul 2014,DCH,2014,CHILD DEVELOPMENT ASSOC INC ,DCH_SNACK_AM,22,0,0,0,0,0,0,0,0,0
SAN DIEGO,Jul 2014,DCH,2014,CHILD DEVELOPMENT ASSOC INC ,DCH_SNACK_NT,26,0,0,0,0,8346,0,0,8346,321
SAN DIEGO,Jul 2014,DCH,2014,CHILD DEVELOPMENT ASSOC INC ,DCH_SNACK_NT,,0,0,0,0,0,0,10,10,0
SAN DIEGO,Jul 2014,DCH,2014,CHILD DEVELOPMENT ASSOC INC ,DCH_SNACK_NT,26,0,0,0,0,0,0,0,0,0
SAN DIEGO,Jul 2014,DCH,2014,CHILD DEVELOPMENT ASSOC INC ,DCH_SNACK_NT,22,0,0,0,0,0,0,0,0,0
SAN DIEGO,Jul 2014,DCH,2014,CHILD DEVELOPMENT ASSOC INC ,DCH_SNACK_PM,26,0,0,0,0,109519,0,0,109519,4212.2692
SAN DIEGO,Jul 2014,DCH,2014,CHILD DEVELOPMENT ASSOC INC ,DCH_SNACK_PM,,0,0,0,0,0,109,7765,7874,0
SAN DIEGO,Jul 2014,DCH,2014,CHILD DEVELOPMENT ASSOC INC ,DCH_SNACK_PM,26,0,0,0,0,0,0,0,0,0
SAN DIEGO,Jul 2014,DCH,2014,CHILD DEVELOPMENT ASSOC INC ,DCH_SNACK_PM,22,0,0,0,0,0,0,0,0,0
SAN DIEGO,Jul 2014,DCH,2014,CHILD DEVELOPMENT ASSOC INC ,DCH_SUPPER,26,0,0,0,0,80845,0,0,80845,3109.4231
SAN DIEGO,Jul 2014,DCH,2014,CHILD DEVELOPMENT ASSOC INC ,DCH_SUPPER,,0,0,0,0,0,190,4771,4961,0
SAN DIEGO,Jul 2014,DCH,2014,CHILD DEVELOPMENT ASSOC INC ,DCH_SUPPER,26,0,0,0,0,0,0,0,0,0
SAN DIEGO,Jul 2014,DCH,2014,CHILD DEVELOPMENT ASSOC INC ,DCH_SUPPER,22,0,0,0,0,0,0,0,0,0
SAN DIEGO,Aug 2014,CACF,2014,CHILD DEVELOPMENT ASSOC INC ,CHILD_BREAKFAST,21,225,103,47,375,2371,1085,495,3951,188.1429
SAN DIEGO,Aug 2014,CACF,2014,CHILD DEVELOPMENT ASSOC INC ,CHILD_LUNCH,21,225,103,47,375,3375,1545,705,5625,267.8571
SAN DIEGO,Aug 2014,CACF,2014,CHILD DEVELOPMENT ASSOC INC ,CHILD_SNACK_AM,21,225,103,47,375,119,54,25,198,9.4286
SAN DIEGO,Aug 2014,CACF,2014,CHILD DEVELOPMENT ASSOC INC ,CHILD_SNACK_PM,21,225,103,47,375,2887,1322,603,4812,229.1429
SAN DIEGO,Aug 2014,DCH,2014,CHILD DEVELOPMENT ASSOC INC ,DCH_BREAKFAST,26,0,0,0,0,94605,0,0,94605,3638.6538
SAN DIEGO,Aug 2014,DCH,2014,CHILD DEVELOPMENT ASSOC INC ,DCH_BREAKFAST,,0,0,0,0,0,184,6752,6936,0
SAN DIEGO,Aug 2014,DCH,2014,CHILD DEVELOPMENT ASSOC INC ,DCH_BREAKFAST,26,0,0,0,0,0,0,0,0,0
SAN DIEGO,Aug 2014,DCH,2014,CHILD DEVELOPMENT ASSOC INC ,DCH_BREAKFAST,22,0,0,0,0,0,0,0,0,0
SAN DIEGO,Aug 2014,DCH,2014,CHILD DEVELOPMENT ASSOC INC ,DCH_LUNCH,22,0,0,0,0,0,0,0,0,0
SAN DIEGO,Aug 2014,DCH,2014,CHILD DEVELOPMENT ASSOC INC ,DCH_LUNCH,26,0,0,0,0,0,0,0,0,0
SAN DIEGO,Aug 2014,DCH,2014,CHILD DEVELOPMENT ASSOC INC ,DCH_LUNCH,,0,0,0,0,0,252,12343,12595,0
SAN DIEGO,Aug 2014,DCH,2014,CHILD DEVELOPMENT ASSOC INC ,DCH_LUNCH,26,0,0,0,0,133982,0,0,133982,5153.1538
SAN DIEGO,Aug 2014,DCH,2014,CHILD DEVELOPMENT ASSOC INC ,DCH_SNACK_AM,26,0,0,0,0,59417,0,0,59417,2285.2692
SAN DIEGO,Aug 2014,DCH,2014,CHILD DEVELOPMENT ASSOC INC ,DCH_SNACK_AM,,0,0,0,0,0,254,6760,7014,0
SAN DIEGO,Aug 2014,DCH,2014,CHILD DEVELOPMENT ASSOC INC ,DCH_SNACK_AM,26,0,0,0,0,0,0,0,0,0
SAN DIEGO,Aug 2014,DCH,2014,CHILD DEVELOPMENT ASSOC INC ,DCH_SNACK_AM,22,0,0,0,0,0,0,0,0,0
SAN DIEGO,Aug 2014,DCH,2014,CHILD DEVELOPMENT ASSOC INC ,DCH_SNACK_NT,22,0,0,0,0,0,0,0,0,0
SAN DIEGO,Aug 2014,DCH,2014,CHILD DEVELOPMENT ASSOC INC ,DCH_SNACK_NT,26,0,0,0,0,0,0,0,0,0
SAN DIEGO,Aug 2014,DCH,2014,CHILD DEVELOPMENT ASSOC INC ,DCH_SNACK_NT,,0,0,0,0,0,0,26,26,0
SAN DIEGO,Aug 2014,DCH,2014,CHILD DEVELOPMENT ASSOC INC ,DCH_SNACK_NT,26,0,0,0,0,9173,0,0,9173,352.8077
SAN DIEGO,Aug 2014,DCH,2014,CHILD DEVELOPMENT ASSOC INC ,DCH_SNACK_PM,26,0,0,0,0,107655,0,0,107655,4140.5769
SAN DIEGO,Aug 2014,DCH,2014,CHILD DEVELOPMENT ASSOC INC ,DCH_SNACK_PM,,0,0,0,0,0,87,7921,8008,0
SAN DIEGO,Aug 2014,DCH,2014,CHILD DEVELOPMENT ASSOC INC ,DCH_SNACK_PM,26,0,0,0,0,0,0,0,0,0
SAN DIEGO,Aug 2014,DCH,2014,CHILD DEVELOPMENT ASSOC INC ,DCH_SNACK_PM,22,0,0,0,0,0,0,0,0,0
SAN DIEGO,Aug 2014,DCH,2014,CHILD DEVELOPMENT ASSOC INC ,DCH_SUPPER,22,0,0,0,0,0,0,0,0,0
SAN DIEGO,Aug 2014,DCH,2014,CHILD DEVELOPMENT ASSOC INC ,DCH_SUPPER,26,0,0,0,0,0,0,0,0,0
SAN DIEGO,Aug 2014,DCH,2014,CHILD DEVELOPMENT ASSOC INC ,DCH_SUPPER,,0,0,0,0,0,162,5013,5175,0
SAN DIEGO,Aug 2014,DCH,2014,CHILD DEVELOPMENT ASSOC INC ,DCH_SUPPER,26,0,0,0,0,80711,0,0,80711,3104.2692
SAN DIEGO,Sep 2014,CACF,2014,CHILD DEVELOPMENT ASSOC INC ,CHILD_BREAKFAST,21,225,103,47,375,2565,1174,536,4275,203.5714
SAN DIEGO,Sep 2014,CACF,2014,CHILD DEVELOPMENT ASSOC INC ,CHILD_LUNCH,21,225,103,47,375,3608,1652,753,6013,286.3333
SAN DIEGO,Sep 2014,CACF,2014,CHILD DEVELOPMENT ASSOC INC ,CHILD_SNACK_AM,21,225,103,47,375,150,69,31,250,11.9048
SAN DIEGO,Sep 2014,CACF,2014,CHILD DEVELOPMENT ASSOC INC ,CHILD_SNACK_PM,21,225,103,47,375,2891,1324,604,4819,229.4762
SAN DIEGO,Sep 2014,DCH,2014,CHILD DEVELOPMENT ASSOC INC ,DCH_BREAKFAST,25,0,0,0,0,99723,0,0,99723,3988.92
SAN DIEGO,Sep 2014,DCH,2014,CHILD DEVELOPMENT ASSOC INC ,DCH_BREAKFAST,,0,0,0,0,0,373,6877,7250,0
SAN DIEGO,Sep 2014,DCH,2014,CHILD DEVELOPMENT ASSOC INC ,DCH_BREAKFAST,20,0,0,0,0,0,0,0,0,0
SAN DIEGO,Sep 2014,DCH,2014,CHILD DEVELOPMENT ASSOC INC ,DCH_BREAKFAST,25,0,0,0,0,0,0,0,0,0
SAN DIEGO,Sep 2014,DCH,2014,CHILD DEVELOPMENT ASSOC INC ,DCH_BREAKFAST,21,0,0,0,0,0,0,0,0,0
SAN DIEGO,Sep 2014,DCH,2014,CHILD DEVELOPMENT ASSOC INC ,DCH_LUNCH,21,0,0,0,0,0,0,0,0,0
SAN DIEGO,Sep 2014,DCH,2014,CHILD DEVELOPMENT ASSOC INC ,DCH_LUNCH,25,0,0,0,0,0,0,0,0,0
SAN DIEGO,Sep 2014,DCH,2014,CHILD DEVELOPMENT ASSOC INC ,DCH_LUNCH,20,0,0,0,0,0,0,0,0,0
SAN DIEGO,Sep 2014,DCH,2014,CHILD DEVELOPMENT ASSOC INC ,DCH_LUNCH,,0,0,0,0,0,328,11325,11653,0
SAN DIEGO,Sep 2014,DCH,2014,CHILD DEVELOPMENT ASSOC INC ,DCH_LUNCH,25,0,0,0,0,111618,0,0,111618,4464.72
SAN DIEGO,Sep 2014,DCH,2014,CHILD DEVELOPMENT ASSOC INC ,DCH_SNACK_AM,25,0,0,0,0,50318,0,0,50318,2012.72
SAN DIEGO,Sep 2014,DCH,2014,CHILD DEVELOPMENT ASSOC INC ,DCH_SNACK_AM,,0,0,0,0,0,313,6418,6731,0
SAN DIEGO,Sep 2014,DCH,2014,CHILD DEVELOPMENT ASSOC INC ,DCH_SNACK_AM,20,0,0,0,0,0,0,0,0,0
SAN DIEGO,Sep 2014,DCH,2014,CHILD DEVELOPMENT ASSOC INC ,DCH_SNACK_AM,25,0,0,0,0,0,0,0,0,0
SAN DIEGO,Sep 2014,DCH,2014,CHILD DEVELOPMENT ASSOC INC ,DCH_SNACK_AM,21,0,0,0,0,0,0,0,0,0
SAN DIEGO,Sep 2014,DCH,2014,CHILD DEVELOPMENT ASSOC INC ,DCH_SNACK_NT,21,0,0,0,0,0,0,0,0,0
SAN DIEGO,Sep 2014,DCH,2014,CHILD DEVELOPMENT ASSOC INC ,DCH_SNACK_NT,25,0,0,0,0,0,0,0,0,0
SAN DIEGO,Sep 2014,DCH,2014,CHILD DEVELOPMENT ASSOC INC ,DCH_SNACK_NT,20,0,0,0,0,0,0,0,0,0
SAN DIEGO,Sep 2014,DCH,2014,CHILD DEVELOPMENT ASSOC INC ,DCH_SNACK_NT,,0,0,0,0,0,0,150,150,0
SAN DIEGO,Sep 2014,DCH,2014,CHILD DEVELOPMENT ASSOC INC ,DCH_SNACK_NT,25,0,0,0,0,12252,0,0,12252,490.08
SAN DIEGO,Sep 2014,DCH,2014,CHILD DEVELOPMENT ASSOC INC ,DCH_SNACK_PM,25,0,0,0,0,113710,0,0,113710,4548.4
SAN DIEGO,Sep 2014,DCH,2014,CHILD DEVELOPMENT ASSOC INC ,DCH_SNACK_PM,,0,0,0,0,0,214,7969,8183,0
SAN DIEGO,Sep 2014,DCH,2014,CHILD DEVELOPMENT ASSOC INC ,DCH_SNACK_PM,20,0,0,0,0,0,0,0,0,0
SAN DIEGO,Sep 2014,DCH,2014,CHILD DEVELOPMENT ASSOC INC ,DCH_SNACK_PM,25,0,0,0,0,0,0,0,0,0
SAN DIEGO,Sep 2014,DCH,2014,CHILD DEVELOPMENT ASSOC INC ,DCH_SNACK_PM,21,0,0,0,0,0,0,0,0,0
SAN DIEGO,Sep 2014,DCH,2014,CHILD DEVELOPMENT ASSOC INC ,DCH_SUPPER,21,0,0,0,0,0,0,0,0,0
SAN DIEGO,Sep 2014,DCH,2014,CHILD DEVELOPMENT ASSOC INC ,DCH_SUPPER,25,0,0,0,0,0,0,0,0,0
SAN DIEGO,Sep 2014,DCH,2014,CHILD DEVELOPMENT ASSOC INC ,DCH_SUPPER,20,0,0,0,0,0,0,0,0,0
SAN DIEGO,Sep 2014,DCH,2014,CHILD DEVELOPMENT ASSOC INC ,DCH_SUPPER,,0,0,0,0,0,340,4702,5042,0
SAN DIEGO,Sep 2014,DCH,2014,CHILD DEVELOPMENT ASSOC INC ,DCH_SUPPER,25,0,0,0,0,84994,0,0,84994,3399.76
SAN DIEGO,Oct 2013,DCH,2014,CHILD NUTRITION PROGRAM OF SOUTHERN CALIFORNIA INC ,DCH_BREAKFAST,23,0,0,0,0,80891,0,0,80891,3517
SAN DIEGO,Oct 2013,DCH,2014,CHILD NUTRITION PROGRAM OF SOUTHERN CALIFORNIA INC ,DCH_BREAKFAST,,0,0,0,0,0,466,16870,17336,0
SAN DIEGO,Oct 2013,DCH,2014,CHILD NUTRITION PROGRAM OF SOUTHERN CALIFORNIA INC ,DCH_BREAKFAST,23,0,0,0,0,0,0,0,0,0
SAN DIEGO,Oct 2013,DCH,2014,CHILD NUTRITION PROGRAM OF SOUTHERN CALIFORNIA INC ,DCH_BREAKFAST,23,0,0,0,0,0,0,0,0,0
SAN DIEGO,Oct 2013,DCH,2014,CHILD NUTRITION PROGRAM OF SOUTHERN CALIFORNIA INC ,DCH_BREAKFAST,23,0,0,0,0,0,0,0,0,0
SAN DIEGO,Oct 2013,DCH,2014,CHILD NUTRITION PROGRAM OF SOUTHERN CALIFORNIA INC ,DCH_LUNCH,23,0,0,0,0,83134,0,0,83134,3614.5217
SAN DIEGO,Oct 2013,DCH,2014,CHILD NUTRITION PROGRAM OF SOUTHERN CALIFORNIA INC ,DCH_LUNCH,,0,0,0,0,0,556,22482,23038,0
SAN DIEGO,Oct 2013,DCH,2014,CHILD NUTRITION PROGRAM OF SOUTHERN CALIFORNIA INC ,DCH_LUNCH,23,0,0,0,0,0,0,0,0,0
SAN DIEGO,Oct 2013,DCH,2014,CHILD NUTRITION PROGRAM OF SOUTHERN CALIFORNIA INC ,DCH_LUNCH,23,0,0,0,0,0,0,0,0,0
SAN DIEGO,Oct 2013,DCH,2014,CHILD NUTRITION PROGRAM OF SOUTHERN CALIFORNIA INC ,DCH_LUNCH,23,0,0,0,0,0,0,0,0,0
SAN DIEGO,Oct 2013,DCH,2014,CHILD NUTRITION PROGRAM OF SOUTHERN CALIFORNIA INC ,DCH_SNACK_AM,23,0,0,0,0,33835,0,0,33835,1471.087
SAN DIEGO,Oct 2013,DCH,2014,CHILD NUTRITION PROGRAM OF SOUTHERN CALIFORNIA INC ,DCH_SNACK_AM,,0,0,0,0,0,250,9662,9912,0
SAN DIEGO,Oct 2013,DCH,2014,CHILD NUTRITION PROGRAM OF SOUTHERN CALIFORNIA INC ,DCH_SNACK_AM,23,0,0,0,0,0,0,0,0,0
SAN DIEGO,Oct 2013,DCH,2014,CHILD NUTRITION PROGRAM OF SOUTHERN CALIFORNIA INC ,DCH_SNACK_AM,23,0,0,0,0,0,0,0,0,0
SAN DIEGO,Oct 2013,DCH,2014,CHILD NUTRITION PROGRAM OF SOUTHERN CALIFORNIA INC ,DCH_SNACK_AM,23,0,0,0,0,0,0,0,0,0
SAN DIEGO,Oct 2013,DCH,2014,CHILD NUTRITION PROGRAM OF SOUTHERN CALIFORNIA INC ,DCH_SNACK_NT,23,0,0,0,0,3708,0,0,3708,161.2174
SAN DIEGO,Oct 2013,DCH,2014,CHILD NUTRITION PROGRAM OF SOUTHERN CALIFORNIA INC ,DCH_SNACK_NT,,0,0,0,0,0,95,60,155,0
SAN DIEGO,Oct 2013,DCH,2014,CHILD NUTRITION PROGRAM OF SOUTHERN CALIFORNIA INC ,DCH_SNACK_NT,23,0,0,0,0,0,0,0,0,0
SAN DIEGO,Oct 2013,DCH,2014,CHILD NUTRITION PROGRAM OF SOUTHERN CALIFORNIA INC ,DCH_SNACK_NT,23,0,0,0,0,0,0,0,0,0
SAN DIEGO,Oct 2013,DCH,2014,CHILD NUTRITION PROGRAM OF SOUTHERN CALIFORNIA INC ,DCH_SNACK_NT,23,0,0,0,0,0,0,0,0,0
SAN DIEGO,Oct 2013,DCH,2014,CHILD NUTRITION PROGRAM OF SOUTHERN CALIFORNIA INC ,DCH_SNACK_PM,23,0,0,0,0,84458,0,0,84458,3672.087
SAN DIEGO,Oct 2013,DCH,2014,CHILD NUTRITION PROGRAM OF SOUTHERN CALIFORNIA INC ,DCH_SNACK_PM,,0,0,0,0,0,574,18301,18875,0
SAN DIEGO,Oct 2013,DCH,2014,CHILD NUTRITION PROGRAM OF SOUTHERN CALIFORNIA INC ,DCH_SNACK_PM,23,0,0,0,0,0,0,0,0,0
SAN DIEGO,Oct 2013,DCH,2014,CHILD NUTRITION PROGRAM OF SOUTHERN CALIFORNIA INC ,DCH_SNACK_PM,23,0,0,0,0,0,0,0,0,0
SAN DIEGO,Oct 2013,DCH,2014,CHILD NUTRITION PROGRAM OF SOUTHERN CALIFORNIA INC ,DCH_SNACK_PM,23,0,0,0,0,0,0,0,0,0
SAN DIEGO,Oct 2013,DCH,2014,CHILD NUTRITION PROGRAM OF SOUTHERN CALIFORNIA INC ,DCH_SUPPER,23,0,0,0,0,37164,0,0,37164,1615.8261
SAN DIEGO,Oct 2013,DCH,2014,CHILD NUTRITION PROGRAM OF SOUTHERN CALIFORNIA INC ,DCH_SUPPER,,0,0,0,0,0,588,6104,6692,0
SAN DIEGO,Oct 2013,DCH,2014,CHILD NUTRITION PROGRAM OF SOUTHERN CALIFORNIA INC ,DCH_SUPPER,23,0,0,0,0,0,0,0,0,0
SAN DIEGO,Oct 2013,DCH,2014,CHILD NUTRITION PROGRAM OF SOUTHERN CALIFORNIA INC ,DCH_SUPPER,23,0,0,0,0,0,0,0,0,0
SAN DIEGO,Oct 2013,DCH,2014,CHILD NUTRITION PROGRAM OF SOUTHERN CALIFORNIA INC ,DCH_SUPPER,23,0,0,0,0,0,0,0,0,0
SAN DIEGO,Nov 2013,DCH,2014,CHILD NUTRITION PROGRAM OF SOUTHERN CALIFORNIA INC ,DCH_BREAKFAST,20,0,0,0,0,66394,0,0,66394,3319.7
SAN DIEGO,Nov 2013,DCH,2014,CHILD NUTRITION PROGRAM OF SOUTHERN CALIFORNIA INC ,DCH_BREAKFAST,,0,0,0,0,0,350,13447,13797,0
SAN DIEGO,Nov 2013,DCH,2014,CHILD NUTRITION PROGRAM OF SOUTHERN CALIFORNIA INC ,DCH_BREAKFAST,20,0,0,0,0,0,0,0,0,0
SAN DIEGO,Nov 2013,DCH,2014,CHILD NUTRITION PROGRAM OF SOUTHERN CALIFORNIA INC ,DCH_BREAKFAST,20,0,0,0,0,0,0,0,0,0
SAN DIEGO,Nov 2013,DCH,2014,CHILD NUTRITION PROGRAM OF SOUTHERN CALIFORNIA INC ,DCH_BREAKFAST,20,0,0,0,0,0,0,0,0,0
SAN DIEGO,Nov 2013,DCH,2014,CHILD NUTRITION PROGRAM OF SOUTHERN CALIFORNIA INC ,DCH_LUNCH,20,0,0,0,0,72332,0,0,72332,3616.6
SAN DIEGO,Nov 2013,DCH,2014,CHILD NUTRITION PROGRAM OF SOUTHERN CALIFORNIA INC ,DCH_LUNCH,,0,0,0,0,0,569,18345,18914,0
SAN DIEGO,Nov 2013,DCH,2014,CHILD NUTRITION PROGRAM OF SOUTHERN CALIFORNIA INC ,DCH_LUNCH,20,0,0,0,0,0,0,0,0,0
SAN DIEGO,Nov 2013,DCH,2014,CHILD NUTRITION PROGRAM OF SOUTHERN CALIFORNIA INC ,DCH_LUNCH,20,0,0,0,0,0,0,0,0,0
SAN DIEGO,Nov 2013,DCH,2014,CHILD NUTRITION PROGRAM OF SOUTHERN CALIFORNIA INC ,DCH_LUNCH,20,0,0,0,0,0,0,0,0,0
SAN DIEGO,Nov 2013,DCH,2014,CHILD NUTRITION PROGRAM OF SOUTHERN CALIFORNIA INC ,DCH_SNACK_AM,20,0,0,0,0,29113,0,0,29113,1455.65
SAN DIEGO,Nov 2013,DCH,2014,CHILD NUTRITION PROGRAM OF SOUTHERN CALIFORNIA INC ,DCH_SNACK_AM,,0,0,0,0,0,220,7993,8213,0
SAN DIEGO,Nov 2013,DCH,2014,CHILD NUTRITION PROGRAM OF SOUTHERN CALIFORNIA INC ,DCH_SNACK_AM,20,0,0,0,0,0,0,0,0,0
SAN DIEGO,Nov 2013,DCH,2014,CHILD NUTRITION PROGRAM OF SOUTHERN CALIFORNIA INC ,DCH_SNACK_AM,20,0,0,0,0,0,0,0,0,0
SAN DIEGO,Nov 2013,DCH,2014,CHILD NUTRITION PROGRAM OF SOUTHERN CALIFORNIA INC ,DCH_SNACK_AM,20,0,0,0,0,0,0,0,0,0
SAN DIEGO,Nov 2013,DCH,2014,CHILD NUTRITION PROGRAM OF SOUTHERN CALIFORNIA INC ,DCH_SNACK_NT,20,0,0,0,0,2855,0,0,2855,142.75
SAN DIEGO,Nov 2013,DCH,2014,CHILD NUTRITION PROGRAM OF SOUTHERN CALIFORNIA INC ,DCH_SNACK_NT,,0,0,0,0,0,34,39,73,0
SAN DIEGO,Nov 2013,DCH,2014,CHILD NUTRITION PROGRAM OF SOUTHERN CALIFORNIA INC ,DCH_SNACK_NT,20,0,0,0,0,0,0,0,0,0
SAN DIEGO,Nov 2013,DCH,2014,CHILD NUTRITION PROGRAM OF SOUTHERN CALIFORNIA INC ,DCH_SNACK_NT,20,0,0,0,0,0,0,0,0,0
SAN DIEGO,Nov 2013,DCH,2014,CHILD NUTRITION PROGRAM OF SOUTHERN CALIFORNIA INC ,DCH_SNACK_NT,20,0,0,0,0,0,0,0,0,0
SAN DIEGO,Nov 2013,DCH,2014,CHILD NUTRITION PROGRAM OF SOUTHERN CALIFORNIA INC ,DCH_SNACK_PM,20,0,0,0,0,68010,0,0,68010,3400.5
SAN DIEGO,Nov 2013,DCH,2014,CHILD NUTRITION PROGRAM OF SOUTHERN CALIFORNIA INC ,DCH_SNACK_PM,,0,0,0,0,0,505,14304,14809,0
SAN DIEGO,Nov 2013,DCH,2014,CHILD NUTRITION PROGRAM OF SOUTHERN CALIFORNIA INC ,DCH_SNACK_PM,20,0,0,0,0,0,0,0,0,0
SAN DIEGO,Nov 2013,DCH,2014,CHILD NUTRITION PROGRAM OF SOUTHERN CALIFORNIA INC ,DCH_SNACK_PM,20,0,0,0,0,0,0,0,0,0
SAN DIEGO,Nov 2013,DCH,2014,CHILD NUTRITION PROGRAM OF SOUTHERN CALIFORNIA INC ,DCH_SNACK_PM,20,0,0,0,0,0,0,0,0,0
SAN DIEGO,Nov 2013,DCH,2014,CHILD NUTRITION PROGRAM OF SOUTHERN CALIFORNIA INC ,DCH_SUPPER,20,0,0,0,0,29962,0,0,29962,1498.1
SAN DIEGO,Nov 2013,DCH,2014,CHILD NUTRITION PROGRAM OF SOUTHERN CALIFORNIA INC ,DCH_SUPPER,,0,0,0,0,0,516,5168,5684,0
SAN DIEGO,Nov 2013,DCH,2014,CHILD NUTRITION PROGRAM OF SOUTHERN CALIFORNIA INC ,DCH_SUPPER,20,0,0,0,0,0,0,0,0,0
SAN DIEGO,Nov 2013,DCH,2014,CHILD NUTRITION PROGRAM OF SOUTHERN CALIFORNIA INC ,DCH_SUPPER,20,0,0,0,0,0,0,0,0,0
SAN DIEGO,Nov 2013,DCH,2014,CHILD NUTRITION PROGRAM OF SOUTHERN CALIFORNIA INC ,DCH_SUPPER,20,0,0,0,0,0,0,0,0,0
SAN DIEGO,Dec 2013,DCH,2014,CHILD NUTRITION PROGRAM OF SOUTHERN CALIFORNIA INC ,DCH_BREAKFAST,21,0,0,0,0,65976,0,0,65976,3141.7143
SAN DIEGO,Dec 2013,DCH,2014,CHILD NUTRITION PROGRAM OF SOUTHERN CALIFORNIA INC ,DCH_BREAKFAST,,0,0,0,0,0,401,13321,13722,0
SAN DIEGO,Dec 2013,DCH,2014,CHILD NUTRITION PROGRAM OF SOUTHERN CALIFORNIA INC ,DCH_BREAKFAST,21,0,0,0,0,0,0,0,0,0
SAN DIEGO,Dec 2013,DCH,2014,CHILD NUTRITION PROGRAM OF SOUTHERN CALIFORNIA INC ,DCH_BREAKFAST,21,0,0,0,0,0,0,0,0,0
SAN DIEGO,Dec 2013,DCH,2014,CHILD NUTRITION PROGRAM OF SOUTHERN CALIFORNIA INC ,DCH_BREAKFAST,21,0,0,0,0,0,0,0,0,0
SAN DIEGO,Dec 2013,DCH,2014,CHILD NUTRITION PROGRAM OF SOUTHERN CALIFORNIA INC ,DCH_LUNCH,21,0,0,0,0,73333,0,0,73333,3492.0476
SAN DIEGO,Dec 2013,DCH,2014,CHILD NUTRITION PROGRAM OF SOUTHERN CALIFORNIA INC ,DCH_LUNCH,,0,0,0,0,0,510,18208,18718,0
SAN DIEGO,Dec 2013,DCH,2014,CHILD NUTRITION PROGRAM OF SOUTHERN CALIFORNIA INC ,DCH_LUNCH,21,0,0,0,0,0,0,0,0,0
SAN DIEGO,Dec 2013,DCH,2014,CHILD NUTRITION PROGRAM OF SOUTHERN CALIFORNIA INC ,DCH_LUNCH,21,0,0,0,0,0,0,0,0,0
SAN DIEGO,Dec 2013,DCH,2014,CHILD NUTRITION PROGRAM OF SOUTHERN CALIFORNIA INC ,DCH_LUNCH,21,0,0,0,0,0,0,0,0,0
SAN DIEGO,Dec 2013,DCH,2014,CHILD NUTRITION PROGRAM OF SOUTHERN CALIFORNIA INC ,DCH_SNACK_AM,21,0,0,0,0,29955,0,0,29955,1426.4286
SAN DIEGO,Dec 2013,DCH,2014,CHILD NUTRITION PROGRAM OF SOUTHERN CALIFORNIA INC ,DCH_SNACK_AM,,0,0,0,0,0,231,8061,8292,0
SAN DIEGO,Dec 2013,DCH,2014,CHILD NUTRITION PROGRAM OF SOUTHERN CALIFORNIA INC ,DCH_SNACK_AM,21,0,0,0,0,0,0,0,0,0
SAN DIEGO,Dec 2013,DCH,2014,CHILD NUTRITION PROGRAM OF SOUTHERN CALIFORNIA INC ,DCH_SNACK_AM,21,0,0,0,0,0,0,0,0,0
SAN DIEGO,Dec 2013,DCH,2014,CHILD NUTRITION PROGRAM OF SOUTHERN CALIFORNIA INC ,DCH_SNACK_AM,21,0,0,0,0,0,0,0,0,0
SAN DIEGO,Dec 2013,DCH,2014,CHILD NUTRITION PROGRAM OF SOUTHERN CALIFORNIA INC ,DCH_SNACK_NT,21,0,0,0,0,2886,0,0,2886,137.4286
SAN DIEGO,Dec 2013,DCH,2014,CHILD NUTRITION PROGRAM OF SOUTHERN CALIFORNIA INC ,DCH_SNACK_NT,,0,0,0,0,0,62,30,92,0
SAN DIEGO,Dec 2013,DCH,2014,CHILD NUTRITION PROGRAM OF SOUTHERN CALIFORNIA INC ,DCH_SNACK_NT,21,0,0,0,0,0,0,0,0,0
SAN DIEGO,Dec 2013,DCH,2014,CHILD NUTRITION PROGRAM OF SOUTHERN CALIFORNIA INC ,DCH_SNACK_NT,21,0,0,0,0,0,0,0,0,0
SAN DIEGO,Dec 2013,DCH,2014,CHILD NUTRITION PROGRAM OF SOUTHERN CALIFORNIA INC ,DCH_SNACK_NT,21,0,0,0,0,0,0,0,0,0
SAN DIEGO,Dec 2013,DCH,2014,CHILD NUTRITION PROGRAM OF SOUTHERN CALIFORNIA INC ,DCH_SNACK_PM,21,0,0,0,0,68209,0,0,68209,3248.0476
SAN DIEGO,Dec 2013,DCH,2014,CHILD NUTRITION PROGRAM OF SOUTHERN CALIFORNIA INC ,DCH_SNACK_PM,,0,0,0,0,0,526,14064,14590,0
SAN DIEGO,Dec 2013,DCH,2014,CHILD NUTRITION PROGRAM OF SOUTHERN CALIFORNIA INC ,DCH_SNACK_PM,21,0,0,0,0,0,0,0,0,0
SAN DIEGO,Dec 2013,DCH,2014,CHILD NUTRITION PROGRAM OF SOUTHERN CALIFORNIA INC ,DCH_SNACK_PM,21,0,0,0,0,0,0,0,0,0
SAN DIEGO,Dec 2013,DCH,2014,CHILD NUTRITION PROGRAM OF SOUTHERN CALIFORNIA INC ,DCH_SNACK_PM,21,0,0,0,0,0,0,0,0,0
SAN DIEGO,Dec 2013,DCH,2014,CHILD NUTRITION PROGRAM OF SOUTHERN CALIFORNIA INC ,DCH_SUPPER,21,0,0,0,0,30960,0,0,30960,1474.2857
SAN DIEGO,Dec 2013,DCH,2014,CHILD NUTRITION PROGRAM OF SOUTHERN CALIFORNIA INC ,DCH_SUPPER,,0,0,0,0,0,445,5272,5717,0
SAN DIEGO,Dec 2013,DCH,2014,CHILD NUTRITION PROGRAM OF SOUTHERN CALIFORNIA INC ,DCH_SUPPER,21,0,0,0,0,0,0,0,0,0
SAN DIEGO,Dec 2013,DCH,2014,CHILD NUTRITION PROGRAM OF SOUTHERN CALIFORNIA INC ,DCH_SUPPER,21,0,0,0,0,0,0,0,0,0
SAN DIEGO,Dec 2013,DCH,2014,CHILD NUTRITION PROGRAM OF SOUTHERN CALIFORNIA INC ,DCH_SUPPER,21,0,0,0,0,0,0,0,0,0
SAN DIEGO,Jan 2014,DCH,2014,CHILD NUTRITION PROGRAM OF SOUTHERN CALIFORNIA INC ,DCH_BREAKFAST,22,0,0,0,0,74554,0,0,74554,3388.8182
SAN DIEGO,Jan 2014,DCH,2014,CHILD NUTRITION PROGRAM OF SOUTHERN CALIFORNIA INC ,DCH_BREAKFAST,,0,0,0,0,0,376,15876,16252,0
SAN DIEGO,Jan 2014,DCH,2014,CHILD NUTRITION PROGRAM OF SOUTHERN CALIFORNIA INC ,DCH_BREAKFAST,22,0,0,0,0,0,0,0,0,0
SAN DIEGO,Jan 2014,DCH,2014,CHILD NUTRITION PROGRAM OF SOUTHERN CALIFORNIA INC ,DCH_BREAKFAST,22,0,0,0,0,0,0,0,0,0
SAN DIEGO,Jan 2014,DCH,2014,CHILD NUTRITION PROGRAM OF SOUTHERN CALIFORNIA INC ,DCH_BREAKFAST,22,0,0,0,0,0,0,0,0,0
SAN DIEGO,Jan 2014,DCH,2014,CHILD NUTRITION PROGRAM OF SOUTHERN CALIFORNIA INC ,DCH_LUNCH,22,0,0,0,0,82363,0,0,82363,3743.7727
SAN DIEGO,Jan 2014,DCH,2014,CHILD NUTRITION PROGRAM OF SOUTHERN CALIFORNIA INC ,DCH_LUNCH,,0,0,0,0,0,464,21430,21894,0
SAN DIEGO,Jan 2014,DCH,2014,CHILD NUTRITION PROGRAM OF SOUTHERN CALIFORNIA INC ,DCH_LUNCH,22,0,0,0,0,0,0,0,0,0
SAN DIEGO,Jan 2014,DCH,2014,CHILD NUTRITION PROGRAM OF SOUTHERN CALIFORNIA INC ,DCH_LUNCH,22,0,0,0,0,0,0,0,0,0
SAN DIEGO,Jan 2014,DCH,2014,CHILD NUTRITION PROGRAM OF SOUTHERN CALIFORNIA INC ,DCH_LUNCH,22,0,0,0,0,0,0,0,0,0
SAN DIEGO,Jan 2014,DCH,2014,CHILD NUTRITION PROGRAM OF SOUTHERN CALIFORNIA INC ,DCH_SNACK_AM,22,0,0,0,0,33799,0,0,33799,1536.3182
SAN DIEGO,Jan 2014,DCH,2014,CHILD NUTRITION PROGRAM OF SOUTHERN CALIFORNIA INC ,DCH_SNACK_AM,,0,0,0,0,0,198,9501,9699,0
SAN DIEGO,Jan 2014,DCH,2014,CHILD NUTRITION PROGRAM OF SOUTHERN CALIFORNIA INC ,DCH_SNACK_AM,22,0,0,0,0,0,0,0,0,0
SAN DIEGO,Jan 2014,DCH,2014,CHILD NUTRITION PROGRAM OF SOUTHERN CALIFORNIA INC ,DCH_SNACK_AM,22,0,0,0,0,0,0,0,0,0
SAN DIEGO,Jan 2014,DCH,2014,CHILD NUTRITION PROGRAM OF SOUTHERN CALIFORNIA INC ,DCH_SNACK_AM,22,0,0,0,0,0,0,0,0,0
SAN DIEGO,Jan 2014,DCH,2014,CHILD NUTRITION PROGRAM OF SOUTHERN CALIFORNIA INC ,DCH_SNACK_NT,22,0,0,0,0,3126,0,0,3126,142.0909
SAN DIEGO,Jan 2014,DCH,2014,CHILD NUTRITION PROGRAM OF SOUTHERN CALIFORNIA INC ,DCH_SNACK_NT,,0,0,0,0,0,8,59,67,0
SAN DIEGO,Jan 2014,DCH,2014,CHILD NUTRITION PROGRAM OF SOUTHERN CALIFORNIA INC ,DCH_SNACK_NT,22,0,0,0,0,0,0,0,0,0
SAN DIEGO,Jan 2014,DCH,2014,CHILD NUTRITION PROGRAM OF SOUTHERN CALIFORNIA INC ,DCH_SNACK_NT,22,0,0,0,0,0,0,0,0,0
SAN DIEGO,Jan 2014,DCH,2014,CHILD NUTRITION PROGRAM OF SOUTHERN CALIFORNIA INC ,DCH_SNACK_NT,22,0,0,0,0,0,0,0,0,0
SAN DIEGO,Jan 2014,DCH,2014,CHILD NUTRITION PROGRAM OF SOUTHERN CALIFORNIA INC ,DCH_SNACK_PM,22,0,0,0,0,76169,0,0,76169,3462.2273
SAN DIEGO,Jan 2014,DCH,2014,CHILD NUTRITION PROGRAM OF SOUTHERN CALIFORNIA INC ,DCH_SNACK_PM,,0,0,0,0,0,479,16188,16667,0
SAN DIEGO,Jan 2014,DCH,2014,CHILD NUTRITION PROGRAM OF SOUTHERN CALIFORNIA INC ,DCH_SNACK_PM,22,0,0,0,0,0,0,0,0,0
SAN DIEGO,Jan 2014,DCH,2014,CHILD NUTRITION PROGRAM OF SOUTHERN CALIFORNIA INC ,DCH_SNACK_PM,22,0,0,0,0,0,0,0,0,0
SAN DIEGO,Jan 2014,DCH,2014,CHILD NUTRITION PROGRAM OF SOUTHERN CALIFORNIA INC ,DCH_SNACK_PM,22,0,0,0,0,0,0,0,0,0
SAN DIEGO,Jan 2014,DCH,2014,CHILD NUTRITION PROGRAM OF SOUTHERN CALIFORNIA INC ,DCH_SUPPER,22,0,0,0,0,33507,0,0,33507,1523.0455
SAN DIEGO,Jan 2014,DCH,2014,CHILD NUTRITION PROGRAM OF SOUTHERN CALIFORNIA INC ,DCH_SUPPER,,0,0,0,0,0,405,5898,6303,0
SAN DIEGO,Jan 2014,DCH,2014,CHILD NUTRITION PROGRAM OF SOUTHERN CALIFORNIA INC ,DCH_SUPPER,22,0,0,0,0,0,0,0,0,0
SAN DIEGO,Jan 2014,DCH,2014,CHILD NUTRITION PROGRAM OF SOUTHERN CALIFORNIA INC ,DCH_SUPPER,22,0,0,0,0,0,0,0,0,0
SAN DIEGO,Jan 2014,DCH,2014,CHILD NUTRITION PROGRAM OF SOUTHERN CALIFORNIA INC ,DCH_SUPPER,22,0,0,0,0,0,0,0,0,0
SAN DIEGO,Feb 2014,DCH,2014,CHILD NUTRITION PROGRAM OF SOUTHERN CALIFORNIA INC ,DCH_BREAKFAST,20,0,0,0,0,69582,0,0,69582,3479.1
SAN DIEGO,Feb 2014,DCH,2014,CHILD NUTRITION PROGRAM OF SOUTHERN CALIFORNIA INC ,DCH_BREAKFAST,,0,0,0,0,0,421,14792,15213,0
SAN DIEGO,Feb 2014,DCH,2014,CHILD NUTRITION PROGRAM OF SOUTHERN CALIFORNIA INC ,DCH_BREAKFAST,20,0,0,0,0,0,0,0,0,0
SAN DIEGO,Feb 2014,DCH,2014,CHILD NUTRITION PROGRAM OF SOUTHERN CALIFORNIA INC ,DCH_BREAKFAST,20,0,0,0,0,0,0,0,0,0
SAN DIEGO,Feb 2014,DCH,2014,CHILD NUTRITION PROGRAM OF SOUTHERN CALIFORNIA INC ,DCH_BREAKFAST,20,0,0,0,0,0,0,0,0,0
SAN DIEGO,Feb 2014,DCH,2014,CHILD NUTRITION PROGRAM OF SOUTHERN CALIFORNIA INC ,DCH_LUNCH,20,0,0,0,0,74796,0,0,74796,3739.8
SAN DIEGO,Feb 2014,DCH,2014,CHILD NUTRITION PROGRAM OF SOUTHERN CALIFORNIA INC ,DCH_LUNCH,,0,0,0,0,0,466,19609,20075,0
SAN DIEGO,Feb 2014,DCH,2014,CHILD NUTRITION PROGRAM OF SOUTHERN CALIFORNIA INC ,DCH_LUNCH,20,0,0,0,0,0,0,0,0,0
SAN DIEGO,Feb 2014,DCH,2014,CHILD NUTRITION PROGRAM OF SOUTHERN CALIFORNIA INC ,DCH_LUNCH,20,0,0,0,0,0,0,0,0,0
SAN DIEGO,Feb 2014,DCH,2014,CHILD NUTRITION PROGRAM OF SOUTHERN CALIFORNIA INC ,DCH_LUNCH,20,0,0,0,0,0,0,0,0,0
SAN DIEGO,Feb 2014,DCH,2014,CHILD NUTRITION PROGRAM OF SOUTHERN CALIFORNIA INC ,DCH_SNACK_AM,20,0,0,0,0,30972,0,0,30972,1548.6
SAN DIEGO,Feb 2014,DCH,2014,CHILD NUTRITION PROGRAM OF SOUTHERN CALIFORNIA INC ,DCH_SNACK_AM,,0,0,0,0,0,216,8698,8914,0
SAN DIEGO,Feb 2014,DCH,2014,CHILD NUTRITION PROGRAM OF SOUTHERN CALIFORNIA INC ,DCH_SNACK_AM,20,0,0,0,0,0,0,0,0,0
SAN DIEGO,Feb 2014,DCH,2014,CHILD NUTRITION PROGRAM OF SOUTHERN CALIFORNIA INC ,DCH_SNACK_AM,20,0,0,0,0,0,0,0,0,0
SAN DIEGO,Feb 2014,DCH,2014,CHILD NUTRITION PROGRAM OF SOUTHERN CALIFORNIA INC ,DCH_SNACK_AM,20,0,0,0,0,0,0,0,0,0
SAN DIEGO,Feb 2014,DCH,2014,CHILD NUTRITION PROGRAM OF SOUTHERN CALIFORNIA INC ,DCH_SNACK_NT,20,0,0,0,0,3129,0,0,3129,156.45
SAN DIEGO,Feb 2014,DCH,2014,CHILD NUTRITION PROGRAM OF SOUTHERN CALIFORNIA INC ,DCH_SNACK_NT,,0,0,0,0,0,19,66,85,0
SAN DIEGO,Feb 2014,DCH,2014,CHILD NUTRITION PROGRAM OF SOUTHERN CALIFORNIA INC ,DCH_SNACK_NT,20,0,0,0,0,0,0,0,0,0
SAN DIEGO,Feb 2014,DCH,2014,CHILD NUTRITION PROGRAM OF SOUTHERN CALIFORNIA INC ,DCH_SNACK_NT,20,0,0,0,0,0,0,0,0,0
SAN DIEGO,Feb 2014,DCH,2014,CHILD NUTRITION PROGRAM OF SOUTHERN CALIFORNIA INC ,DCH_SNACK_NT,20,0,0,0,0,0,0,0,0,0
SAN DIEGO,Feb 2014,DCH,2014,CHILD NUTRITION PROGRAM OF SOUTHERN CALIFORNIA INC ,DCH_SNACK_PM,20,0,0,0,0,71050,0,0,71050,3552.5
SAN DIEGO,Feb 2014,DCH,2014,CHILD NUTRITION PROGRAM OF SOUTHERN CALIFORNIA INC ,DCH_SNACK_PM,,0,0,0,0,0,477,15372,15849,0
SAN DIEGO,Feb 2014,DCH,2014,CHILD NUTRITION PROGRAM OF SOUTHERN CALIFORNIA INC ,DCH_SNACK_PM,20,0,0,0,0,0,0,0,0,0
SAN DIEGO,Feb 2014,DCH,2014,CHILD NUTRITION PROGRAM OF SOUTHERN CALIFORNIA INC ,DCH_SNACK_PM,20,0,0,0,0,0,0,0,0,0
SAN DIEGO,Feb 2014,DCH,2014,CHILD NUTRITION PROGRAM OF SOUTHERN CALIFORNIA INC ,DCH_SNACK_PM,20,0,0,0,0,0,0,0,0,0
SAN DIEGO,Feb 2014,DCH,2014,CHILD NUTRITION PROGRAM OF SOUTHERN CALIFORNIA INC ,DCH_SUPPER,20,0,0,0,0,32052,0,0,32052,1602.6
SAN DIEGO,Feb 2014,DCH,2014,CHILD NUTRITION PROGRAM OF SOUTHERN CALIFORNIA INC ,DCH_SUPPER,,0,0,0,0,0,401,5263,5664,0
SAN DIEGO,Feb 2014,DCH,2014,CHILD NUTRITION PROGRAM OF SOUTHERN CALIFORNIA INC ,DCH_SUPPER,20,0,0,0,0,0,0,0,0,0
SAN DIEGO,Feb 2014,DCH,2014,CHILD NUTRITION PROGRAM OF SOUTHERN CALIFORNIA INC ,DCH_SUPPER,20,0,0,0,0,0,0,0,0,0
SAN DIEGO,Feb 2014,DCH,2014,CHILD NUTRITION PROGRAM OF SOUTHERN CALIFORNIA INC ,DCH_SUPPER,20,0,0,0,0,0,0,0,0,0
SAN DIEGO,Mar 2014,DCH,2014,CHILD NUTRITION PROGRAM OF SOUTHERN CALIFORNIA INC ,DCH_BREAKFAST,21,0,0,0,0,74002,0,0,74002,3523.9048
SAN DIEGO,Mar 2014,DCH,2014,CHILD NUTRITION PROGRAM OF SOUTHERN CALIFORNIA INC ,DCH_BREAKFAST,,0,0,0,0,0,512,16164,16676,0
SAN DIEGO,Mar 2014,DCH,2014,CHILD NUTRITION PROGRAM OF SOUTHERN CALIFORNIA INC ,DCH_BREAKFAST,21,0,0,0,0,0,0,0,0,0
SAN DIEGO,Mar 2014,DCH,2014,CHILD NUTRITION PROGRAM OF SOUTHERN CALIFORNIA INC ,DCH_BREAKFAST,21,0,0,0,0,0,0,0,0,0
SAN DIEGO,Mar 2014,DCH,2014,CHILD NUTRITION PROGRAM OF SOUTHERN CALIFORNIA INC ,DCH_BREAKFAST,21,0,0,0,0,0,0,0,0,0
SAN DIEGO,Mar 2014,DCH,2014,CHILD NUTRITION PROGRAM OF SOUTHERN CALIFORNIA INC ,DCH_LUNCH,21,0,0,0,0,83174,0,0,83174,3960.6667
SAN DIEGO,Mar 2014,DCH,2014,CHILD NUTRITION PROGRAM OF SOUTHERN CALIFORNIA INC ,DCH_LUNCH,,0,0,0,0,0,555,21932,22487,0
SAN DIEGO,Mar 2014,DCH,2014,CHILD NUTRITION PROGRAM OF SOUTHERN CALIFORNIA INC ,DCH_LUNCH,21,0,0,0,0,0,0,0,0,0
SAN DIEGO,Mar 2014,DCH,2014,CHILD NUTRITION PROGRAM OF SOUTHERN CALIFORNIA INC ,DCH_LUNCH,21,0,0,0,0,0,0,0,0,0
SAN DIEGO,Mar 2014,DCH,2014,CHILD NUTRITION PROGRAM OF SOUTHERN CALIFORNIA INC ,DCH_LUNCH,21,0,0,0,0,0,0,0,0,0
SAN DIEGO,Mar 2014,DCH,2014,CHILD NUTRITION PROGRAM OF SOUTHERN CALIFORNIA INC ,DCH_SNACK_AM,21,0,0,0,0,34200,0,0,34200,1628.5714
SAN DIEGO,Mar 2014,DCH,2014,CHILD NUTRITION PROGRAM OF SOUTHERN CALIFORNIA INC ,DCH_SNACK_AM,,0,0,0,0,0,297,9711,10008,0
SAN DIEGO,Mar 2014,DCH,2014,CHILD NUTRITION PROGRAM OF SOUTHERN CALIFORNIA INC ,DCH_SNACK_AM,21,0,0,0,0,0,0,0,0,0
SAN DIEGO,Mar 2014,DCH,2014,CHILD NUTRITION PROGRAM OF SOUTHERN CALIFORNIA INC ,DCH_SNACK_AM,21,0,0,0,0,0,0,0,0,0
SAN DIEGO,Mar 2014,DCH,2014,CHILD NUTRITION PROGRAM OF SOUTHERN CALIFORNIA INC ,DCH_SNACK_AM,21,0,0,0,0,0,0,0,0,0
SAN DIEGO,Mar 2014,DCH,2014,CHILD NUTRITION PROGRAM OF SOUTHERN CALIFORNIA INC ,DCH_SNACK_NT,21,0,0,0,0,3100,0,0,3100,147.619
SAN DIEGO,Mar 2014,DCH,2014,CHILD NUTRITION PROGRAM OF SOUTHERN CALIFORNIA INC ,DCH_SNACK_NT,,0,0,0,0,0,38,83,121,0
SAN DIEGO,Mar 2014,DCH,2014,CHILD NUTRITION PROGRAM OF SOUTHERN CALIFORNIA INC ,DCH_SNACK_NT,21,0,0,0,0,0,0,0,0,0
SAN DIEGO,Mar 2014,DCH,2014,CHILD NUTRITION PROGRAM OF SOUTHERN CALIFORNIA INC ,DCH_SNACK_NT,21,0,0,0,0,0,0,0,0,0
SAN DIEGO,Mar 2014,DCH,2014,CHILD NUTRITION PROGRAM OF SOUTHERN CALIFORNIA INC ,DCH_SNACK_NT,21,0,0,0,0,0,0,0,0,0
SAN DIEGO,Mar 2014,DCH,2014,CHILD NUTRITION PROGRAM OF SOUTHERN CALIFORNIA INC ,DCH_SNACK_PM,21,0,0,0,0,76927,0,0,76927,3663.1905
SAN DIEGO,Mar 2014,DCH,2014,CHILD NUTRITION PROGRAM OF SOUTHERN CALIFORNIA INC ,DCH_SNACK_PM,,0,0,0,0,0,464,16191,16655,0
SAN DIEGO,Mar 2014,DCH,2014,CHILD NUTRITION PROGRAM OF SOUTHERN CALIFORNIA INC ,DCH_SNACK_PM,21,0,0,0,0,0,0,0,0,0
SAN DIEGO,Mar 2014,DCH,2014,CHILD NUTRITION PROGRAM OF SOUTHERN CALIFORNIA INC ,DCH_SNACK_PM,21,0,0,0,0,0,0,0,0,0
SAN DIEGO,Mar 2014,DCH,2014,CHILD NUTRITION PROGRAM OF SOUTHERN CALIFORNIA INC ,DCH_SNACK_PM,21,0,0,0,0,0,0,0,0,0
SAN DIEGO,Mar 2014,DCH,2014,CHILD NUTRITION PROGRAM OF SOUTHERN CALIFORNIA INC ,DCH_SUPPER,21,0,0,0,0,35044,0,0,35044,1668.7619
SAN DIEGO,Mar 2014,DCH,2014,CHILD NUTRITION PROGRAM OF SOUTHERN CALIFORNIA INC ,DCH_SUPPER,,0,0,0,0,0,483,5701,6184,0
SAN DIEGO,Mar 2014,DCH,2014,CHILD NUTRITION PROGRAM OF SOUTHERN CALIFORNIA INC ,DCH_SUPPER,21,0,0,0,0,0,0,0,0,0
SAN DIEGO,Mar 2014,DCH,2014,CHILD NUTRITION PROGRAM OF SOUTHERN CALIFORNIA INC ,DCH_SUPPER,21,0,0,0,0,0,0,0,0,0
SAN DIEGO,Mar 2014,DCH,2014,CHILD NUTRITION PROGRAM OF SOUTHERN CALIFORNIA INC ,DCH_SUPPER,21,0,0,0,0,0,0,0,0,0
SAN DIEGO,Apr 2014,DCH,2014,CHILD NUTRITION PROGRAM OF SOUTHERN CALIFORNIA INC ,DCH_BREAKFAST,22,0,0,0,0,77893,0,0,77893,3540.5909
SAN DIEGO,Apr 2014,DCH,2014,CHILD NUTRITION PROGRAM OF SOUTHERN CALIFORNIA INC ,DCH_BREAKFAST,,0,0,0,0,0,435,17354,17789,0
SAN DIEGO,Apr 2014,DCH,2014,CHILD NUTRITION PROGRAM OF SOUTHERN CALIFORNIA INC ,DCH_BREAKFAST,22,0,0,0,0,0,0,0,0,0
SAN DIEGO,Apr 2014,DCH,2014,CHILD NUTRITION PROGRAM OF SOUTHERN CALIFORNIA INC ,DCH_BREAKFAST,22,0,0,0,0,0,0,0,0,0
SAN DIEGO,Apr 2014,DCH,2014,CHILD NUTRITION PROGRAM OF SOUTHERN CALIFORNIA INC ,DCH_BREAKFAST,22,0,0,0,0,0,0,0,0,0
SAN DIEGO,Apr 2014,DCH,2014,CHILD NUTRITION PROGRAM OF SOUTHERN CALIFORNIA INC ,DCH_LUNCH,22,0,0,0,0,89238,0,0,89238,4056.2727
SAN DIEGO,Apr 2014,DCH,2014,CHILD NUTRITION PROGRAM OF SOUTHERN CALIFORNIA INC ,DCH_LUNCH,,0,0,0,0,0,527,23498,24025,0
SAN DIEGO,Apr 2014,DCH,2014,CHILD NUTRITION PROGRAM OF SOUTHERN CALIFORNIA INC ,DCH_LUNCH,22,0,0,0,0,0,0,0,0,0
SAN DIEGO,Apr 2014,DCH,2014,CHILD NUTRITION PROGRAM OF SOUTHERN CALIFORNIA INC ,DCH_LUNCH,22,0,0,0,0,0,0,0,0,0
SAN DIEGO,Apr 2014,DCH,2014,CHILD NUTRITION PROGRAM OF SOUTHERN CALIFORNIA INC ,DCH_LUNCH,22,0,0,0,0,0,0,0,0,0
SAN DIEGO,Apr 2014,DCH,2014,CHILD NUTRITION PROGRAM OF SOUTHERN CALIFORNIA INC ,DCH_SNACK_AM,22,0,0,0,0,37160,0,0,37160,1689.0909
SAN DIEGO,Apr 2014,DCH,2014,CHILD NUTRITION PROGRAM OF SOUTHERN CALIFORNIA INC ,DCH_SNACK_AM,,0,0,0,0,0,227,10345,10572,0
SAN DIEGO,Apr 2014,DCH,2014,CHILD NUTRITION PROGRAM OF SOUTHERN CALIFORNIA INC ,DCH_SNACK_AM,22,0,0,0,0,0,0,0,0,0
SAN DIEGO,Apr 2014,DCH,2014,CHILD NUTRITION PROGRAM OF SOUTHERN CALIFORNIA INC ,DCH_SNACK_AM,22,0,0,0,0,0,0,0,0,0
SAN DIEGO,Apr 2014,DCH,2014,CHILD NUTRITION PROGRAM OF SOUTHERN CALIFORNIA INC ,DCH_SNACK_AM,22,0,0,0,0,0,0,0,0,0
SAN DIEGO,Apr 2014,DCH,2014,CHILD NUTRITION PROGRAM OF SOUTHERN CALIFORNIA INC ,DCH_SNACK_NT,22,0,0,0,0,3045,0,0,3045,138.4091
SAN DIEGO,Apr 2014,DCH,2014,CHILD NUTRITION PROGRAM OF SOUTHERN CALIFORNIA INC ,DCH_SNACK_NT,,0,0,0,0,0,27,57,84,0
SAN DIEGO,Apr 2014,DCH,2014,CHILD NUTRITION PROGRAM OF SOUTHERN CALIFORNIA INC ,DCH_SNACK_NT,22,0,0,0,0,0,0,0,0,0
SAN DIEGO,Apr 2014,DCH,2014,CHILD NUTRITION PROGRAM OF SOUTHERN CALIFORNIA INC ,DCH_SNACK_NT,22,0,0,0,0,0,0,0,0,0
SAN DIEGO,Apr 2014,DCH,2014,CHILD NUTRITION PROGRAM OF SOUTHERN CALIFORNIA INC ,DCH_SNACK_NT,22,0,0,0,0,0,0,0,0,0
SAN DIEGO,Apr 2014,DCH,2014,CHILD NUTRITION PROGRAM OF SOUTHERN CALIFORNIA INC ,DCH_SNACK_PM,22,0,0,0,0,80300,0,0,80300,3650
SAN DIEGO,Apr 2014,DCH,2014,CHILD NUTRITION PROGRAM OF SOUTHERN CALIFORNIA INC ,DCH_SNACK_PM,,0,0,0,0,0,446,17139,17585,0
SAN DIEGO,Apr 2014,DCH,2014,CHILD NUTRITION PROGRAM OF SOUTHERN CALIFORNIA INC ,DCH_SNACK_PM,22,0,0,0,0,0,0,0,0,0
SAN DIEGO,Apr 2014,DCH,2014,CHILD NUTRITION PROGRAM OF SOUTHERN CALIFORNIA INC ,DCH_SNACK_PM,22,0,0,0,0,0,0,0,0,0
SAN DIEGO,Apr 2014,DCH,2014,CHILD NUTRITION PROGRAM OF SOUTHERN CALIFORNIA INC ,DCH_SNACK_PM,22,0,0,0,0,0,0,0,0,0
SAN DIEGO,Apr 2014,DCH,2014,CHILD NUTRITION PROGRAM OF SOUTHERN CALIFORNIA INC ,DCH_SUPPER,22,0,0,0,0,36593,0,0,36593,1663.3182
SAN DIEGO,Apr 2014,DCH,2014,CHILD NUTRITION PROGRAM OF SOUTHERN CALIFORNIA INC ,DCH_SUPPER,,0,0,0,0,0,518,6164,6682,0
SAN DIEGO,Apr 2014,DCH,2014,CHILD NUTRITION PROGRAM OF SOUTHERN CALIFORNIA INC ,DCH_SUPPER,22,0,0,0,0,0,0,0,0,0
SAN DIEGO,Apr 2014,DCH,2014,CHILD NUTRITION PROGRAM OF SOUTHERN CALIFORNIA INC ,DCH_SUPPER,22,0,0,0,0,0,0,0,0,0
SAN DIEGO,Apr 2014,DCH,2014,CHILD NUTRITION PROGRAM OF SOUTHERN CALIFORNIA INC ,DCH_SUPPER,22,0,0,0,0,0,0,0,0,0
SAN DIEGO,May 2014,DCH,2014,CHILD NUTRITION PROGRAM OF SOUTHERN CALIFORNIA INC ,DCH_BREAKFAST,21,0,0,0,0,75997,0,0,75997,3618.9048
SAN DIEGO,May 2014,DCH,2014,CHILD NUTRITION PROGRAM OF SOUTHERN CALIFORNIA INC ,DCH_BREAKFAST,,0,0,0,0,0,484,17243,17727,0
SAN DIEGO,May 2014,DCH,2014,CHILD NUTRITION PROGRAM OF SOUTHERN CALIFORNIA INC ,DCH_BREAKFAST,21,0,0,0,0,0,0,0,0,0
SAN DIEGO,May 2014,DCH,2014,CHILD NUTRITION PROGRAM OF SOUTHERN CALIFORNIA INC ,DCH_BREAKFAST,21,0,0,0,0,0,0,0,0,0
SAN DIEGO,May 2014,DCH,2014,CHILD NUTRITION PROGRAM OF SOUTHERN CALIFORNIA INC ,DCH_BREAKFAST,21,0,0,0,0,0,0,0,0,0
SAN DIEGO,May 2014,DCH,2014,CHILD NUTRITION PROGRAM OF SOUTHERN CALIFORNIA INC ,DCH_LUNCH,21,0,0,0,0,82083,0,0,82083,3908.7143
SAN DIEGO,May 2014,DCH,2014,CHILD NUTRITION PROGRAM OF SOUTHERN CALIFORNIA INC ,DCH_LUNCH,,0,0,0,0,0,483,22670,23153,0
SAN DIEGO,May 2014,DCH,2014,CHILD NUTRITION PROGRAM OF SOUTHERN CALIFORNIA INC ,DCH_LUNCH,21,0,0,0,0,0,0,0,0,0
SAN DIEGO,May 2014,DCH,2014,CHILD NUTRITION PROGRAM OF SOUTHERN CALIFORNIA INC ,DCH_LUNCH,21,0,0,0,0,0,0,0,0,0
SAN DIEGO,May 2014,DCH,2014,CHILD NUTRITION PROGRAM OF SOUTHERN CALIFORNIA INC ,DCH_LUNCH,21,0,0,0,0,0,0,0,0,0
SAN DIEGO,May 2014,DCH,2014,CHILD NUTRITION PROGRAM OF SOUTHERN CALIFORNIA INC ,DCH_SNACK_AM,21,0,0,0,0,34791,0,0,34791,1656.7143
SAN DIEGO,May 2014,DCH,2014,CHILD NUTRITION PROGRAM OF SOUTHERN CALIFORNIA INC ,DCH_SNACK_AM,,0,0,0,0,0,255,9910,10165,0
SAN DIEGO,May 2014,DCH,2014,CHILD NUTRITION PROGRAM OF SOUTHERN CALIFORNIA INC ,DCH_SNACK_AM,21,0,0,0,0,0,0,0,0,0
SAN DIEGO,May 2014,DCH,2014,CHILD NUTRITION PROGRAM OF SOUTHERN CALIFORNIA INC ,DCH_SNACK_AM,21,0,0,0,0,0,0,0,0,0
SAN DIEGO,May 2014,DCH,2014,CHILD NUTRITION PROGRAM OF SOUTHERN CALIFORNIA INC ,DCH_SNACK_AM,21,0,0,0,0,0,0,0,0,0
SAN DIEGO,May 2014,DCH,2014,CHILD NUTRITION PROGRAM OF SOUTHERN CALIFORNIA INC ,DCH_SNACK_NT,21,0,0,0,0,2847,0,0,2847,135.5714
SAN DIEGO,May 2014,DCH,2014,CHILD NUTRITION PROGRAM OF SOUTHERN CALIFORNIA INC ,DCH_SNACK_NT,,0,0,0,0,0,66,62,128,0
SAN DIEGO,May 2014,DCH,2014,CHILD NUTRITION PROGRAM OF SOUTHERN CALIFORNIA INC ,DCH_SNACK_NT,21,0,0,0,0,0,0,0,0,0
SAN DIEGO,May 2014,DCH,2014,CHILD NUTRITION PROGRAM OF SOUTHERN CALIFORNIA INC ,DCH_SNACK_NT,21,0,0,0,0,0,0,0,0,0
SAN DIEGO,May 2014,DCH,2014,CHILD NUTRITION PROGRAM OF SOUTHERN CALIFORNIA INC ,DCH_SNACK_NT,21,0,0,0,0,0,0,0,0,0
SAN DIEGO,May 2014,DCH,2014,CHILD NUTRITION PROGRAM OF SOUTHERN CALIFORNIA INC ,DCH_SNACK_PM,21,0,0,0,0,77522,0,0,77522,3691.5238
SAN DIEGO,May 2014,DCH,2014,CHILD NUTRITION PROGRAM OF SOUTHERN CALIFORNIA INC ,DCH_SNACK_PM,,0,0,0,0,0,461,17005,17466,0
SAN DIEGO,May 2014,DCH,2014,CHILD NUTRITION PROGRAM OF SOUTHERN CALIFORNIA INC ,DCH_SNACK_PM,21,0,0,0,0,0,0,0,0,0
SAN DIEGO,May 2014,DCH,2014,CHILD NUTRITION PROGRAM OF SOUTHERN CALIFORNIA INC ,DCH_SNACK_PM,21,0,0,0,0,0,0,0,0,0
SAN DIEGO,May 2014,DCH,2014,CHILD NUTRITION PROGRAM OF SOUTHERN CALIFORNIA INC ,DCH_SNACK_PM,21,0,0,0,0,0,0,0,0,0
SAN DIEGO,May 2014,DCH,2014,CHILD NUTRITION PROGRAM OF SOUTHERN CALIFORNIA INC ,DCH_SUPPER,21,0,0,0,0,34489,0,0,34489,1642.3333
SAN DIEGO,May 2014,DCH,2014,CHILD NUTRITION PROGRAM OF SOUTHERN CALIFORNIA INC ,DCH_SUPPER,,0,0,0,0,0,516,5723,6239,0
SAN DIEGO,May 2014,DCH,2014,CHILD NUTRITION PROGRAM OF SOUTHERN CALIFORNIA INC ,DCH_SUPPER,21,0,0,0,0,0,0,0,0,0
SAN DIEGO,May 2014,DCH,2014,CHILD NUTRITION PROGRAM OF SOUTHERN CALIFORNIA INC ,DCH_SUPPER,21,0,0,0,0,0,0,0,0,0
SAN DIEGO,May 2014,DCH,2014,CHILD NUTRITION PROGRAM OF SOUTHERN CALIFORNIA INC ,DCH_SUPPER,21,0,0,0,0,0,0,0,0,0
SAN DIEGO,Jun 2014,DCH,2014,CHILD NUTRITION PROGRAM OF SOUTHERN CALIFORNIA INC ,DCH_BREAKFAST,21,0,0,0,0,70998,0,0,70998,3380.8571
SAN DIEGO,Jun 2014,DCH,2014,CHILD NUTRITION PROGRAM OF SOUTHERN CALIFORNIA INC ,DCH_BREAKFAST,,0,0,0,0,0,441,15428,15869,0
SAN DIEGO,Jun 2014,DCH,2014,CHILD NUTRITION PROGRAM OF SOUTHERN CALIFORNIA INC ,DCH_BREAKFAST,21,0,0,0,0,0,0,0,0,0
SAN DIEGO,Jun 2014,DCH,2014,CHILD NUTRITION PROGRAM OF SOUTHERN CALIFORNIA INC ,DCH_BREAKFAST,21,0,0,0,0,0,0,0,0,0
SAN DIEGO,Jun 2014,DCH,2014,CHILD NUTRITION PROGRAM OF SOUTHERN CALIFORNIA INC ,DCH_BREAKFAST,21,0,0,0,0,0,0,0,0,0
SAN DIEGO,Jun 2014,DCH,2014,CHILD NUTRITION PROGRAM OF SOUTHERN CALIFORNIA INC ,DCH_LUNCH,21,0,0,0,0,93997,0,0,93997,4476.0476
SAN DIEGO,Jun 2014,DCH,2014,CHILD NUTRITION PROGRAM OF SOUTHERN CALIFORNIA INC ,DCH_LUNCH,,0,0,0,0,0,654,22452,23106,0
SAN DIEGO,Jun 2014,DCH,2014,CHILD NUTRITION PROGRAM OF SOUTHERN CALIFORNIA INC ,DCH_LUNCH,21,0,0,0,0,0,0,0,0,0
SAN DIEGO,Jun 2014,DCH,2014,CHILD NUTRITION PROGRAM OF SOUTHERN CALIFORNIA INC ,DCH_LUNCH,21,0,0,0,0,0,0,0,0,0
SAN DIEGO,Jun 2014,DCH,2014,CHILD NUTRITION PROGRAM OF SOUTHERN CALIFORNIA INC ,DCH_LUNCH,21,0,0,0,0,0,0,0,0,0
SAN DIEGO,Jun 2014,DCH,2014,CHILD NUTRITION PROGRAM OF SOUTHERN CALIFORNIA INC ,DCH_SNACK_AM,21,0,0,0,0,38479,0,0,38479,1832.3333
SAN DIEGO,Jun 2014,DCH,2014,CHILD NUTRITION PROGRAM OF SOUTHERN CALIFORNIA INC ,DCH_SNACK_AM,,0,0,0,0,0,323,9706,10029,0
SAN DIEGO,Jun 2014,DCH,2014,CHILD NUTRITION PROGRAM OF SOUTHERN CALIFORNIA INC ,DCH_SNACK_AM,21,0,0,0,0,0,0,0,0,0
SAN DIEGO,Jun 2014,DCH,2014,CHILD NUTRITION PROGRAM OF SOUTHERN CALIFORNIA INC ,DCH_SNACK_AM,21,0,0,0,0,0,0,0,0,0
SAN DIEGO,Jun 2014,DCH,2014,CHILD NUTRITION PROGRAM OF SOUTHERN CALIFORNIA INC ,DCH_SNACK_AM,21,0,0,0,0,0,0,0,0,0
SAN DIEGO,Jun 2014,DCH,2014,CHILD NUTRITION PROGRAM OF SOUTHERN CALIFORNIA INC ,DCH_SNACK_NT,21,0,0,0,0,2059,0,0,2059,98.0476
SAN DIEGO,Jun 2014,DCH,2014,CHILD NUTRITION PROGRAM OF SOUTHERN CALIFORNIA INC ,DCH_SNACK_NT,,0,0,0,0,0,30,46,76,0
SAN DIEGO,Jun 2014,DCH,2014,CHILD NUTRITION PROGRAM OF SOUTHERN CALIFORNIA INC ,DCH_SNACK_NT,21,0,0,0,0,0,0,0,0,0
SAN DIEGO,Jun 2014,DCH,2014,CHILD NUTRITION PROGRAM OF SOUTHERN CALIFORNIA INC ,DCH_SNACK_NT,21,0,0,0,0,0,0,0,0,0
SAN DIEGO,Jun 2014,DCH,2014,CHILD NUTRITION PROGRAM OF SOUTHERN CALIFORNIA INC ,DCH_SNACK_NT,21,0,0,0,0,0,0,0,0,0
SAN DIEGO,Jun 2014,DCH,2014,CHILD NUTRITION PROGRAM OF SOUTHERN CALIFORNIA INC ,DCH_SNACK_PM,21,0,0,0,0,69959,0,0,69959,3331.381
SAN DIEGO,Jun 2014,DCH,2014,CHILD NUTRITION PROGRAM OF SOUTHERN CALIFORNIA INC ,DCH_SNACK_PM,,0,0,0,0,0,498,15014,15512,0
SAN DIEGO,Jun 2014,DCH,2014,CHILD NUTRITION PROGRAM OF SOUTHERN CALIFORNIA INC ,DCH_SNACK_PM,21,0,0,0,0,0,0,0,0,0
SAN DIEGO,Jun 2014,DCH,2014,CHILD NUTRITION PROGRAM OF SOUTHERN CALIFORNIA INC ,DCH_SNACK_PM,21,0,0,0,0,0,0,0,0,0
SAN DIEGO,Jun 2014,DCH,2014,CHILD NUTRITION PROGRAM OF SOUTHERN CALIFORNIA INC ,DCH_SNACK_PM,21,0,0,0,0,0,0,0,0,0
SAN DIEGO,Jun 2014,DCH,2014,CHILD NUTRITION PROGRAM OF SOUTHERN CALIFORNIA INC ,DCH_SUPPER,21,0,0,0,0,31940,0,0,31940,1520.9524
SAN DIEGO,Jun 2014,DCH,2014,CHILD NUTRITION PROGRAM OF SOUTHERN CALIFORNIA INC ,DCH_SUPPER,,0,0,0,0,0,495,5350,5845,0
SAN DIEGO,Jun 2014,DCH,2014,CHILD NUTRITION PROGRAM OF SOUTHERN CALIFORNIA INC ,DCH_SUPPER,21,0,0,0,0,0,0,0,0,0
SAN DIEGO,Jun 2014,DCH,2014,CHILD NUTRITION PROGRAM OF SOUTHERN CALIFORNIA INC ,DCH_SUPPER,21,0,0,0,0,0,0,0,0,0
SAN DIEGO,Jun 2014,DCH,2014,CHILD NUTRITION PROGRAM OF SOUTHERN CALIFORNIA INC ,DCH_SUPPER,21,0,0,0,0,0,0,0,0,0
SAN DIEGO,Jul 2014,DCH,2014,CHILD NUTRITION PROGRAM OF SOUTHERN CALIFORNIA INC ,DCH_BREAKFAST,22,0,0,0,0,69022,0,0,69022,3137.3636
SAN DIEGO,Jul 2014,DCH,2014,CHILD NUTRITION PROGRAM OF SOUTHERN CALIFORNIA INC ,DCH_BREAKFAST,,0,0,0,0,0,368,16002,16370,0
SAN DIEGO,Jul 2014,DCH,2014,CHILD NUTRITION PROGRAM OF SOUTHERN CALIFORNIA INC ,DCH_BREAKFAST,22,0,0,0,0,0,0,0,0,0
SAN DIEGO,Jul 2014,DCH,2014,CHILD NUTRITION PROGRAM OF SOUTHERN CALIFORNIA INC ,DCH_BREAKFAST,22,0,0,0,0,0,0,0,0,0
SAN DIEGO,Jul 2014,DCH,2014,CHILD NUTRITION PROGRAM OF SOUTHERN CALIFORNIA INC ,DCH_BREAKFAST,22,0,0,0,0,0,0,0,0,0
SAN DIEGO,Jul 2014,DCH,2014,CHILD NUTRITION PROGRAM OF SOUTHERN CALIFORNIA INC ,DCH_LUNCH,22,0,0,0,0,99033,0,0,99033,4501.5
SAN DIEGO,Jul 2014,DCH,2014,CHILD NUTRITION PROGRAM OF SOUTHERN CALIFORNIA INC ,DCH_LUNCH,,0,0,0,0,0,541,23068,23609,0
SAN DIEGO,Jul 2014,DCH,2014,CHILD NUTRITION PROGRAM OF SOUTHERN CALIFORNIA INC ,DCH_LUNCH,22,0,0,0,0,0,0,0,0,0
SAN DIEGO,Jul 2014,DCH,2014,CHILD NUTRITION PROGRAM OF SOUTHERN CALIFORNIA INC ,DCH_LUNCH,22,0,0,0,0,0,0,0,0,0
SAN DIEGO,Jul 2014,DCH,2014,CHILD NUTRITION PROGRAM OF SOUTHERN CALIFORNIA INC ,DCH_LUNCH,22,0,0,0,0,0,0,0,0,0
SAN DIEGO,Jul 2014,DCH,2014,CHILD NUTRITION PROGRAM OF SOUTHERN CALIFORNIA INC ,DCH_SNACK_AM,22,0,0,0,0,40396,0,0,40396,1836.1818
SAN DIEGO,Jul 2014,DCH,2014,CHILD NUTRITION PROGRAM OF SOUTHERN CALIFORNIA INC ,DCH_SNACK_AM,,0,0,0,0,0,330,10225,10555,0
SAN DIEGO,Jul 2014,DCH,2014,CHILD NUTRITION PROGRAM OF SOUTHERN CALIFORNIA INC ,DCH_SNACK_AM,22,0,0,0,0,0,0,0,0,0
SAN DIEGO,Jul 2014,DCH,2014,CHILD NUTRITION PROGRAM OF SOUTHERN CALIFORNIA INC ,DCH_SNACK_AM,22,0,0,0,0,0,0,0,0,0
SAN DIEGO,Jul 2014,DCH,2014,CHILD NUTRITION PROGRAM OF SOUTHERN CALIFORNIA INC ,DCH_SNACK_AM,22,0,0,0,0,0,0,0,0,0
SAN DIEGO,Jul 2014,DCH,2014,CHILD NUTRITION PROGRAM OF SOUTHERN CALIFORNIA INC ,DCH_SNACK_NT,22,0,0,0,0,2030,0,0,2030,92.2727
SAN DIEGO,Jul 2014,DCH,2014,CHILD NUTRITION PROGRAM OF SOUTHERN CALIFORNIA INC ,DCH_SNACK_NT,,0,0,0,0,0,11,48,59,0
SAN DIEGO,Jul 2014,DCH,2014,CHILD NUTRITION PROGRAM OF SOUTHERN CALIFORNIA INC ,DCH_SNACK_NT,22,0,0,0,0,0,0,0,0,0
SAN DIEGO,Jul 2014,DCH,2014,CHILD NUTRITION PROGRAM OF SOUTHERN CALIFORNIA INC ,DCH_SNACK_NT,22,0,0,0,0,0,0,0,0,0
SAN DIEGO,Jul 2014,DCH,2014,CHILD NUTRITION PROGRAM OF SOUTHERN CALIFORNIA INC ,DCH_SNACK_NT,22,0,0,0,0,0,0,0,0,0
SAN DIEGO,Jul 2014,DCH,2014,CHILD NUTRITION PROGRAM OF SOUTHERN CALIFORNIA INC ,DCH_SNACK_PM,22,0,0,0,0,67537,0,0,67537,3069.8636
SAN DIEGO,Jul 2014,DCH,2014,CHILD NUTRITION PROGRAM OF SOUTHERN CALIFORNIA INC ,DCH_SNACK_PM,,0,0,0,0,0,269,14294,14563,0
SAN DIEGO,Jul 2014,DCH,2014,CHILD NUTRITION PROGRAM OF SOUTHERN CALIFORNIA INC ,DCH_SNACK_PM,22,0,0,0,0,0,0,0,0,0
SAN DIEGO,Jul 2014,DCH,2014,CHILD NUTRITION PROGRAM OF SOUTHERN CALIFORNIA INC ,DCH_SNACK_PM,22,0,0,0,0,0,0,0,0,0
SAN DIEGO,Jul 2014,DCH,2014,CHILD NUTRITION PROGRAM OF SOUTHERN CALIFORNIA INC ,DCH_SNACK_PM,22,0,0,0,0,0,0,0,0,0
SAN DIEGO,Jul 2014,DCH,2014,CHILD NUTRITION PROGRAM OF SOUTHERN CALIFORNIA INC ,DCH_SUPPER,22,0,0,0,0,31891,0,0,31891,1449.5909
SAN DIEGO,Jul 2014,DCH,2014,CHILD NUTRITION PROGRAM OF SOUTHERN CALIFORNIA INC ,DCH_SUPPER,,0,0,0,0,0,249,5761,6010,0
SAN DIEGO,Jul 2014,DCH,2014,CHILD NUTRITION PROGRAM OF SOUTHERN CALIFORNIA INC ,DCH_SUPPER,22,0,0,0,0,0,0,0,0,0
SAN DIEGO,Jul 2014,DCH,2014,CHILD NUTRITION PROGRAM OF SOUTHERN CALIFORNIA INC ,DCH_SUPPER,22,0,0,0,0,0,0,0,0,0
SAN DIEGO,Jul 2014,DCH,2014,CHILD NUTRITION PROGRAM OF SOUTHERN CALIFORNIA INC ,DCH_SUPPER,22,0,0,0,0,0,0,0,0,0
SAN DIEGO,Aug 2014,DCH,2014,CHILD NUTRITION PROGRAM OF SOUTHERN CALIFORNIA INC ,DCH_BREAKFAST,21,0,0,0,0,70665,0,0,70665,3365
SAN DIEGO,Aug 2014,DCH,2014,CHILD NUTRITION PROGRAM OF SOUTHERN CALIFORNIA INC ,DCH_BREAKFAST,,0,0,0,0,0,471,15805,16276,0
SAN DIEGO,Aug 2014,DCH,2014,CHILD NUTRITION PROGRAM OF SOUTHERN CALIFORNIA INC ,DCH_BREAKFAST,21,0,0,0,0,0,0,0,0,0
SAN DIEGO,Aug 2014,DCH,2014,CHILD NUTRITION PROGRAM OF SOUTHERN CALIFORNIA INC ,DCH_BREAKFAST,21,0,0,0,0,0,0,0,0,0
SAN DIEGO,Aug 2014,DCH,2014,CHILD NUTRITION PROGRAM OF SOUTHERN CALIFORNIA INC ,DCH_BREAKFAST,21,0,0,0,0,0,0,0,0,0
SAN DIEGO,Aug 2014,DCH,2014,CHILD NUTRITION PROGRAM OF SOUTHERN CALIFORNIA INC ,DCH_LUNCH,21,0,0,0,0,0,0,0,0,0
SAN DIEGO,Aug 2014,DCH,2014,CHILD NUTRITION PROGRAM OF SOUTHERN CALIFORNIA INC ,DCH_LUNCH,21,0,0,0,0,0,0,0,0,0
SAN DIEGO,Aug 2014,DCH,2014,CHILD NUTRITION PROGRAM OF SOUTHERN CALIFORNIA INC ,DCH_LUNCH,21,0,0,0,0,0,0,0,0,0
SAN DIEGO,Aug 2014,DCH,2014,CHILD NUTRITION PROGRAM OF SOUTHERN CALIFORNIA INC ,DCH_LUNCH,,0,0,0,0,0,529,21280,21809,0
SAN DIEGO,Aug 2014,DCH,2014,CHILD NUTRITION PROGRAM OF SOUTHERN CALIFORNIA INC ,DCH_LUNCH,21,0,0,0,0,84278,0,0,84278,4013.2381
SAN DIEGO,Aug 2014,DCH,2014,CHILD NUTRITION PROGRAM OF SOUTHERN CALIFORNIA INC ,DCH_SNACK_AM,21,0,0,0,0,35167,0,0,35167,1674.619
SAN DIEGO,Aug 2014,DCH,2014,CHILD NUTRITION PROGRAM OF SOUTHERN CALIFORNIA INC ,DCH_SNACK_AM,,0,0,0,0,0,299,9895,10194,0
SAN DIEGO,Aug 2014,DCH,2014,CHILD NUTRITION PROGRAM OF SOUTHERN CALIFORNIA INC ,DCH_SNACK_AM,21,0,0,0,0,0,0,0,0,0
SAN DIEGO,Aug 2014,DCH,2014,CHILD NUTRITION PROGRAM OF SOUTHERN CALIFORNIA INC ,DCH_SNACK_AM,21,0,0,0,0,0,0,0,0,0
SAN DIEGO,Aug 2014,DCH,2014,CHILD NUTRITION PROGRAM OF SOUTHERN CALIFORNIA INC ,DCH_SNACK_AM,21,0,0,0,0,0,0,0,0,0
SAN DIEGO,Aug 2014,DCH,2014,CHILD NUTRITION PROGRAM OF SOUTHERN CALIFORNIA INC ,DCH_SNACK_NT,21,0,0,0,0,0,0,0,0,0
SAN DIEGO,Aug 2014,DCH,2014,CHILD NUTRITION PROGRAM OF SOUTHERN CALIFORNIA INC ,DCH_SNACK_NT,21,0,0,0,0,0,0,0,0,0
SAN DIEGO,Aug 2014,DCH,2014,CHILD NUTRITION PROGRAM OF SOUTHERN CALIFORNIA INC ,DCH_SNACK_NT,21,0,0,0,0,0,0,0,0,0
SAN DIEGO,Aug 2014,DCH,2014,CHILD NUTRITION PROGRAM OF SOUTHERN CALIFORNIA INC ,DCH_SNACK_NT,,0,0,0,0,0,36,48,84,0
SAN DIEGO,Aug 2014,DCH,2014,CHILD NUTRITION PROGRAM OF SOUTHERN CALIFORNIA INC ,DCH_SNACK_NT,21,0,0,0,0,2126,0,0,2126,101.2381
SAN DIEGO,Aug 2014,DCH,2014,CHILD NUTRITION PROGRAM OF SOUTHERN CALIFORNIA INC ,DCH_SNACK_PM,21,0,0,0,0,69586,0,0,69586,3313.619
SAN DIEGO,Aug 2014,DCH,2014,CHILD NUTRITION PROGRAM OF SOUTHERN CALIFORNIA INC ,DCH_SNACK_PM,,0,0,0,0,0,333,14397,14730,0
SAN DIEGO,Aug 2014,DCH,2014,CHILD NUTRITION PROGRAM OF SOUTHERN CALIFORNIA INC ,DCH_SNACK_PM,21,0,0,0,0,0,0,0,0,0
SAN DIEGO,Aug 2014,DCH,2014,CHILD NUTRITION PROGRAM OF SOUTHERN CALIFORNIA INC ,DCH_SNACK_PM,21,0,0,0,0,0,0,0,0,0
SAN DIEGO,Aug 2014,DCH,2014,CHILD NUTRITION PROGRAM OF SOUTHERN CALIFORNIA INC ,DCH_SNACK_PM,21,0,0,0,0,0,0,0,0,0
SAN DIEGO,Aug 2014,DCH,2014,CHILD NUTRITION PROGRAM OF SOUTHERN CALIFORNIA INC ,DCH_SUPPER,21,0,0,0,0,0,0,0,0,0
SAN DIEGO,Aug 2014,DCH,2014,CHILD NUTRITION PROGRAM OF SOUTHERN CALIFORNIA INC ,DCH_SUPPER,21,0,0,0,0,0,0,0,0,0
SAN DIEGO,Aug 2014,DCH,2014,CHILD NUTRITION PROGRAM OF SOUTHERN CALIFORNIA INC ,DCH_SUPPER,21,0,0,0,0,0,0,0,0,0
SAN DIEGO,Aug 2014,DCH,2014,CHILD NUTRITION PROGRAM OF SOUTHERN CALIFORNIA INC ,DCH_SUPPER,,0,0,0,0,0,327,5308,5635,0
SAN DIEGO,Aug 2014,DCH,2014,CHILD NUTRITION PROGRAM OF SOUTHERN CALIFORNIA INC ,DCH_SUPPER,21,0,0,0,0,32458,0,0,32458,1545.619
SAN DIEGO,Sep 2014,DCH,2014,CHILD NUTRITION PROGRAM OF SOUTHERN CALIFORNIA INC ,DCH_BREAKFAST,21,0,0,0,0,73499,0,0,73499,3499.9524
SAN DIEGO,Sep 2014,DCH,2014,CHILD NUTRITION PROGRAM OF SOUTHERN CALIFORNIA INC ,DCH_BREAKFAST,,0,0,0,0,0,525,16246,16771,0
SAN DIEGO,Sep 2014,DCH,2014,CHILD NUTRITION PROGRAM OF SOUTHERN CALIFORNIA INC ,DCH_BREAKFAST,21,0,0,0,0,0,0,0,0,0
SAN DIEGO,Sep 2014,DCH,2014,CHILD NUTRITION PROGRAM OF SOUTHERN CALIFORNIA INC ,DCH_BREAKFAST,21,0,0,0,0,0,0,0,0,0
SAN DIEGO,Sep 2014,DCH,2014,CHILD NUTRITION PROGRAM OF SOUTHERN CALIFORNIA INC ,DCH_BREAKFAST,21,0,0,0,0,0,0,0,0,0
SAN DIEGO,Sep 2014,DCH,2014,CHILD NUTRITION PROGRAM OF SOUTHERN CALIFORNIA INC ,DCH_LUNCH,21,0,0,0,0,0,0,0,0,0
SAN DIEGO,Sep 2014,DCH,2014,CHILD NUTRITION PROGRAM OF SOUTHERN CALIFORNIA INC ,DCH_LUNCH,21,0,0,0,0,0,0,0,0,0
SAN DIEGO,Sep 2014,DCH,2014,CHILD NUTRITION PROGRAM OF SOUTHERN CALIFORNIA INC ,DCH_LUNCH,21,0,0,0,0,0,0,0,0,0
SAN DIEGO,Sep 2014,DCH,2014,CHILD NUTRITION PROGRAM OF SOUTHERN CALIFORNIA INC ,DCH_LUNCH,,0,0,0,0,0,456,20188,20644,0
SAN DIEGO,Sep 2014,DCH,2014,CHILD NUTRITION PROGRAM OF SOUTHERN CALIFORNIA INC ,DCH_LUNCH,21,0,0,0,0,74596,0,0,74596,3552.1905
SAN DIEGO,Sep 2014,DCH,2014,CHILD NUTRITION PROGRAM OF SOUTHERN CALIFORNIA INC ,DCH_SNACK_AM,21,0,0,0,0,31176,0,0,31176,1484.5714
SAN DIEGO,Sep 2014,DCH,2014,CHILD NUTRITION PROGRAM OF SOUTHERN CALIFORNIA INC ,DCH_SNACK_AM,,0,0,0,0,0,193,9497,9690,0
SAN DIEGO,Sep 2014,DCH,2014,CHILD NUTRITION PROGRAM OF SOUTHERN CALIFORNIA INC ,DCH_SNACK_AM,21,0,0,0,0,0,0,0,0,0
SAN DIEGO,Sep 2014,DCH,2014,CHILD NUTRITION PROGRAM OF SOUTHERN CALIFORNIA INC ,DCH_SNACK_AM,21,0,0,0,0,0,0,0,0,0
SAN DIEGO,Sep 2014,DCH,2014,CHILD NUTRITION PROGRAM OF SOUTHERN CALIFORNIA INC ,DCH_SNACK_AM,21,0,0,0,0,0,0,0,0,0
SAN DIEGO,Sep 2014,DCH,2014,CHILD NUTRITION PROGRAM OF SOUTHERN CALIFORNIA INC ,DCH_SNACK_NT,21,0,0,0,0,0,0,0,0,0
SAN DIEGO,Sep 2014,DCH,2014,CHILD NUTRITION PROGRAM OF SOUTHERN CALIFORNIA INC ,DCH_SNACK_NT,21,0,0,0,0,0,0,0,0,0
SAN DIEGO,Sep 2014,DCH,2014,CHILD NUTRITION PROGRAM OF SOUTHERN CALIFORNIA INC ,DCH_SNACK_NT,21,0,0,0,0,0,0,0,0,0
SAN DIEGO,Sep 2014,DCH,2014,CHILD NUTRITION PROGRAM OF SOUTHERN CALIFORNIA INC ,DCH_SNACK_NT,,0,0,0,0,0,44,53,97,0
SAN DIEGO,Sep 2014,DCH,2014,CHILD NUTRITION PROGRAM OF SOUTHERN CALIFORNIA INC ,DCH_SNACK_NT,21,0,0,0,0,2586,0,0,2586,123.1429
SAN DIEGO,Sep 2014,DCH,2014,CHILD NUTRITION PROGRAM OF SOUTHERN CALIFORNIA INC ,DCH_SNACK_PM,21,0,0,0,0,75552,0,0,75552,3597.7143
SAN DIEGO,Sep 2014,DCH,2014,CHILD NUTRITION PROGRAM OF SOUTHERN CALIFORNIA INC ,DCH_SNACK_PM,,0,0,0,0,0,453,15439,15892,0
SAN DIEGO,Sep 2014,DCH,2014,CHILD NUTRITION PROGRAM OF SOUTHERN CALIFORNIA INC ,DCH_SNACK_PM,21,0,0,0,0,0,0,0,0,0
SAN DIEGO,Sep 2014,DCH,2014,CHILD NUTRITION PROGRAM OF SOUTHERN CALIFORNIA INC ,DCH_SNACK_PM,21,0,0,0,0,0,0,0,0,0
SAN DIEGO,Sep 2014,DCH,2014,CHILD NUTRITION PROGRAM OF SOUTHERN CALIFORNIA INC ,DCH_SNACK_PM,21,0,0,0,0,0,0,0,0,0
SAN DIEGO,Sep 2014,DCH,2014,CHILD NUTRITION PROGRAM OF SOUTHERN CALIFORNIA INC ,DCH_SUPPER,21,0,0,0,0,0,0,0,0,0
SAN DIEGO,Sep 2014,DCH,2014,CHILD NUTRITION PROGRAM OF SOUTHERN CALIFORNIA INC ,DCH_SUPPER,21,0,0,0,0,0,0,0,0,0
SAN DIEGO,Sep 2014,DCH,2014,CHILD NUTRITION PROGRAM OF SOUTHERN CALIFORNIA INC ,DCH_SUPPER,21,0,0,0,0,0,0,0,0,0
SAN DIEGO,Sep 2014,DCH,2014,CHILD NUTRITION PROGRAM OF SOUTHERN CALIFORNIA INC ,DCH_SUPPER,,0,0,0,0,0,439,5170,5609,0
SAN DIEGO,Sep 2014,DCH,2014,CHILD NUTRITION PROGRAM OF SOUTHERN CALIFORNIA INC ,DCH_SUPPER,21,0,0,0,0,33624,0,0,33624,1601.1429
SAN DIEGO,Oct 2013,CACF,2014,CHILDREN OF THE RAINBOW INC,CHILD_BREAKFAST,23,85,22,11,118,1191,308,154,1653,71.8696
SAN DIEGO,Oct 2013,CACF,2014,CHILDREN OF THE RAINBOW INC,CHILD_LUNCH,23,85,22,11,118,1472,381,191,2044,88.8696
SAN DIEGO,Oct 2013,CACF,2014,CHILDREN OF THE RAINBOW INC,CHILD_SNACK_AM,23,85,22,11,118,1402,363,181,1946,84.6087
SAN DIEGO,Oct 2013,CACF,2014,CHILDREN OF THE RAINBOW INC,CHILD_SNACK_PM,23,85,22,11,118,281,73,36,390,16.9565
SAN DIEGO,Nov 2013,CACF,2014,CHILDREN OF THE RAINBOW INC,CHILD_BREAKFAST,18,85,22,11,118,963,249,125,1337,74.2778
SAN DIEGO,Nov 2013,CACF,2014,CHILDREN OF THE RAINBOW INC,CHILD_LUNCH,18,85,22,11,118,1178,305,153,1636,90.8889
SAN DIEGO,Nov 2013,CACF,2014,CHILDREN OF THE RAINBOW INC,CHILD_SNACK_AM,18,85,22,11,118,1109,287,144,1540,85.5556
SAN DIEGO,Nov 2013,CACF,2014,CHILDREN OF THE RAINBOW INC,CHILD_SNACK_PM,18,85,22,11,118,227,59,29,315,17.5
SAN DIEGO,Dec 2013,CACF,2014,CHILDREN OF THE RAINBOW INC,CHILD_BREAKFAST,21,85,22,11,118,1019,264,132,1415,67.381
SAN DIEGO,Dec 2013,CACF,2014,CHILDREN OF THE RAINBOW INC,CHILD_LUNCH,21,85,22,11,118,1266,328,164,1758,83.7143
SAN DIEGO,Dec 2013,CACF,2014,CHILDREN OF THE RAINBOW INC,CHILD_SNACK_AM,21,85,22,11,118,1195,309,155,1659,79
SAN DIEGO,Dec 2013,CACF,2014,CHILDREN OF THE RAINBOW INC,CHILD_SNACK_PM,21,85,22,11,118,251,65,33,349,16.619
SAN DIEGO,Jan 2014,CACF,2014,CHILDREN OF THE RAINBOW INC,CHILD_BREAKFAST,21,85,22,11,118,1114,288,145,1547,73.6667
SAN DIEGO,Jan 2014,CACF,2014,CHILDREN OF THE RAINBOW INC,CHILD_LUNCH,21,85,22,11,118,1370,355,177,1902,90.5714
SAN DIEGO,Jan 2014,CACF,2014,CHILDREN OF THE RAINBOW INC,CHILD_SNACK_AM,21,85,22,11,118,1306,338,169,1813,86.3333
SAN DIEGO,Jan 2014,CACF,2014,CHILDREN OF THE RAINBOW INC,CHILD_SNACK_PM,21,85,22,11,118,241,62,32,335,15.9524
SAN DIEGO,Feb 2014,CACF,2014,CHILDREN OF THE RAINBOW INC,CHILD_BREAKFAST,19,85,22,11,118,1122,290,145,1557,81.9474
SAN DIEGO,Feb 2014,CACF,2014,CHILDREN OF THE RAINBOW INC,CHILD_LUNCH,19,85,22,11,118,1356,351,175,1882,99.0526
SAN DIEGO,Feb 2014,CACF,2014,CHILDREN OF THE RAINBOW INC,CHILD_SNACK_AM,19,85,22,11,118,1293,335,167,1795,94.4737
SAN DIEGO,Feb 2014,CACF,2014,CHILDREN OF THE RAINBOW INC,CHILD_SNACK_PM,19,85,22,11,118,246,64,31,341,17.9474
SAN DIEGO,Mar 2014,CACF,2014,CHILDREN OF THE RAINBOW INC,CHILD_BREAKFAST,20,85,22,11,118,1256,325,163,1744,87.2
SAN DIEGO,Mar 2014,CACF,2014,CHILDREN OF THE RAINBOW INC,CHILD_LUNCH,20,85,22,11,118,1588,411,206,2205,110.25
SAN DIEGO,Mar 2014,CACF,2014,CHILDREN OF THE RAINBOW INC,CHILD_SNACK_AM,20,85,22,11,118,1576,408,204,2188,109.4
SAN DIEGO,Mar 2014,CACF,2014,CHILDREN OF THE RAINBOW INC,CHILD_SNACK_PM,20,85,22,11,118,334,86,44,464,23.2
SAN DIEGO,Apr 2014,CACF,2014,CHILDREN OF THE RAINBOW INC,CHILD_BREAKFAST,22,85,22,11,118,1397,362,181,1940,88.1818
SAN DIEGO,Apr 2014,CACF,2014,CHILDREN OF THE RAINBOW INC,CHILD_LUNCH,22,85,22,11,118,1704,441,221,2366,107.5455
SAN DIEGO,Apr 2014,CACF,2014,CHILDREN OF THE RAINBOW INC,CHILD_SNACK_AM,22,85,22,11,118,1675,434,217,2326,105.7273
SAN DIEGO,Apr 2014,CACF,2014,CHILDREN OF THE RAINBOW INC,CHILD_SNACK_PM,22,85,22,11,118,297,77,39,413,18.7727
SAN DIEGO,May 2014,CACF,2014,CHILDREN OF THE RAINBOW INC,CHILD_BREAKFAST,21,85,22,11,118,1380,357,179,1916,91.2381
SAN DIEGO,May 2014,CACF,2014,CHILDREN OF THE RAINBOW INC,CHILD_LUNCH,21,85,22,11,118,1675,434,217,2326,110.7619
SAN DIEGO,May 2014,CACF,2014,CHILDREN OF THE RAINBOW INC,CHILD_SNACK_AM,21,85,22,11,118,1616,418,209,2243,106.8095
SAN DIEGO,May 2014,CACF,2014,CHILDREN OF THE RAINBOW INC,CHILD_SNACK_PM,21,85,22,11,118,300,78,39,417,19.8571
SAN DIEGO,Jun 2014,CACF,2014,CHILDREN OF THE RAINBOW INC,CHILD_BREAKFAST,21,85,22,11,118,1286,333,167,1786,85.0476
SAN DIEGO,Jun 2014,CACF,2014,CHILDREN OF THE RAINBOW INC,CHILD_LUNCH,21,85,22,11,118,1599,414,207,2220,105.7143
SAN DIEGO,Jun 2014,CACF,2014,CHILDREN OF THE RAINBOW INC,CHILD_SNACK_AM,21,85,22,11,118,1550,401,201,2152,102.4762
SAN DIEGO,Jun 2014,CACF,2014,CHILDREN OF THE RAINBOW INC,CHILD_SNACK_PM,21,85,22,11,118,308,80,40,428,20.381
SAN DIEGO,Jul 2014,CACF,2014,CHILDREN OF THE RAINBOW INC,CHILD_BREAKFAST,22,85,22,11,118,1329,344,172,1845,83.8636
SAN DIEGO,Jul 2014,CACF,2014,CHILDREN OF THE RAINBOW INC,CHILD_LUNCH,22,85,22,11,118,1629,421,211,2261,102.7727
SAN DIEGO,Jul 2014,CACF,2014,CHILDREN OF THE RAINBOW INC,CHILD_SNACK_AM,22,85,22,11,118,1568,406,203,2177,98.9545
SAN DIEGO,Jul 2014,CACF,2014,CHILDREN OF THE RAINBOW INC,CHILD_SNACK_PM,22,85,22,11,118,284,73,37,394,17.9091
SAN DIEGO,Aug 2014,CACF,2014,CHILDREN OF THE RAINBOW INC,CHILD_BREAKFAST,19,85,22,11,118,1212,314,156,1682,88.5263
SAN DIEGO,Aug 2014,CACF,2014,CHILDREN OF THE RAINBOW INC,CHILD_LUNCH,19,85,22,11,118,1438,372,187,1997,105.1053
SAN DIEGO,Aug 2014,CACF,2014,CHILDREN OF THE RAINBOW INC,CHILD_SNACK_AM,19,85,22,11,118,1414,366,183,1963,103.3158
SAN DIEGO,Aug 2014,CACF,2014,CHILDREN OF THE RAINBOW INC,CHILD_SNACK_PM,19,85,22,11,118,207,54,27,288,15.1579
SAN DIEGO,Sep 2014,CACF,2014,CHILDREN OF THE RAINBOW INC,CHILD_BREAKFAST,21,85,22,11,118,1333,345,173,1851,88.1429
SAN DIEGO,Sep 2014,CACF,2014,CHILDREN OF THE RAINBOW INC,CHILD_LUNCH,21,85,22,11,118,1523,394,198,2115,100.7143
SAN DIEGO,Sep 2014,CACF,2014,CHILDREN OF THE RAINBOW INC,CHILD_SNACK_AM,21,85,22,11,118,1508,390,196,2094,99.7143
SAN DIEGO,Sep 2014,CACF,2014,CHILDREN OF THE RAINBOW INC,CHILD_SNACK_PM,21,85,22,11,118,161,42,20,223,10.619
SAN DIEGO,Oct 2013,CACF,2014,CHILDRENS PARADISE INC,CHILD_BREAKFAST,23,183,52,164,399,1502,427,1346,3275,142.3913
SAN DIEGO,Oct 2013,CACF,2014,CHILDRENS PARADISE INC,CHILD_LUNCH,23,183,52,164,399,2236,635,2005,4876,212
SAN DIEGO,Oct 2013,CACF,2014,CHILDRENS PARADISE INC,CHILD_SNACK_PM,23,183,52,164,399,1813,515,1626,3954,171.913
SAN DIEGO,Oct 2013,CACF,2014,CHILDRENS PARADISE INC,OSCH_CHILD_BREAKFAST,23,62,10,10,82,293,47,47,387,16.8261
SAN DIEGO,Oct 2013,CACF,2014,CHILDRENS PARADISE INC,OSCH_CHILD_LUNCH,23,62,10,10,82,155,25,25,205,8.913
SAN DIEGO,Oct 2013,CACF,2014,CHILDRENS PARADISE INC,OSCH_CHILD_SNACK_PM,23,62,10,10,82,721,116,117,954,41.4783
SAN DIEGO,Nov 2013,CACF,2014,CHILDRENS PARADISE INC,CHILD_BREAKFAST,19,183,52,164,399,1375,391,1232,2998,157.7895
SAN DIEGO,Nov 2013,CACF,2014,CHILDRENS PARADISE INC,CHILD_LUNCH,19,183,52,164,399,1997,567,1791,4355,229.2105
SAN DIEGO,Nov 2013,CACF,2014,CHILDRENS PARADISE INC,CHILD_SNACK_PM,19,183,52,164,399,1588,451,1424,3463,182.2632
SAN DIEGO,Nov 2013,CACF,2014,CHILDRENS PARADISE INC,OSCH_CHILD_BREAKFAST,19,64,10,10,84,246,38,39,323,17
SAN DIEGO,Nov 2013,CACF,2014,CHILDRENS PARADISE INC,OSCH_CHILD_LUNCH,19,64,10,10,84,290,45,45,380,20
SAN DIEGO,Nov 2013,CACF,2014,CHILDRENS PARADISE INC,OSCH_CHILD_SNACK_PM,19,64,10,10,84,491,77,77,645,33.9474
SAN DIEGO,Dec 2013,CACF,2014,CHILDRENS PARADISE INC,CHILD_BREAKFAST,19,224,61,182,467,1536,418,1248,3202,168.5263
SAN DIEGO,Dec 2013,CACF,2014,CHILDRENS PARADISE INC,CHILD_LUNCH,19,224,61,182,467,2064,562,1677,4303,226.4737
SAN DIEGO,Dec 2013,CACF,2014,CHILDRENS PARADISE INC,CHILD_SNACK_PM,19,224,61,182,467,1740,474,1414,3628,190.9474
SAN DIEGO,Dec 2013,CACF,2014,CHILDRENS PARADISE INC,OSCH_CHILD_BREAKFAST,19,65,10,10,85,202,31,31,264,13.8947
SAN DIEGO,Dec 2013,CACF,2014,CHILDRENS PARADISE INC,OSCH_CHILD_LUNCH,19,65,10,10,85,232,36,35,303,15.9474
SAN DIEGO,Dec 2013,CACF,2014,CHILDRENS PARADISE INC,OSCH_CHILD_SNACK_PM,19,65,10,10,85,464,71,72,607,31.9474
SAN DIEGO,Jan 2014,CACF,2014,CHILDRENS PARADISE INC,CHILD_BREAKFAST,22,241,66,180,487,1824,499,1363,3686,167.5455
SAN DIEGO,Jan 2014,CACF,2014,CHILDRENS PARADISE INC,CHILD_LUNCH,22,241,66,180,487,2657,727,1984,5368,244
SAN DIEGO,Jan 2014,CACF,2014,CHILDRENS PARADISE INC,CHILD_SNACK_PM,22,241,66,180,487,2478,679,1851,5008,227.6364
SAN DIEGO,Jan 2014,CACF,2014,CHILDRENS PARADISE INC,OSCH_CHILD_BREAKFAST,22,67,10,7,84,437,65,46,548,24.9091
SAN DIEGO,Jan 2014,CACF,2014,CHILDRENS PARADISE INC,OSCH_CHILD_LUNCH,22,67,10,7,84,314,47,33,394,17.9091
SAN DIEGO,Jan 2014,CACF,2014,CHILDRENS PARADISE INC,OSCH_CHILD_SNACK_PM,22,67,10,7,84,676,101,70,847,38.5
SAN DIEGO,Feb 2014,CACF,2014,CHILDRENS PARADISE INC,CHILD_BREAKFAST,19,258,68,189,515,1916,505,1403,3824,201.2632
SAN DIEGO,Feb 2014,CACF,2014,CHILDRENS PARADISE INC,CHILD_LUNCH,19,258,68,189,515,2520,664,1846,5030,264.7368
SAN DIEGO,Feb 2014,CACF,2014,CHILDRENS PARADISE INC,CHILD_SNACK_PM,19,258,68,189,515,2374,626,1739,4739,249.4211
SAN DIEGO,Feb 2014,CACF,2014,CHILDRENS PARADISE INC,OSCH_CHILD_BREAKFAST,19,70,10,6,86,202,29,17,248,13.0526
SAN DIEGO,Feb 2014,CACF,2014,CHILDRENS PARADISE INC,OSCH_CHILD_LUNCH,19,70,10,6,86,239,34,21,294,15.4737
SAN DIEGO,Feb 2014,CACF,2014,CHILDRENS PARADISE INC,OSCH_CHILD_SNACK_PM,19,70,10,6,86,602,86,52,740,38.9474
SAN DIEGO,Mar 2014,CACF,2014,CHILDRENS PARADISE INC,CHILD_BREAKFAST,21,258,68,189,515,2570,677,1883,5130,244.2857
SAN DIEGO,Mar 2014,CACF,2014,CHILDRENS PARADISE INC,CHILD_LUNCH,21,258,68,189,515,2939,774,2153,5866,279.3333
SAN DIEGO,Mar 2014,CACF,2014,CHILDRENS PARADISE INC,CHILD_SNACK_PM,21,258,68,189,515,2461,649,1803,4913,233.9524
SAN DIEGO,Mar 2014,CACF,2014,CHILDRENS PARADISE INC,OSCH_CHILD_BREAKFAST,21,70,10,6,86,458,65,40,563,26.8095
SAN DIEGO,Mar 2014,CACF,2014,CHILDRENS PARADISE INC,OSCH_CHILD_LUNCH,21,70,10,6,86,346,49,30,425,20.2381
SAN DIEGO,Mar 2014,CACF,2014,CHILDRENS PARADISE INC,OSCH_CHILD_SNACK_PM,21,70,10,6,86,778,111,67,956,45.5238
SAN DIEGO,Apr 2014,CACF,2014,CHILDRENS PARADISE INC,CHILD_BREAKFAST,22,362,79,207,648,2948,643,1687,5278,239.9091
SAN DIEGO,Apr 2014,CACF,2014,CHILDRENS PARADISE INC,CHILD_LUNCH,22,362,79,207,648,3949,862,2258,7069,321.3182
SAN DIEGO,Apr 2014,CACF,2014,CHILDRENS PARADISE INC,CHILD_SNACK_PM,22,362,79,207,648,3127,682,1789,5598,254.4545
SAN DIEGO,Apr 2014,CACF,2014,CHILDRENS PARADISE INC,OSCH_CHILD_BREAKFAST,22,72,10,6,88,439,61,37,537,24.4091
SAN DIEGO,Apr 2014,CACF,2014,CHILDRENS PARADISE INC,OSCH_CHILD_LUNCH,22,72,10,6,88,211,29,18,258,11.7273
SAN DIEGO,Apr 2014,CACF,2014,CHILDRENS PARADISE INC,OSCH_CHILD_SNACK_PM,22,72,10,6,88,837,116,70,1023,46.5
SAN DIEGO,May 2014,CACF,2014,CHILDRENS PARADISE INC,CHILD_BREAKFAST,21,362,79,207,648,2829,617,1618,5064,241.1429
SAN DIEGO,May 2014,CACF,2014,CHILDRENS PARADISE INC,CHILD_LUNCH,21,362,79,207,648,3438,750,1967,6155,293.0952
SAN DIEGO,May 2014,CACF,2014,CHILDRENS PARADISE INC,CHILD_SNACK_PM,21,362,79,207,648,2982,651,1706,5339,254.2381
SAN DIEGO,May 2014,CACF,2014,CHILDRENS PARADISE INC,OSCH_CHILD_BREAKFAST,21,72,10,6,88,371,51,31,453,21.5714
SAN DIEGO,May 2014,CACF,2014,CHILDRENS PARADISE INC,OSCH_CHILD_LUNCH,21,72,10,6,88,293,41,24,358,17.0476
SAN DIEGO,May 2014,CACF,2014,CHILDRENS PARADISE INC,OSCH_CHILD_SNACK_PM,21,72,10,6,88,776,108,64,948,45.1429
SAN DIEGO,Jun 2014,CACF,2014,CHILDRENS PARADISE INC,CHILD_BREAKFAST,21,362,79,207,648,2902,633,1660,5195,247.381
SAN DIEGO,Jun 2014,CACF,2014,CHILDRENS PARADISE INC,CHILD_LUNCH,21,362,79,207,648,3401,742,1946,6089,289.9524
SAN DIEGO,Jun 2014,CACF,2014,CHILDRENS PARADISE INC,CHILD_SNACK_PM,21,362,79,207,648,3009,657,1720,5386,256.4762
SAN DIEGO,Jun 2014,CACF,2014,CHILDRENS PARADISE INC,OSCH_CHILD_BREAKFAST,21,72,10,6,88,870,121,72,1063,50.619
SAN DIEGO,Jun 2014,CACF,2014,CHILDRENS PARADISE INC,OSCH_CHILD_LUNCH,21,72,10,6,88,911,126,76,1113,53
SAN DIEGO,Jun 2014,CACF,2014,CHILDRENS PARADISE INC,OSCH_CHILD_SNACK_PM,21,72,10,6,88,928,129,77,1134,54
SAN DIEGO,Jul 2014,CACF,2014,CHILDRENS PARADISE INC,CHILD_BREAKFAST,22,362,79,207,648,2680,585,1532,4797,218.0455
SAN DIEGO,Jul 2014,CACF,2014,CHILDRENS PARADISE INC,CHILD_LUNCH,22,362,79,207,648,3267,713,1869,5849,265.8636
SAN DIEGO,Jul 2014,CACF,2014,CHILDRENS PARADISE INC,CHILD_SNACK_PM,22,362,79,207,648,3018,659,1725,5402,245.5455
SAN DIEGO,Jul 2014,CACF,2014,CHILDRENS PARADISE INC,OSCH_CHILD_BREAKFAST,22,72,10,6,88,985,137,82,1204,54.7273
SAN DIEGO,Jul 2014,CACF,2014,CHILDRENS PARADISE INC,OSCH_CHILD_LUNCH,22,72,10,6,88,1110,154,93,1357,61.6818
SAN DIEGO,Jul 2014,CACF,2014,CHILDRENS PARADISE INC,OSCH_CHILD_SNACK_PM,22,72,10,6,88,1082,150,90,1322,60.0909
SAN DIEGO,Aug 2014,CACF,2014,CHILDRENS PARADISE INC,CHILD_BREAKFAST,21,362,79,207,648,2546,556,1456,4558,217.0476
SAN DIEGO,Aug 2014,CACF,2014,CHILDRENS PARADISE INC,CHILD_LUNCH,21,362,79,207,648,2991,653,1710,5354,254.9524
SAN DIEGO,Aug 2014,CACF,2014,CHILDRENS PARADISE INC,CHILD_SNACK_PM,21,362,79,207,648,2949,644,1686,5279,251.381
SAN DIEGO,Aug 2014,CACF,2014,CHILDRENS PARADISE INC,OSCH_CHILD_BREAKFAST,21,72,10,6,88,775,108,64,947,45.0952
SAN DIEGO,Aug 2014,CACF,2014,CHILDRENS PARADISE INC,OSCH_CHILD_LUNCH,21,72,10,6,88,649,90,54,793,37.7619
SAN DIEGO,Aug 2014,CACF,2014,CHILDRENS PARADISE INC,OSCH_CHILD_SNACK_PM,21,72,10,6,88,1104,153,92,1349,64.2381
SAN DIEGO,Sep 2014,CACF,2014,CHILDRENS PARADISE INC,CHILD_BREAKFAST,21,426,83,136,645,2295,447,732,3474,165.4286
SAN DIEGO,Sep 2014,CACF,2014,CHILDRENS PARADISE INC,CHILD_LUNCH,21,426,83,136,645,2846,555,908,4309,205.1905
SAN DIEGO,Sep 2014,CACF,2014,CHILDRENS PARADISE INC,CHILD_SNACK_PM,21,426,83,136,645,2348,458,749,3555,169.2857
SAN DIEGO,Sep 2014,CACF,2014,CHILDRENS PARADISE INC,HS_CHILD_BREAKFAST,12,181,0,0,181,1889,0,0,1889,157.4167
SAN DIEGO,Sep 2014,CACF,2014,CHILDRENS PARADISE INC,HS_CHILD_LUNCH,12,181,0,0,181,2091,0,0,2091,174.25
SAN DIEGO,Sep 2014,CACF,2014,CHILDRENS PARADISE INC,HS_CHILD_SNACK_PM,12,181,0,0,181,1783,0,0,1783,148.5833
SAN DIEGO,Sep 2014,CACF,2014,CHILDRENS PARADISE INC,OSCH_CHILD_BREAKFAST,21,79,11,7,97,534,74,48,656,31.2381
SAN DIEGO,Sep 2014,CACF,2014,CHILDRENS PARADISE INC,OSCH_CHILD_LUNCH,21,79,11,7,97,144,20,13,177,8.4286
SAN DIEGO,Sep 2014,CACF,2014,CHILDRENS PARADISE INC,OSCH_CHILD_SNACK_PM,21,79,11,7,97,1235,172,109,1516,72.1905
SAN DIEGO,Oct 2013,CACF,2014,CHRIST GOSPEL TABERNACLE INC,CHILD_BREAKFAST,23,27,3,1,31,234,26,9,269,11.6957
SAN DIEGO,Oct 2013,CACF,2014,CHRIST GOSPEL TABERNACLE INC,CHILD_LUNCH,23,27,3,1,31,251,28,9,288,12.5217
SAN DIEGO,Oct 2013,CACF,2014,CHRIST GOSPEL TABERNACLE INC,CHILD_SNACK_PM,23,27,3,1,31,345,38,13,396,17.2174
SAN DIEGO,Aug 2014,Cacf,2014,Chula Vista Elementary School District,CHILD_BREAKFAST,21,260,88,229,577,2352,796,2071,5219,248.5238
SAN DIEGO,Aug 2014,Cacf,2014,Chula Vista Elementary School District,CHILD_LUNCH,21,260,88,229,577,1794,607,1580,3981,189.5714
SAN DIEGO,Sep 2014,CACF,2014,Chula Vista Elementary School District,CHILD_BREAKFAST,17,260,88,229,577,1778,602,1565,3945,232.0588
SAN DIEGO,Sep 2014,CACF,2014,Chula Vista Elementary School District,CHILD_LUNCH,17,260,88,229,577,1609,544,1417,3570,210
SAN DIEGO,Oct 2013,CACF,2014,CHURCH OF COMPASSION DAYSPRING CHRISTIAN LRNING CTR,CHILD_BREAKFAST,23,27,0,19,46,349,0,245,594,25.8261
SAN DIEGO,Oct 2013,CACF,2014,CHURCH OF COMPASSION DAYSPRING CHRISTIAN LRNING CTR,CHILD_LUNCH,23,27,0,19,46,311,0,218,529,23
SAN DIEGO,Oct 2013,CACF,2014,CHURCH OF COMPASSION DAYSPRING CHRISTIAN LRNING CTR,CHILD_SNACK_PM,23,27,0,19,46,457,0,322,779,33.8696
SAN DIEGO,Oct 2013,CACF,2014,CHURCH OF COMPASSION DAYSPRING CHRISTIAN LRNING CTR,OSCH_CHILD_BREAKFAST,23,22,2,18,42,173,16,141,330,14.3478
SAN DIEGO,Oct 2013,CACF,2014,CHURCH OF COMPASSION DAYSPRING CHRISTIAN LRNING CTR,OSCH_CHILD_LUNCH,23,22,2,18,42,141,13,115,269,11.6957
SAN DIEGO,Oct 2013,CACF,2014,CHURCH OF COMPASSION DAYSPRING CHRISTIAN LRNING CTR,OSCH_CHILD_SNACK_PM,23,22,2,18,42,238,22,195,455,19.7826
SAN DIEGO,Nov 2013,CACF,2014,CHURCH OF COMPASSION DAYSPRING CHRISTIAN LRNING CTR,CHILD_BREAKFAST,18,27,0,19,46,262,0,185,447,24.8333
SAN DIEGO,Nov 2013,CACF,2014,CHURCH OF COMPASSION DAYSPRING CHRISTIAN LRNING CTR,CHILD_LUNCH,18,27,0,19,46,242,0,170,412,22.8889
SAN DIEGO,Nov 2013,CACF,2014,CHURCH OF COMPASSION DAYSPRING CHRISTIAN LRNING CTR,CHILD_SNACK_PM,18,27,0,19,46,340,0,239,579,32.1667
SAN DIEGO,Nov 2013,CACF,2014,CHURCH OF COMPASSION DAYSPRING CHRISTIAN LRNING CTR,OSCH_CHILD_BREAKFAST,18,22,2,18,42,130,12,107,249,13.8333
SAN DIEGO,Nov 2013,CACF,2014,CHURCH OF COMPASSION DAYSPRING CHRISTIAN LRNING CTR,OSCH_CHILD_LUNCH,18,22,2,18,42,109,10,90,209,11.6111
SAN DIEGO,Nov 2013,CACF,2014,CHURCH OF COMPASSION DAYSPRING CHRISTIAN LRNING CTR,OSCH_CHILD_SNACK_PM,18,22,2,18,42,178,16,145,339,18.8333
SAN DIEGO,Dec 2013,CACF,2014,CHURCH OF COMPASSION DAYSPRING CHRISTIAN LRNING CTR,CHILD_BREAKFAST,19,27,0,19,46,274,0,193,467,24.5789
SAN DIEGO,Dec 2013,CACF,2014,CHURCH OF COMPASSION DAYSPRING CHRISTIAN LRNING CTR,CHILD_LUNCH,19,27,0,19,46,253,0,178,431,22.6842
SAN DIEGO,Dec 2013,CACF,2014,CHURCH OF COMPASSION DAYSPRING CHRISTIAN LRNING CTR,CHILD_SNACK_PM,19,27,0,19,46,337,0,237,574,30.2105
SAN DIEGO,Dec 2013,CACF,2014,CHURCH OF COMPASSION DAYSPRING CHRISTIAN LRNING CTR,OSCH_CHILD_BREAKFAST,19,22,2,18,42,136,12,111,259,13.6316
SAN DIEGO,Dec 2013,CACF,2014,CHURCH OF COMPASSION DAYSPRING CHRISTIAN LRNING CTR,OSCH_CHILD_LUNCH,19,22,2,18,42,115,10,94,219,11.5263
SAN DIEGO,Dec 2013,CACF,2014,CHURCH OF COMPASSION DAYSPRING CHRISTIAN LRNING CTR,OSCH_CHILD_SNACK_PM,19,22,2,18,42,176,16,144,336,17.6842
SAN DIEGO,Jan 2014,CACF,2014,CHURCH OF COMPASSION DAYSPRING CHRISTIAN LRNING CTR,CHILD_BREAKFAST,21,27,0,19,46,295,0,208,503,23.9524
SAN DIEGO,Jan 2014,CACF,2014,CHURCH OF COMPASSION DAYSPRING CHRISTIAN LRNING CTR,CHILD_LUNCH,21,27,0,19,46,288,0,203,491,23.381
SAN DIEGO,Jan 2014,CACF,2014,CHURCH OF COMPASSION DAYSPRING CHRISTIAN LRNING CTR,CHILD_SNACK_PM,21,27,0,19,46,383,0,269,652,31.0476
SAN DIEGO,Jan 2014,CACF,2014,CHURCH OF COMPASSION DAYSPRING CHRISTIAN LRNING CTR,OSCH_CHILD_BREAKFAST,21,22,2,18,42,146,13,120,279,13.2857
SAN DIEGO,Jan 2014,CACF,2014,CHURCH OF COMPASSION DAYSPRING CHRISTIAN LRNING CTR,OSCH_CHILD_LUNCH,21,22,2,18,42,130,12,107,249,11.8571
SAN DIEGO,Jan 2014,CACF,2014,CHURCH OF COMPASSION DAYSPRING CHRISTIAN LRNING CTR,OSCH_CHILD_SNACK_PM,21,22,2,18,42,200,18,163,381,18.1429
SAN DIEGO,Feb 2014,CACF,2014,CHURCH OF COMPASSION DAYSPRING CHRISTIAN LRNING CTR,CHILD_BREAKFAST,19,27,0,19,46,286,0,201,487,25.6316
SAN DIEGO,Feb 2014,CACF,2014,CHURCH OF COMPASSION DAYSPRING CHRISTIAN LRNING CTR,CHILD_LUNCH,19,27,0,19,46,269,0,189,458,24.1053
SAN DIEGO,Feb 2014,CACF,2014,CHURCH OF COMPASSION DAYSPRING CHRISTIAN LRNING CTR,CHILD_SNACK_PM,19,27,0,19,46,377,0,265,642,33.7895
SAN DIEGO,Feb 2014,CACF,2014,CHURCH OF COMPASSION DAYSPRING CHRISTIAN LRNING CTR,OSCH_CHILD_BREAKFAST,19,22,2,18,42,142,13,116,271,14.2632
SAN DIEGO,Feb 2014,CACF,2014,CHURCH OF COMPASSION DAYSPRING CHRISTIAN LRNING CTR,OSCH_CHILD_LUNCH,19,22,2,18,42,122,11,100,233,12.2632
SAN DIEGO,Feb 2014,CACF,2014,CHURCH OF COMPASSION DAYSPRING CHRISTIAN LRNING CTR,OSCH_CHILD_SNACK_PM,19,22,2,18,42,197,18,161,376,19.7895
SAN DIEGO,Mar 2014,CACF,2014,CHURCH OF COMPASSION DAYSPRING CHRISTIAN LRNING CTR,CHILD_BREAKFAST,21,27,0,19,46,318,0,223,541,25.7619
SAN DIEGO,Mar 2014,CACF,2014,CHURCH OF COMPASSION DAYSPRING CHRISTIAN LRNING CTR,CHILD_LUNCH,21,27,0,19,46,295,0,207,502,23.9048
SAN DIEGO,Mar 2014,CACF,2014,CHURCH OF COMPASSION DAYSPRING CHRISTIAN LRNING CTR,CHILD_SNACK_PM,21,27,0,19,46,418,0,294,712,33.9048
SAN DIEGO,Mar 2014,CACF,2014,CHURCH OF COMPASSION DAYSPRING CHRISTIAN LRNING CTR,OSCH_CHILD_BREAKFAST,21,22,2,18,42,158,14,129,301,14.3333
SAN DIEGO,Mar 2014,CACF,2014,CHURCH OF COMPASSION DAYSPRING CHRISTIAN LRNING CTR,OSCH_CHILD_LUNCH,21,22,2,18,42,133,12,109,254,12.0952
SAN DIEGO,Mar 2014,CACF,2014,CHURCH OF COMPASSION DAYSPRING CHRISTIAN LRNING CTR,OSCH_CHILD_SNACK_PM,21,22,2,18,42,218,20,178,416,19.8095
SAN DIEGO,Apr 2014,CACF,2014,CHURCH OF COMPASSION DAYSPRING CHRISTIAN LRNING CTR,CHILD_BREAKFAST,22,27,0,19,46,346,0,243,589,26.7727
SAN DIEGO,Apr 2014,CACF,2014,CHURCH OF COMPASSION DAYSPRING CHRISTIAN LRNING CTR,CHILD_LUNCH,22,27,0,19,46,399,0,280,679,30.8636
SAN DIEGO,Apr 2014,CACF,2014,CHURCH OF COMPASSION DAYSPRING CHRISTIAN LRNING CTR,CHILD_SNACK_PM,22,27,0,19,46,434,0,306,740,33.6364
SAN DIEGO,Apr 2014,CACF,2014,CHURCH OF COMPASSION DAYSPRING CHRISTIAN LRNING CTR,OSCH_CHILD_BREAKFAST,22,22,2,18,42,171,16,140,327,14.8636
SAN DIEGO,Apr 2014,CACF,2014,CHURCH OF COMPASSION DAYSPRING CHRISTIAN LRNING CTR,OSCH_CHILD_LUNCH,22,22,2,18,42,180,16,148,344,15.6364
SAN DIEGO,Apr 2014,CACF,2014,CHURCH OF COMPASSION DAYSPRING CHRISTIAN LRNING CTR,OSCH_CHILD_SNACK_PM,22,22,2,18,42,226,21,185,432,19.6364
SAN DIEGO,May 2014,CACF,2014,CHURCH OF COMPASSION DAYSPRING CHRISTIAN LRNING CTR,CHILD_BREAKFAST,21,27,0,19,46,370,0,261,631,30.0476
SAN DIEGO,May 2014,CACF,2014,CHURCH OF COMPASSION DAYSPRING CHRISTIAN LRNING CTR,CHILD_LUNCH,21,27,0,19,46,374,0,263,637,30.3333
SAN DIEGO,May 2014,CACF,2014,CHURCH OF COMPASSION DAYSPRING CHRISTIAN LRNING CTR,CHILD_SNACK_PM,21,27,0,19,46,458,0,322,780,37.1429
SAN DIEGO,May 2014,CACF,2014,CHURCH OF COMPASSION DAYSPRING CHRISTIAN LRNING CTR,OSCH_CHILD_BREAKFAST,21,22,2,18,42,184,17,150,351,16.7143
SAN DIEGO,May 2014,CACF,2014,CHURCH OF COMPASSION DAYSPRING CHRISTIAN LRNING CTR,OSCH_CHILD_LUNCH,21,22,2,18,42,169,15,139,323,15.381
SAN DIEGO,May 2014,CACF,2014,CHURCH OF COMPASSION DAYSPRING CHRISTIAN LRNING CTR,OSCH_CHILD_SNACK_PM,21,22,2,18,42,239,22,195,456,21.7143
SAN DIEGO,Jun 2014,CACF,2014,CHURCH OF COMPASSION DAYSPRING CHRISTIAN LRNING CTR,CHILD_BREAKFAST,21,27,0,19,46,338,0,238,576,27.4286
SAN DIEGO,Jun 2014,CACF,2014,CHURCH OF COMPASSION DAYSPRING CHRISTIAN LRNING CTR,CHILD_LUNCH,21,27,0,19,46,368,0,259,627,29.8571
SAN DIEGO,Jun 2014,CACF,2014,CHURCH OF COMPASSION DAYSPRING CHRISTIAN LRNING CTR,CHILD_SNACK_PM,21,27,0,19,46,399,0,281,680,32.381
SAN DIEGO,Jun 2014,CACF,2014,CHURCH OF COMPASSION DAYSPRING CHRISTIAN LRNING CTR,OSCH_CHILD_BREAKFAST,21,22,2,18,42,168,15,137,320,15.2381
SAN DIEGO,Jun 2014,CACF,2014,CHURCH OF COMPASSION DAYSPRING CHRISTIAN LRNING CTR,OSCH_CHILD_LUNCH,21,22,2,18,42,167,15,136,318,15.1429
SAN DIEGO,Jun 2014,CACF,2014,CHURCH OF COMPASSION DAYSPRING CHRISTIAN LRNING CTR,OSCH_CHILD_SNACK_PM,21,22,2,18,42,208,19,171,398,18.9524
SAN DIEGO,Jul 2014,CACF,2014,CHURCH OF COMPASSION DAYSPRING CHRISTIAN LRNING CTR,CHILD_BREAKFAST,22,27,0,19,46,397,0,279,676,30.7273
SAN DIEGO,Jul 2014,CACF,2014,CHURCH OF COMPASSION DAYSPRING CHRISTIAN LRNING CTR,CHILD_LUNCH,22,27,0,19,46,523,0,368,891,40.5
SAN DIEGO,Jul 2014,CACF,2014,CHURCH OF COMPASSION DAYSPRING CHRISTIAN LRNING CTR,CHILD_SNACK_PM,22,27,0,19,46,433,0,304,737,33.5
SAN DIEGO,Jul 2014,CACF,2014,CHURCH OF COMPASSION DAYSPRING CHRISTIAN LRNING CTR,OSCH_CHILD_BREAKFAST,22,22,2,18,42,197,18,161,376,17.0909
SAN DIEGO,Jul 2014,CACF,2014,CHURCH OF COMPASSION DAYSPRING CHRISTIAN LRNING CTR,OSCH_CHILD_LUNCH,22,22,2,18,42,237,22,193,452,20.5455
SAN DIEGO,Jul 2014,CACF,2014,CHURCH OF COMPASSION DAYSPRING CHRISTIAN LRNING CTR,OSCH_CHILD_SNACK_PM,22,22,2,18,42,220,20,180,420,19.0909
SAN DIEGO,Aug 2014,CACF,2014,CHURCH OF COMPASSION DAYSPRING CHRISTIAN LRNING CTR,CHILD_BREAKFAST,16,27,0,19,46,277,0,195,472,29.5
SAN DIEGO,Aug 2014,CACF,2014,CHURCH OF COMPASSION DAYSPRING CHRISTIAN LRNING CTR,CHILD_LUNCH,16,27,0,19,46,375,0,263,638,39.875
SAN DIEGO,Aug 2014,CACF,2014,CHURCH OF COMPASSION DAYSPRING CHRISTIAN LRNING CTR,CHILD_SNACK_PM,16,27,0,19,46,312,0,220,532,33.25
SAN DIEGO,Aug 2014,CACF,2014,CHURCH OF COMPASSION DAYSPRING CHRISTIAN LRNING CTR,OSCH_CHILD_BREAKFAST,16,22,2,18,42,122,11,100,233,14.5625
SAN DIEGO,Aug 2014,CACF,2014,CHURCH OF COMPASSION DAYSPRING CHRISTIAN LRNING CTR,OSCH_CHILD_LUNCH,16,22,2,18,42,163,15,134,312,19.5
SAN DIEGO,Aug 2014,CACF,2014,CHURCH OF COMPASSION DAYSPRING CHRISTIAN LRNING CTR,OSCH_CHILD_SNACK_PM,16,22,2,18,42,165,15,135,315,19.6875
SAN DIEGO,Sep 2014,CACF,2014,CHURCH OF COMPASSION DAYSPRING CHRISTIAN LRNING CTR,CHILD_BREAKFAST,21,27,0,19,46,338,0,238,576,27.4286
SAN DIEGO,Sep 2014,CACF,2014,CHURCH OF COMPASSION DAYSPRING CHRISTIAN LRNING CTR,CHILD_LUNCH,21,27,0,19,46,436,0,306,742,35.3333
SAN DIEGO,Sep 2014,CACF,2014,CHURCH OF COMPASSION DAYSPRING CHRISTIAN LRNING CTR,CHILD_SNACK_PM,21,27,0,19,46,390,0,275,665,31.6667
SAN DIEGO,Sep 2014,CACF,2014,CHURCH OF COMPASSION DAYSPRING CHRISTIAN LRNING CTR,OSCH_CHILD_BREAKFAST,21,22,2,18,42,135,12,110,257,12.2381
SAN DIEGO,Sep 2014,CACF,2014,CHURCH OF COMPASSION DAYSPRING CHRISTIAN LRNING CTR,OSCH_CHILD_SNACK_PM,21,22,2,18,42,253,23,207,483,23
SAN DIEGO,Oct 2013,CACF,2014,CLAIREMONT VILLA ADHC INC ,ADULT_BREAKFAST,23,99,0,0,99,1373,0,0,1373,59.6957
SAN DIEGO,Oct 2013,CACF,2014,CLAIREMONT VILLA ADHC INC ,ADULT_LUNCH,23,99,0,0,99,1371,0,0,1371,59.6087
SAN DIEGO,Nov 2013,CACF,2014,CLAIREMONT VILLA ADHC INC ,ADULT_BREAKFAST,21,99,0,0,99,1128,0,0,1128,53.7143
SAN DIEGO,Nov 2013,CACF,2014,CLAIREMONT VILLA ADHC INC ,ADULT_LUNCH,21,99,0,0,99,1126,0,0,1126,53.619
SAN DIEGO,Dec 2013,CACF,2014,CLAIREMONT VILLA ADHC INC ,ADULT_BREAKFAST,22,92,0,2,94,1155,0,25,1180,53.6364
SAN DIEGO,Dec 2013,CACF,2014,CLAIREMONT VILLA ADHC INC ,ADULT_LUNCH,22,92,0,2,94,1153,0,25,1178,53.5455
SAN DIEGO,Jan 2014,CACF,2014,CLAIREMONT VILLA ADHC INC ,ADULT_BREAKFAST,23,92,0,2,94,1243,0,27,1270,55.2174
SAN DIEGO,Jan 2014,CACF,2014,CLAIREMONT VILLA ADHC INC ,ADULT_LUNCH,23,92,0,2,94,1242,0,27,1269,55.1739
SAN DIEGO,Feb 2014,CACF,2014,CLAIREMONT VILLA ADHC INC ,ADULT_BREAKFAST,20,95,0,2,97,1125,0,24,1149,57.45
SAN DIEGO,Feb 2014,CACF,2014,CLAIREMONT VILLA ADHC INC ,ADULT_LUNCH,20,95,0,2,97,1120,0,24,1144,57.2
SAN DIEGO,Mar 2014,CACF,2014,CLAIREMONT VILLA ADHC INC ,ADULT_BREAKFAST,21,97,0,2,99,1211,0,25,1236,58.8571
SAN DIEGO,Mar 2014,CACF,2014,CLAIREMONT VILLA ADHC INC ,ADULT_LUNCH,21,97,0,2,99,1209,0,25,1234,58.7619
SAN DIEGO,Apr 2014,CACF,2014,CLAIREMONT VILLA ADHC INC ,ADULT_BREAKFAST,22,104,0,1,105,1303,0,13,1316,59.8182
SAN DIEGO,Apr 2014,CACF,2014,CLAIREMONT VILLA ADHC INC ,ADULT_LUNCH,22,104,0,1,105,1303,0,12,1315,59.7727
SAN DIEGO,May 2014,CACF,2014,CLAIREMONT VILLA ADHC INC ,ADULT_BREAKFAST,22,101,0,1,102,1181,0,12,1193,54.2273
SAN DIEGO,May 2014,CACF,2014,CLAIREMONT VILLA ADHC INC ,ADULT_LUNCH,22,101,0,1,102,1180,0,12,1192,54.1818
SAN DIEGO,Jun 2014,CACF,2014,CLAIREMONT VILLA ADHC INC ,ADULT_BREAKFAST,21,100,0,1,101,1083,0,11,1094,52.0952
SAN DIEGO,Jun 2014,CACF,2014,CLAIREMONT VILLA ADHC INC ,ADULT_LUNCH,21,100,0,1,101,1083,0,11,1094,52.0952
SAN DIEGO,Jul 2014,CACF,2014,CLAIREMONT VILLA ADHC INC ,ADULT_BREAKFAST,23,99,0,1,100,1204,0,12,1216,52.8696
SAN DIEGO,Jul 2014,CACF,2014,CLAIREMONT VILLA ADHC INC ,ADULT_LUNCH,23,99,0,1,100,1205,0,12,1217,52.913
SAN DIEGO,Aug 2014,CACF,2014,CLAIREMONT VILLA ADHC INC ,ADULT_BREAKFAST,21,91,0,1,92,1103,0,12,1115,53.0952
SAN DIEGO,Aug 2014,CACF,2014,CLAIREMONT VILLA ADHC INC ,ADULT_LUNCH,21,91,0,1,92,1104,0,12,1116,53.1429
SAN DIEGO,Sep 2014,CACF,2014,CLAIREMONT VILLA ADHC INC ,ADULT_BREAKFAST,22,89,0,1,90,1147,0,13,1160,52.7273
SAN DIEGO,Sep 2014,CACF,2014,CLAIREMONT VILLA ADHC INC ,ADULT_LUNCH,22,89,0,1,90,1147,0,13,1160,52.7273
SAN DIEGO,Oct 2013,CACF,2014,COLES COTTAGE CHILD CENTER INC,CHILD_BREAKFAST,22,8,0,14,22,130,0,227,357,16.2273
SAN DIEGO,Oct 2013,CACF,2014,COLES COTTAGE CHILD CENTER INC,CHILD_LUNCH,22,8,0,14,22,132,0,232,364,16.5455
SAN DIEGO,Oct 2013,CACF,2014,COLES COTTAGE CHILD CENTER INC,CHILD_SNACK_PM,22,8,0,14,22,108,0,190,298,13.5455
SAN DIEGO,Nov 2013,CACF,2014,COLES COTTAGE CHILD CENTER INC,CHILD_BREAKFAST,18,8,0,14,22,95,0,166,261,14.5
SAN DIEGO,Nov 2013,CACF,2014,COLES COTTAGE CHILD CENTER INC,CHILD_LUNCH,18,8,0,14,22,107,0,186,293,16.2778
SAN DIEGO,Nov 2013,CACF,2014,COLES COTTAGE CHILD CENTER INC,CHILD_SNACK_PM,18,8,0,14,22,93,0,162,255,14.1667
SAN DIEGO,Dec 2013,CACF,2014,COLES COTTAGE CHILD CENTER INC,CHILD_BREAKFAST,19,6,0,14,20,92,0,214,306,16.1053
SAN DIEGO,Dec 2013,CACF,2014,COLES COTTAGE CHILD CENTER INC,CHILD_LUNCH,19,6,0,14,20,99,0,232,331,17.4211
SAN DIEGO,Dec 2013,CACF,2014,COLES COTTAGE CHILD CENTER INC,CHILD_SNACK_PM,19,6,0,14,20,81,0,190,271,14.2632
SAN DIEGO,Jan 2014,CACF,2014,COLES COTTAGE CHILD CENTER INC,CHILD_BREAKFAST,22,6,0,14,20,114,0,267,381,17.3182
SAN DIEGO,Jan 2014,CACF,2014,COLES COTTAGE CHILD CENTER INC,CHILD_LUNCH,22,6,0,14,20,130,0,304,434,19.7273
SAN DIEGO,Jan 2014,CACF,2014,COLES COTTAGE CHILD CENTER INC,CHILD_SNACK_PM,22,6,0,14,20,107,0,251,358,16.2727
SAN DIEGO,Feb 2014,CACF,2014,COLES COTTAGE CHILD CENTER INC,CHILD_BREAKFAST,19,7,0,15,22,100,0,215,315,16.5789
SAN DIEGO,Feb 2014,CACF,2014,COLES COTTAGE CHILD CENTER INC,CHILD_LUNCH,19,7,0,15,22,121,0,260,381,20.0526
SAN DIEGO,Feb 2014,CACF,2014,COLES COTTAGE CHILD CENTER INC,CHILD_SNACK_PM,19,7,0,15,22,101,0,217,318,16.7368
SAN DIEGO,Mar 2014,CACF,2014,COLES COTTAGE CHILD CENTER INC,CHILD_BREAKFAST,21,17,0,34,51,237,0,473,710,33.8095
SAN DIEGO,Mar 2014,CACF,2014,COLES COTTAGE CHILD CENTER INC,CHILD_LUNCH,21,17,0,34,51,268,0,536,804,38.2857
SAN DIEGO,Mar 2014,CACF,2014,COLES COTTAGE CHILD CENTER INC,CHILD_SNACK_PM,21,17,0,34,51,241,0,481,722,34.381
SAN DIEGO,Apr 2014,CACF,2014,COLES COTTAGE CHILD CENTER INC,CHILD_BREAKFAST,21,19,0,35,54,277,0,511,788,37.5238
SAN DIEGO,Apr 2014,CACF,2014,COLES COTTAGE CHILD CENTER INC,CHILD_LUNCH,21,19,0,35,54,309,0,569,878,41.8095
SAN DIEGO,Apr 2014,CACF,2014,COLES COTTAGE CHILD CENTER INC,CHILD_SNACK_PM,21,19,0,35,54,282,0,518,800,38.0952
SAN DIEGO,May 2014,CACF,2014,COLES COTTAGE CHILD CENTER INC,CHILD_BREAKFAST,21,19,0,35,54,266,0,491,757,36.0476
SAN DIEGO,May 2014,CACF,2014,COLES COTTAGE CHILD CENTER INC,CHILD_LUNCH,21,19,0,35,54,321,0,590,911,43.381
SAN DIEGO,May 2014,CACF,2014,COLES COTTAGE CHILD CENTER INC,CHILD_SNACK_PM,21,19,0,35,54,293,0,540,833,39.6667
SAN DIEGO,Jun 2014,CACF,2014,COLES COTTAGE CHILD CENTER INC,CHILD_BREAKFAST,21,19,1,34,54,233,12,418,663,31.5714
SAN DIEGO,Jun 2014,CACF,2014,COLES COTTAGE CHILD CENTER INC,CHILD_LUNCH,21,19,1,34,54,292,15,523,830,39.5238
SAN DIEGO,Jun 2014,CACF,2014,COLES COTTAGE CHILD CENTER INC,CHILD_SNACK_PM,21,19,1,34,54,270,14,484,768,36.5714
SAN DIEGO,Jul 2014,CACF,2014,COLES COTTAGE CHILD CENTER INC,CHILD_BREAKFAST,22,19,1,34,54,252,13,451,716,32.5455
SAN DIEGO,Jul 2014,CACF,2014,COLES COTTAGE CHILD CENTER INC,CHILD_LUNCH,22,19,1,34,54,301,16,539,856,38.9091
SAN DIEGO,Jul 2014,CACF,2014,COLES COTTAGE CHILD CENTER INC,CHILD_SNACK_PM,22,19,1,34,54,278,15,498,791,35.9545
SAN DIEGO,Aug 2014,CACF,2014,COLES COTTAGE CHILD CENTER INC,CHILD_BREAKFAST,21,15,1,36,52,192,13,460,665,31.6667
SAN DIEGO,Aug 2014,CACF,2014,COLES COTTAGE CHILD CENTER INC,CHILD_LUNCH,21,15,1,36,52,224,15,538,777,37
SAN DIEGO,Aug 2014,CACF,2014,COLES COTTAGE CHILD CENTER INC,CHILD_SNACK_PM,21,15,1,36,52,214,14,514,742,35.3333
SAN DIEGO,Sep 2014,CACF,2014,COLES COTTAGE CHILD CENTER INC,CHILD_BREAKFAST,21,12,1,34,47,184,15,523,722,34.381
SAN DIEGO,Sep 2014,CACF,2014,COLES COTTAGE CHILD CENTER INC,CHILD_LUNCH,21,12,1,34,47,203,17,574,794,37.8095
SAN DIEGO,Sep 2014,CACF,2014,COLES COTTAGE CHILD CENTER INC,CHILD_SNACK_PM,21,12,1,34,47,194,16,549,759,36.1429
SAN DIEGO,Oct 2013,CACF,2014,CORONADO BAPTIST CHURCH,CHILD_LUNCH,22,0,0,100,100,0,0,377,377,17.1364
SAN DIEGO,Oct 2013,CACF,2014,CORONADO BAPTIST CHURCH,CHILD_SNACK_AM,22,0,0,100,100,0,0,371,371,16.8636
SAN DIEGO,Oct 2013,CACF,2014,CORONADO BAPTIST CHURCH,CHILD_SNACK_PM,22,0,0,100,100,0,0,261,261,11.8636
SAN DIEGO,Nov 2013,CACF,2014,CORONADO BAPTIST CHURCH,CHILD_LUNCH,18,0,0,100,100,0,0,286,286,15.8889
SAN DIEGO,Nov 2013,CACF,2014,CORONADO BAPTIST CHURCH,CHILD_SNACK_AM,18,0,0,100,100,0,0,278,278,15.4444
SAN DIEGO,Nov 2013,CACF,2014,CORONADO BAPTIST CHURCH,CHILD_SNACK_PM,18,0,0,100,100,0,0,192,192,10.6667
SAN DIEGO,Dec 2013,CACF,2014,CORONADO BAPTIST CHURCH,CHILD_LUNCH,21,0,0,100,100,0,0,291,291,13.8571
SAN DIEGO,Dec 2013,CACF,2014,CORONADO BAPTIST CHURCH,CHILD_SNACK_AM,21,0,0,100,100,0,0,293,293,13.9524
SAN DIEGO,Dec 2013,CACF,2014,CORONADO BAPTIST CHURCH,CHILD_SNACK_PM,21,0,0,100,100,0,0,196,196,9.3333
SAN DIEGO,Jan 2014,CACF,2014,CORONADO BAPTIST CHURCH,CHILD_LUNCH,21,0,0,100,100,0,0,299,299,14.2381
SAN DIEGO,Jan 2014,CACF,2014,CORONADO BAPTIST CHURCH,CHILD_SNACK_AM,21,0,0,100,100,0,0,317,317,15.0952
SAN DIEGO,Jan 2014,CACF,2014,CORONADO BAPTIST CHURCH,CHILD_SNACK_PM,21,0,0,100,100,0,0,239,239,11.381
SAN DIEGO,Feb 2014,CACF,2014,CORONADO BAPTIST CHURCH,CHILD_LUNCH,19,0,0,100,100,0,0,338,338,17.7895
SAN DIEGO,Feb 2014,CACF,2014,CORONADO BAPTIST CHURCH,CHILD_SNACK_AM,19,0,0,100,100,0,0,345,345,18.1579
SAN DIEGO,Feb 2014,CACF,2014,CORONADO BAPTIST CHURCH,CHILD_SNACK_PM,19,0,0,100,100,0,0,271,271,14.2632
SAN DIEGO,Mar 2014,CACF,2014,CORONADO BAPTIST CHURCH,CHILD_LUNCH,21,0,0,100,100,0,0,367,367,17.4762
SAN DIEGO,Mar 2014,CACF,2014,CORONADO BAPTIST CHURCH,CHILD_SNACK_AM,21,0,0,100,100,0,0,366,366,17.4286
SAN DIEGO,Mar 2014,CACF,2014,CORONADO BAPTIST CHURCH,CHILD_SNACK_PM,21,0,0,100,100,0,0,287,287,13.6667
SAN DIEGO,Apr 2014,CACF,2014,CORONADO BAPTIST CHURCH,CHILD_LUNCH,22,0,0,100,100,0,0,390,390,17.7273
SAN DIEGO,Apr 2014,CACF,2014,CORONADO BAPTIST CHURCH,CHILD_SNACK_AM,22,0,0,100,100,0,0,404,404,18.3636
SAN DIEGO,Apr 2014,CACF,2014,CORONADO BAPTIST CHURCH,CHILD_SNACK_PM,22,0,0,100,100,0,0,329,329,14.9545
SAN DIEGO,May 2014,CACF,2014,CORONADO BAPTIST CHURCH,CHILD_LUNCH,21,0,0,100,100,0,0,335,335,15.9524
SAN DIEGO,May 2014,CACF,2014,CORONADO BAPTIST CHURCH,CHILD_SNACK_AM,21,0,0,100,100,0,0,316,316,15.0476
SAN DIEGO,May 2014,CACF,2014,CORONADO BAPTIST CHURCH,CHILD_SNACK_PM,21,0,0,100,100,0,0,275,275,13.0952
SAN DIEGO,Jun 2014,CACF,2014,CORONADO BAPTIST CHURCH,CHILD_LUNCH,21,0,0,100,100,0,0,376,376,17.9048
SAN DIEGO,Jun 2014,CACF,2014,CORONADO BAPTIST CHURCH,CHILD_SNACK_AM,21,0,0,100,100,0,0,350,350,16.6667
SAN DIEGO,Jun 2014,CACF,2014,CORONADO BAPTIST CHURCH,CHILD_SNACK_PM,21,0,0,100,100,0,0,300,300,14.2857
SAN DIEGO,Jul 2014,CACF,2014,CORONADO BAPTIST CHURCH,CHILD_LUNCH,22,0,0,100,100,0,0,447,447,20.3182
SAN DIEGO,Jul 2014,CACF,2014,CORONADO BAPTIST CHURCH,CHILD_SNACK_AM,22,0,0,100,100,0,0,399,399,18.1364
SAN DIEGO,Jul 2014,CACF,2014,CORONADO BAPTIST CHURCH,CHILD_SNACK_PM,22,0,0,100,100,0,0,364,364,16.5455
SAN DIEGO,Oct 2013,CACF,2014,DINO DAY CARE INC,CHILD_BREAKFAST,20,25,1,7,33,358,14,100,472,23.6
SAN DIEGO,Oct 2013,CACF,2014,DINO DAY CARE INC,CHILD_LUNCH,20,25,1,7,33,446,18,125,589,29.45
SAN DIEGO,Oct 2013,CACF,2014,DINO DAY CARE INC,CHILD_SNACK_PM,20,25,1,7,33,348,14,98,460,23
SAN DIEGO,Nov 2013,CACF,2014,DINO DAY CARE INC,CHILD_BREAKFAST,18,25,1,7,33,259,10,73,342,19
SAN DIEGO,Nov 2013,CACF,2014,DINO DAY CARE INC,CHILD_LUNCH,18,25,1,7,33,345,14,96,455,25.2778
SAN DIEGO,Nov 2013,CACF,2014,DINO DAY CARE INC,CHILD_SNACK_PM,18,25,1,7,33,267,11,75,353,19.6111
SAN DIEGO,Dec 2013,CACF,2014,DINO DAY CARE INC,CHILD_BREAKFAST,19,25,1,7,33,204,8,57,269,14.1579
SAN DIEGO,Dec 2013,CACF,2014,DINO DAY CARE INC,CHILD_LUNCH,19,25,1,7,33,297,12,83,392,20.6316
SAN DIEGO,Dec 2013,CACF,2014,DINO DAY CARE INC,CHILD_SNACK_PM,19,25,1,7,33,239,10,67,316,16.6316
SAN DIEGO,Jan 2014,CACF,2014,DINO DAY CARE INC,CHILD_BREAKFAST,22,25,1,7,33,202,8,57,267,12.1364
SAN DIEGO,Jan 2014,CACF,2014,DINO DAY CARE INC,CHILD_LUNCH,22,25,1,7,33,308,12,87,407,18.5
SAN DIEGO,Jan 2014,CACF,2014,DINO DAY CARE INC,CHILD_SNACK_PM,22,25,1,7,33,233,9,66,308,14
SAN DIEGO,Feb 2014,CACF,2014,DINO DAY CARE INC,CHILD_BREAKFAST,19,25,1,7,33,201,8,56,265,13.9474
SAN DIEGO,Feb 2014,CACF,2014,DINO DAY CARE INC,CHILD_LUNCH,19,25,1,7,33,295,12,82,389,20.4737
SAN DIEGO,Feb 2014,CACF,2014,DINO DAY CARE INC,CHILD_SNACK_PM,19,25,1,7,33,242,10,68,320,16.8421
SAN DIEGO,Mar 2014,CACF,2014,DINO DAY CARE INC,CHILD_BREAKFAST,21,25,1,7,33,289,12,81,382,18.1905
SAN DIEGO,Mar 2014,CACF,2014,DINO DAY CARE INC,CHILD_LUNCH,21,25,1,7,33,437,17,123,577,27.4762
SAN DIEGO,Mar 2014,CACF,2014,DINO DAY CARE INC,CHILD_SNACK_PM,21,25,1,7,33,348,14,98,460,21.9048
SAN DIEGO,Apr 2014,CACF,2014,DINO DAY CARE INC,CHILD_BREAKFAST,22,25,1,7,33,317,13,89,419,19.0455
SAN DIEGO,Apr 2014,CACF,2014,DINO DAY CARE INC,CHILD_LUNCH,22,25,1,7,33,459,18,129,606,27.5455
SAN DIEGO,Apr 2014,CACF,2014,DINO DAY CARE INC,CHILD_SNACK_PM,22,25,1,7,33,350,14,98,462,21
SAN DIEGO,May 2014,CACF,2014,DINO DAY CARE INC,CHILD_BREAKFAST,21,25,1,7,33,289,12,81,382,18.1905
SAN DIEGO,May 2014,CACF,2014,DINO DAY CARE INC,CHILD_LUNCH,21,25,1,7,33,411,16,116,543,25.8571
SAN DIEGO,May 2014,CACF,2014,DINO DAY CARE INC,CHILD_SNACK_PM,21,25,1,7,33,320,13,90,423,20.1429
SAN DIEGO,Jun 2014,CACF,2014,DINO DAY CARE INC,CHILD_BREAKFAST,21,25,1,7,33,220,9,61,290,13.8095
SAN DIEGO,Jun 2014,CACF,2014,DINO DAY CARE INC,CHILD_LUNCH,21,25,1,7,33,346,14,97,457,21.7619
SAN DIEGO,Jun 2014,CACF,2014,DINO DAY CARE INC,CHILD_SNACK_PM,21,25,1,7,33,300,12,84,396,18.8571
SAN DIEGO,Jul 2014,CACF,2014,DINO DAY CARE INC,CHILD_BREAKFAST,22,25,1,7,33,228,9,64,301,13.6818
SAN DIEGO,Jul 2014,CACF,2014,DINO DAY CARE INC,CHILD_LUNCH,22,25,1,7,33,349,14,98,461,20.9545
SAN DIEGO,Jul 2014,CACF,2014,DINO DAY CARE INC,CHILD_SNACK_PM,22,25,1,7,33,302,12,84,398,18.0909
SAN DIEGO,Aug 2014,CACF,2014,DINO DAY CARE INC,CHILD_BREAKFAST,21,25,1,7,33,148,6,42,196,9.3333
SAN DIEGO,Aug 2014,CACF,2014,DINO DAY CARE INC,CHILD_LUNCH,21,25,1,7,33,333,13,93,439,20.9048
SAN DIEGO,Aug 2014,CACF,2014,DINO DAY CARE INC,CHILD_SNACK_PM,21,25,1,7,33,255,10,72,337,16.0476
SAN DIEGO,Sep 2014,CACF,2014,DINO DAY CARE INC,CHILD_BREAKFAST,21,25,1,7,33,245,10,69,324,15.4286
SAN DIEGO,Sep 2014,CACF,2014,DINO DAY CARE INC,CHILD_LUNCH,21,25,1,7,33,353,14,99,466,22.1905
SAN DIEGO,Sep 2014,CACF,2014,DINO DAY CARE INC,CHILD_SNACK_PM,21,25,1,7,33,306,12,86,404,19.2381
SAN DIEGO,Aug 2014,CACF,2014,EAST SAN DIEGO ASSEMBLY OF GOD,ATRISK_CHILD_LUNCH,4,26,0,0,26,104,0,0,104,26
SAN DIEGO,Sep 2014,CACF,2014,EAST SAN DIEGO ASSEMBLY OF GOD,ATRISK_CHILD_LUNCH,22,79,0,0,79,1248,0,0,1248,56.7273
SAN DIEGO,Sep 2014,CACF,2014,EAST SAN DIEGO ASSEMBLY OF GOD,ATRISK_CHILD_SNACK_AM,22,79,0,0,79,203,0,0,203,9.2273
SAN DIEGO,Oct 2013,CACF,2014,EDUCATIONAL ENRICHMENT SYSTEMS INC ,CHILD_BREAKFAST,22,776,231,79,1086,8813,2623,898,12334,560.6364
SAN DIEGO,Oct 2013,CACF,2014,EDUCATIONAL ENRICHMENT SYSTEMS INC ,CHILD_LUNCH,22,776,231,79,1086,8372,2492,853,11717,532.5909
SAN DIEGO,Oct 2013,CACF,2014,EDUCATIONAL ENRICHMENT SYSTEMS INC ,CHILD_SNACK_AM,22,776,231,79,1086,5786,1722,590,8098,368.0909
SAN DIEGO,Oct 2013,CACF,2014,EDUCATIONAL ENRICHMENT SYSTEMS INC ,CHILD_SNACK_PM,22,776,231,79,1086,7513,2237,765,10515,477.9545
SAN DIEGO,Nov 2013,CACF,2014,EDUCATIONAL ENRICHMENT SYSTEMS INC ,CHILD_BREAKFAST,19,776,231,79,1086,6446,1919,657,9022,474.8421
SAN DIEGO,Nov 2013,CACF,2014,EDUCATIONAL ENRICHMENT SYSTEMS INC ,CHILD_LUNCH,19,776,231,79,1086,6393,1903,652,8948,470.9474
SAN DIEGO,Nov 2013,CACF,2014,EDUCATIONAL ENRICHMENT SYSTEMS INC ,CHILD_SNACK_AM,19,776,231,79,1086,3535,1052,360,4947,260.3684
SAN DIEGO,Nov 2013,CACF,2014,EDUCATIONAL ENRICHMENT SYSTEMS INC ,CHILD_SNACK_PM,19,776,231,79,1086,5715,1701,582,7998,420.9474
SAN DIEGO,Dec 2013,CACF,2014,EDUCATIONAL ENRICHMENT SYSTEMS INC ,CHILD_BREAKFAST,21,776,231,79,1086,6290,1872,641,8803,419.1905
SAN DIEGO,Dec 2013,CACF,2014,EDUCATIONAL ENRICHMENT SYSTEMS INC ,CHILD_LUNCH,21,776,231,79,1086,6448,1920,657,9025,429.7619
SAN DIEGO,Dec 2013,CACF,2014,EDUCATIONAL ENRICHMENT SYSTEMS INC ,CHILD_SNACK_AM,21,776,231,79,1086,3730,1110,380,5220,248.5714
SAN DIEGO,Dec 2013,CACF,2014,EDUCATIONAL ENRICHMENT SYSTEMS INC ,CHILD_SNACK_PM,21,776,231,79,1086,5840,1739,595,8174,389.2381
SAN DIEGO,Jan 2014,CACF,2014,EDUCATIONAL ENRICHMENT SYSTEMS INC ,CHILD_BREAKFAST,21,776,231,79,1086,6918,2059,705,9682,461.0476
SAN DIEGO,Jan 2014,CACF,2014,EDUCATIONAL ENRICHMENT SYSTEMS INC ,CHILD_LUNCH,21,776,231,79,1086,6958,2071,709,9738,463.7143
SAN DIEGO,Jan 2014,CACF,2014,EDUCATIONAL ENRICHMENT SYSTEMS INC ,CHILD_SNACK_AM,21,776,231,79,1086,3775,1124,384,5283,251.5714
SAN DIEGO,Jan 2014,CACF,2014,EDUCATIONAL ENRICHMENT SYSTEMS INC ,CHILD_SNACK_PM,21,776,231,79,1086,6692,1992,682,9366,446
SAN DIEGO,Feb 2014,CACF,2014,EDUCATIONAL ENRICHMENT SYSTEMS INC ,CHILD_BREAKFAST,19,776,231,79,1086,7282,2168,742,10192,536.4211
SAN DIEGO,Feb 2014,CACF,2014,EDUCATIONAL ENRICHMENT SYSTEMS INC ,CHILD_LUNCH,19,776,231,79,1086,7325,2181,746,10252,539.5789
SAN DIEGO,Feb 2014,CACF,2014,EDUCATIONAL ENRICHMENT SYSTEMS INC ,CHILD_SNACK_AM,19,776,231,79,1086,4589,1366,467,6422,338
SAN DIEGO,Feb 2014,CACF,2014,EDUCATIONAL ENRICHMENT SYSTEMS INC ,CHILD_SNACK_PM,19,776,231,79,1086,6726,2002,685,9413,495.4211
SAN DIEGO,Mar 2014,CACF,2014,EDUCATIONAL ENRICHMENT SYSTEMS INC ,CHILD_BREAKFAST,21,776,231,79,1086,7296,2172,744,10212,486.2857
SAN DIEGO,Mar 2014,CACF,2014,EDUCATIONAL ENRICHMENT SYSTEMS INC ,CHILD_LUNCH,21,776,231,79,1086,7554,2249,769,10572,503.4286
SAN DIEGO,Mar 2014,CACF,2014,EDUCATIONAL ENRICHMENT SYSTEMS INC ,CHILD_SNACK_AM,21,776,231,79,1086,4379,1304,446,6129,291.8571
SAN DIEGO,Mar 2014,CACF,2014,EDUCATIONAL ENRICHMENT SYSTEMS INC ,CHILD_SNACK_PM,21,776,231,79,1086,6814,2029,694,9537,454.1429
SAN DIEGO,Apr 2014,CACF,2014,EDUCATIONAL ENRICHMENT SYSTEMS INC ,CHILD_BREAKFAST,22,776,231,79,1086,7907,2354,806,11067,503.0455
SAN DIEGO,Apr 2014,CACF,2014,EDUCATIONAL ENRICHMENT SYSTEMS INC ,CHILD_LUNCH,22,776,231,79,1086,8287,2467,845,11599,527.2273
SAN DIEGO,Apr 2014,CACF,2014,EDUCATIONAL ENRICHMENT SYSTEMS INC ,CHILD_SNACK_AM,22,776,231,79,1086,5164,1537,527,7228,328.5455
SAN DIEGO,Apr 2014,CACF,2014,EDUCATIONAL ENRICHMENT SYSTEMS INC ,CHILD_SNACK_PM,22,776,231,79,1086,7420,2209,756,10385,472.0455
SAN DIEGO,May 2014,CACF,2014,EDUCATIONAL ENRICHMENT SYSTEMS INC ,CHILD_BREAKFAST,21,776,231,79,1086,7270,2164,741,10175,484.5238
SAN DIEGO,May 2014,CACF,2014,EDUCATIONAL ENRICHMENT SYSTEMS INC ,CHILD_LUNCH,21,776,231,79,1086,7591,2260,773,10624,505.9048
SAN DIEGO,May 2014,CACF,2014,EDUCATIONAL ENRICHMENT SYSTEMS INC ,CHILD_SNACK_AM,21,776,231,79,1086,4934,1469,502,6905,328.8095
SAN DIEGO,May 2014,CACF,2014,EDUCATIONAL ENRICHMENT SYSTEMS INC ,CHILD_SNACK_PM,21,776,231,79,1086,6966,2074,710,9750,464.2857
SAN DIEGO,Jun 2014,CACF,2014,EDUCATIONAL ENRICHMENT SYSTEMS INC ,CHILD_BREAKFAST,21,776,231,79,1086,4162,1239,424,5825,277.381
SAN DIEGO,Jun 2014,CACF,2014,EDUCATIONAL ENRICHMENT SYSTEMS INC ,CHILD_LUNCH,21,776,231,79,1086,4754,1415,484,6653,316.8095
SAN DIEGO,Jun 2014,CACF,2014,EDUCATIONAL ENRICHMENT SYSTEMS INC ,CHILD_SNACK_AM,21,776,231,79,1086,1660,494,170,2324,110.6667
SAN DIEGO,Jun 2014,CACF,2014,EDUCATIONAL ENRICHMENT SYSTEMS INC ,CHILD_SNACK_PM,21,776,231,79,1086,4005,1192,409,5606,266.9524
SAN DIEGO,Jul 2014,CACF,2014,EDUCATIONAL ENRICHMENT SYSTEMS INC ,CHILD_BREAKFAST,22,776,231,79,1086,2306,687,235,3228,146.7273
SAN DIEGO,Jul 2014,CACF,2014,EDUCATIONAL ENRICHMENT SYSTEMS INC ,CHILD_LUNCH,22,776,231,79,1086,3212,956,328,4496,204.3636
SAN DIEGO,Jul 2014,CACF,2014,EDUCATIONAL ENRICHMENT SYSTEMS INC ,CHILD_SNACK_PM,22,776,231,79,1086,2605,776,265,3646,165.7273
SAN DIEGO,Aug 2014,CACF,2014,EDUCATIONAL ENRICHMENT SYSTEMS INC ,CHILD_BREAKFAST,21,776,231,79,1086,3795,1130,386,5311,252.9048
SAN DIEGO,Aug 2014,CACF,2014,EDUCATIONAL ENRICHMENT SYSTEMS INC ,CHILD_LUNCH,21,776,231,79,1086,3577,1065,364,5006,238.381
SAN DIEGO,Aug 2014,CACF,2014,EDUCATIONAL ENRICHMENT SYSTEMS INC ,CHILD_SNACK_AM,21,776,231,79,1086,1660,494,169,2323,110.619
SAN DIEGO,Aug 2014,CACF,2014,EDUCATIONAL ENRICHMENT SYSTEMS INC ,CHILD_SNACK_PM,21,776,231,79,1086,2974,885,303,4162,198.1905
SAN DIEGO,Sep 2014,CACF,2014,EDUCATIONAL ENRICHMENT SYSTEMS INC ,CHILD_BREAKFAST,21,776,231,79,1086,7016,2089,715,9820,467.619
SAN DIEGO,Sep 2014,CACF,2014,EDUCATIONAL ENRICHMENT SYSTEMS INC ,CHILD_LUNCH,21,776,231,79,1086,5648,1681,576,7905,376.4286
SAN DIEGO,Sep 2014,CACF,2014,EDUCATIONAL ENRICHMENT SYSTEMS INC ,CHILD_SNACK_AM,21,776,231,79,1086,4841,1441,493,6775,322.619
SAN DIEGO,Sep 2014,CACF,2014,EDUCATIONAL ENRICHMENT SYSTEMS INC ,CHILD_SNACK_PM,21,776,231,79,1086,4945,1472,504,6921,329.5714
SAN DIEGO,Oct 2013,CACF,2014,EL CAJON WESLEYAN CHURCH ,CHILD_BREAKFAST,23,10,4,77,91,84,34,649,767,33.3478
SAN DIEGO,Oct 2013,CACF,2014,EL CAJON WESLEYAN CHURCH ,CHILD_LUNCH,23,10,4,77,91,104,42,800,946,41.1304
SAN DIEGO,Oct 2013,CACF,2014,EL CAJON WESLEYAN CHURCH ,CHILD_SNACK_PM,23,10,4,77,91,107,43,827,977,42.4783
SAN DIEGO,Nov 2013,CACF,2014,EL CAJON WESLEYAN CHURCH ,CHILD_BREAKFAST,18,10,4,77,91,93,37,717,847,47.0556
SAN DIEGO,Nov 2013,CACF,2014,EL CAJON WESLEYAN CHURCH ,CHILD_LUNCH,18,10,4,77,91,91,36,700,827,45.9444
SAN DIEGO,Nov 2013,CACF,2014,EL CAJON WESLEYAN CHURCH ,CHILD_SNACK_PM,18,10,4,77,91,94,38,727,859,47.7222
SAN DIEGO,Dec 2013,CACF,2014,EL CAJON WESLEYAN CHURCH ,CHILD_BREAKFAST,19,10,4,77,91,89,36,682,807,42.4737
SAN DIEGO,Dec 2013,CACF,2014,EL CAJON WESLEYAN CHURCH ,CHILD_LUNCH,19,10,4,77,91,98,39,758,895,47.1053
SAN DIEGO,Dec 2013,CACF,2014,EL CAJON WESLEYAN CHURCH ,CHILD_SNACK_PM,19,10,4,77,91,95,38,731,864,45.4737
SAN DIEGO,Jan 2014,CACF,2014,EL CAJON WESLEYAN CHURCH ,CHILD_BREAKFAST,21,10,4,57,71,131,52,744,927,44.1429
SAN DIEGO,Jan 2014,CACF,2014,EL CAJON WESLEYAN CHURCH ,CHILD_LUNCH,21,10,4,57,71,137,55,780,972,46.2857
SAN DIEGO,Jan 2014,CACF,2014,EL CAJON WESLEYAN CHURCH ,CHILD_SNACK_PM,21,10,4,57,71,123,49,705,877,41.7619
SAN DIEGO,Jan 2014,CACF,2014,EL CAJON WESLEYAN CHURCH ,OSCH_CHILD_BREAKFAST,21,0,0,21,21,0,0,13,13,0.619
SAN DIEGO,Jan 2014,CACF,2014,EL CAJON WESLEYAN CHURCH ,OSCH_CHILD_LUNCH,21,0,0,21,21,0,0,13,13,0.619
SAN DIEGO,Jan 2014,CACF,2014,EL CAJON WESLEYAN CHURCH ,OSCH_CHILD_SNACK_PM,21,0,0,21,21,0,0,117,117,5.5714
SAN DIEGO,Feb 2014,CACF,2014,EL CAJON WESLEYAN CHURCH ,CHILD_BREAKFAST,19,10,4,57,71,131,52,748,931,49
SAN DIEGO,Feb 2014,CACF,2014,EL CAJON WESLEYAN CHURCH ,CHILD_LUNCH,19,10,4,57,71,133,53,758,944,49.6842
SAN DIEGO,Feb 2014,CACF,2014,EL CAJON WESLEYAN CHURCH ,CHILD_SNACK_PM,19,10,4,57,71,120,48,685,853,44.8947
SAN DIEGO,Feb 2014,CACF,2014,EL CAJON WESLEYAN CHURCH ,OSCH_CHILD_BREAKFAST,19,0,0,21,21,0,0,7,7,0.3684
SAN DIEGO,Feb 2014,CACF,2014,EL CAJON WESLEYAN CHURCH ,OSCH_CHILD_LUNCH,19,0,0,21,21,0,0,7,7,0.3684
SAN DIEGO,Feb 2014,CACF,2014,EL CAJON WESLEYAN CHURCH ,OSCH_CHILD_SNACK_PM,19,0,0,21,21,0,0,133,133,7
SAN DIEGO,Mar 2014,CACF,2014,EL CAJON WESLEYAN CHURCH ,CHILD_BREAKFAST,21,10,4,57,71,142,57,807,1006,47.9048
SAN DIEGO,Mar 2014,CACF,2014,EL CAJON WESLEYAN CHURCH ,CHILD_LUNCH,21,10,4,57,71,147,59,835,1041,49.5714
SAN DIEGO,Mar 2014,CACF,2014,EL CAJON WESLEYAN CHURCH ,CHILD_SNACK_PM,21,10,4,57,71,135,54,769,958,45.619
SAN DIEGO,Mar 2014,CACF,2014,EL CAJON WESLEYAN CHURCH ,OSCH_CHILD_SNACK_PM,21,0,0,21,21,0,0,152,152,7.2381
SAN DIEGO,Apr 2014,CACF,2014,EL CAJON WESLEYAN CHURCH ,CHILD_BREAKFAST,22,10,4,57,71,146,58,834,1038,47.1818
SAN DIEGO,Apr 2014,CACF,2014,EL CAJON WESLEYAN CHURCH ,CHILD_LUNCH,22,10,4,57,71,145,58,826,1029,46.7727
SAN DIEGO,Apr 2014,CACF,2014,EL CAJON WESLEYAN CHURCH ,CHILD_SNACK_PM,22,10,4,57,71,130,52,738,920,41.8182
SAN DIEGO,Apr 2014,CACF,2014,EL CAJON WESLEYAN CHURCH ,OSCH_CHILD_BREAKFAST,22,0,0,21,21,0,0,91,91,4.1364
SAN DIEGO,Apr 2014,CACF,2014,EL CAJON WESLEYAN CHURCH ,OSCH_CHILD_LUNCH,22,0,0,21,21,0,0,92,92,4.1818
SAN DIEGO,Apr 2014,CACF,2014,EL CAJON WESLEYAN CHURCH ,OSCH_CHILD_SNACK_PM,22,0,0,21,21,0,0,150,150,6.8182
SAN DIEGO,May 2014,CACF,2014,EL CAJON WESLEYAN CHURCH ,CHILD_BREAKFAST,21,10,4,57,71,153,61,872,1086,51.7143
SAN DIEGO,May 2014,CACF,2014,EL CAJON WESLEYAN CHURCH ,CHILD_LUNCH,21,10,4,57,71,156,62,889,1107,52.7143
SAN DIEGO,May 2014,CACF,2014,EL CAJON WESLEYAN CHURCH ,CHILD_SNACK_PM,21,10,4,57,71,140,56,800,996,47.4286
SAN DIEGO,May 2014,CACF,2014,EL CAJON WESLEYAN CHURCH ,OSCH_CHILD_BREAKFAST,21,0,0,21,21,0,0,69,69,3.2857
SAN DIEGO,May 2014,CACF,2014,EL CAJON WESLEYAN CHURCH ,OSCH_CHILD_SNACK_PM,21,0,0,21,21,0,0,146,146,6.9524
SAN DIEGO,Jun 2014,CACF,2014,EL CAJON WESLEYAN CHURCH ,CHILD_BREAKFAST,21,10,4,57,71,136,54,774,964,45.9048
SAN DIEGO,Jun 2014,CACF,2014,EL CAJON WESLEYAN CHURCH ,CHILD_LUNCH,21,10,4,57,71,140,56,799,995,47.381
SAN DIEGO,Jun 2014,CACF,2014,EL CAJON WESLEYAN CHURCH ,CHILD_SNACK_PM,21,10,4,57,71,127,51,724,902,42.9524
SAN DIEGO,Jun 2014,CACF,2014,EL CAJON WESLEYAN CHURCH ,OSCH_CHILD_BREAKFAST,21,0,0,21,21,0,0,47,47,2.2381
SAN DIEGO,Jun 2014,CACF,2014,EL CAJON WESLEYAN CHURCH ,OSCH_CHILD_LUNCH,21,0,0,21,21,0,0,36,36,1.7143
SAN DIEGO,Jun 2014,CACF,2014,EL CAJON WESLEYAN CHURCH ,OSCH_CHILD_SNACK_PM,21,0,0,21,21,0,0,123,123,5.8571
SAN DIEGO,Jul 2014,CACF,2014,EL CAJON WESLEYAN CHURCH ,CHILD_BREAKFAST,22,10,4,57,71,130,52,741,923,41.9545
SAN DIEGO,Jul 2014,CACF,2014,EL CAJON WESLEYAN CHURCH ,CHILD_LUNCH,22,10,4,57,71,136,54,776,966,43.9091
SAN DIEGO,Jul 2014,CACF,2014,EL CAJON WESLEYAN CHURCH ,CHILD_SNACK_PM,22,10,4,57,71,122,49,698,869,39.5
SAN DIEGO,Jul 2014,CACF,2014,EL CAJON WESLEYAN CHURCH ,OSCH_CHILD_BREAKFAST,22,0,0,21,21,0,0,165,165,7.5
SAN DIEGO,Jul 2014,CACF,2014,EL CAJON WESLEYAN CHURCH ,OSCH_CHILD_LUNCH,22,0,0,21,21,0,0,166,166,7.5455
SAN DIEGO,Jul 2014,CACF,2014,EL CAJON WESLEYAN CHURCH ,OSCH_CHILD_SNACK_PM,22,0,0,21,21,0,0,123,123,5.5909
SAN DIEGO,Aug 2014,CACF,2014,EL CAJON WESLEYAN CHURCH ,CHILD_BREAKFAST,19,10,4,57,71,101,40,573,714,37.5789
SAN DIEGO,Aug 2014,CACF,2014,EL CAJON WESLEYAN CHURCH ,CHILD_LUNCH,19,10,4,57,71,109,44,621,774,40.7368
SAN DIEGO,Aug 2014,CACF,2014,EL CAJON WESLEYAN CHURCH ,CHILD_SNACK_PM,19,10,4,57,71,102,41,579,722,38
SAN DIEGO,Aug 2014,CACF,2014,EL CAJON WESLEYAN CHURCH ,OSCH_CHILD_BREAKFAST,11,0,0,21,21,0,0,41,41,3.7273
SAN DIEGO,Aug 2014,CACF,2014,EL CAJON WESLEYAN CHURCH ,OSCH_CHILD_LUNCH,11,0,0,21,21,0,0,43,43,3.9091
SAN DIEGO,Aug 2014,CACF,2014,EL CAJON WESLEYAN CHURCH ,OSCH_CHILD_SNACK_PM,11,0,0,21,21,0,0,39,39,3.5455
SAN DIEGO,Sep 2014,CACF,2014,EL CAJON WESLEYAN CHURCH ,CHILD_BREAKFAST,21,10,4,57,71,120,48,683,851,40.5238
SAN DIEGO,Sep 2014,CACF,2014,EL CAJON WESLEYAN CHURCH ,CHILD_LUNCH,21,10,4,57,71,125,50,710,885,42.1429
SAN DIEGO,Sep 2014,CACF,2014,EL CAJON WESLEYAN CHURCH ,CHILD_SNACK_PM,21,10,4,57,71,113,45,646,804,38.2857
SAN DIEGO,Oct 2013,CACF,2014,EPISCOPAL COMMUNITY SERVICES ,HS_CHILD_BREAKFAST,21,1245,0,0,1245,11481,0,0,11481,546.7143
SAN DIEGO,Oct 2013,CACF,2014,EPISCOPAL COMMUNITY SERVICES ,HS_CHILD_LUNCH,21,1245,0,0,1245,17953,0,0,17953,854.9048
SAN DIEGO,Oct 2013,CACF,2014,EPISCOPAL COMMUNITY SERVICES ,HS_CHILD_SNACK_PM,21,1245,0,0,1245,11094,0,0,11094,528.2857
SAN DIEGO,Nov 2013,CACF,2014,EPISCOPAL COMMUNITY SERVICES ,HS_CHILD_BREAKFAST,15,1245,0,0,1245,7862,0,0,7862,524.1333
SAN DIEGO,Nov 2013,CACF,2014,EPISCOPAL COMMUNITY SERVICES ,HS_CHILD_LUNCH,15,1245,0,0,1245,11686,0,0,11686,779.0667
SAN DIEGO,Nov 2013,CACF,2014,EPISCOPAL COMMUNITY SERVICES ,HS_CHILD_SNACK_PM,15,1245,0,0,1245,7093,0,0,7093,472.8667
SAN DIEGO,Dec 2013,CACF,2014,EPISCOPAL COMMUNITY SERVICES ,HS_CHILD_BREAKFAST,15,1245,0,0,1245,7944,0,0,7944,529.6
SAN DIEGO,Dec 2013,CACF,2014,EPISCOPAL COMMUNITY SERVICES ,HS_CHILD_LUNCH,15,1245,0,0,1245,12121,0,0,12121,808.0667
SAN DIEGO,Dec 2013,CACF,2014,EPISCOPAL COMMUNITY SERVICES ,HS_CHILD_SNACK_PM,15,1245,0,0,1245,7237,0,0,7237,482.4667
SAN DIEGO,Jan 2014,CACF,2014,EPISCOPAL COMMUNITY SERVICES ,HS_CHILD_BREAKFAST,18,1245,0,0,1245,9605,0,0,9605,533.6111
SAN DIEGO,Jan 2014,CACF,2014,EPISCOPAL COMMUNITY SERVICES ,HS_CHILD_LUNCH,18,1245,0,0,1245,14647,0,0,14647,813.7222
SAN DIEGO,Jan 2014,CACF,2014,EPISCOPAL COMMUNITY SERVICES ,HS_CHILD_SNACK_PM,18,1245,0,0,1245,9252,0,0,9252,514
SAN DIEGO,Feb 2014,CACF,2014,EPISCOPAL COMMUNITY SERVICES ,HS_CHILD_BREAKFAST,18,1245,0,0,1245,10076,0,0,10076,559.7778
SAN DIEGO,Feb 2014,CACF,2014,EPISCOPAL COMMUNITY SERVICES ,HS_CHILD_LUNCH,18,1245,0,0,1245,15594,0,0,15594,866.3333
SAN DIEGO,Feb 2014,CACF,2014,EPISCOPAL COMMUNITY SERVICES ,HS_CHILD_SNACK_PM,18,1245,0,0,1245,9562,0,0,9562,531.2222
SAN DIEGO,Mar 2014,CACF,2014,EPISCOPAL COMMUNITY SERVICES ,HS_CHILD_BREAKFAST,19,1245,0,0,1245,10322,0,0,10322,543.2632
SAN DIEGO,Mar 2014,CACF,2014,EPISCOPAL COMMUNITY SERVICES ,HS_CHILD_LUNCH,19,1245,0,0,1245,15916,0,0,15916,837.6842
SAN DIEGO,Mar 2014,CACF,2014,EPISCOPAL COMMUNITY SERVICES ,HS_CHILD_SNACK_PM,19,1245,0,0,1245,10072,0,0,10072,530.1053
SAN DIEGO,Apr 2014,CACF,2014,EPISCOPAL COMMUNITY SERVICES ,HS_CHILD_BREAKFAST,21,1245,0,0,1245,9155,0,0,9155,435.9524
SAN DIEGO,Apr 2014,CACF,2014,EPISCOPAL COMMUNITY SERVICES ,HS_CHILD_LUNCH,21,1245,0,0,1245,14038,0,0,14038,668.4762
SAN DIEGO,Apr 2014,CACF,2014,EPISCOPAL COMMUNITY SERVICES ,HS_CHILD_SNACK_PM,21,1245,0,0,1245,9048,0,0,9048,430.8571
SAN DIEGO,May 2014,CACF,2014,EPISCOPAL COMMUNITY SERVICES ,HS_CHILD_BREAKFAST,20,1245,0,0,1245,10294,0,0,10294,514.7
SAN DIEGO,May 2014,CACF,2014,EPISCOPAL COMMUNITY SERVICES ,HS_CHILD_LUNCH,20,1245,0,0,1245,15796,0,0,15796,789.8
SAN DIEGO,May 2014,CACF,2014,EPISCOPAL COMMUNITY SERVICES ,HS_CHILD_SNACK_PM,20,1245,0,0,1245,9462,0,0,9462,473.1
SAN DIEGO,Jun 2014,CACF,2014,EPISCOPAL COMMUNITY SERVICES ,HS_CHILD_BREAKFAST,15,1245,0,0,1245,3401,0,0,3401,226.7333
SAN DIEGO,Jun 2014,CACF,2014,EPISCOPAL COMMUNITY SERVICES ,HS_CHILD_LUNCH,15,1245,0,0,1245,4618,0,0,4618,307.8667
SAN DIEGO,Jun 2014,CACF,2014,EPISCOPAL COMMUNITY SERVICES ,HS_CHILD_SNACK_PM,15,1245,0,0,1245,3295,0,0,3295,219.6667
SAN DIEGO,Jul 2014,CACF,2014,EPISCOPAL COMMUNITY SERVICES ,HS_CHILD_BREAKFAST,8,1142,0,0,1142,655,0,0,655,81.875
SAN DIEGO,Jul 2014,CACF,2014,EPISCOPAL COMMUNITY SERVICES ,HS_CHILD_LUNCH,8,1142,0,0,1142,892,0,0,892,111.5
SAN DIEGO,Jul 2014,CACF,2014,EPISCOPAL COMMUNITY SERVICES ,HS_CHILD_SNACK_PM,8,1142,0,0,1142,510,0,0,510,63.75
SAN DIEGO,Aug 2014,CACF,2014,EPISCOPAL COMMUNITY SERVICES ,HS_CHILD_BREAKFAST,20,1225,0,0,1225,5226,0,0,5226,261.3
SAN DIEGO,Aug 2014,CACF,2014,EPISCOPAL COMMUNITY SERVICES ,HS_CHILD_LUNCH,20,1225,0,0,1225,5913,0,0,5913,295.65
SAN DIEGO,Aug 2014,CACF,2014,EPISCOPAL COMMUNITY SERVICES ,HS_CHILD_SNACK_PM,20,1225,0,0,1225,4657,0,0,4657,232.85
SAN DIEGO,Sep 2014,CACF,2014,EPISCOPAL COMMUNITY SERVICES ,HS_CHILD_BREAKFAST,20,1225,0,0,1225,8307,0,0,8307,415.35
SAN DIEGO,Sep 2014,CACF,2014,EPISCOPAL COMMUNITY SERVICES ,HS_CHILD_LUNCH,20,1225,0,0,1225,11535,0,0,11535,576.75
SAN DIEGO,Sep 2014,CACF,2014,EPISCOPAL COMMUNITY SERVICES ,HS_CHILD_SNACK_PM,20,1225,0,0,1225,7029,0,0,7029,351.45
SAN DIEGO,Oct 2013,CACF,2014,ESCONDIDO COMMUNITY CHILD DEVELOPMENT CTR,CHILD_BREAKFAST,23,290,81,16,387,4385,1225,241,5851,254.3913
SAN DIEGO,Oct 2013,CACF,2014,ESCONDIDO COMMUNITY CHILD DEVELOPMENT CTR,CHILD_LUNCH,23,290,81,16,387,4869,1360,268,6497,282.4783
SAN DIEGO,Oct 2013,CACF,2014,ESCONDIDO COMMUNITY CHILD DEVELOPMENT CTR,CHILD_SNACK_PM,23,290,81,16,387,3919,1094,216,5229,227.3478
SAN DIEGO,Nov 2013,CACF,2014,ESCONDIDO COMMUNITY CHILD DEVELOPMENT CTR,CHILD_BREAKFAST,19,290,81,16,387,3506,979,194,4679,246.2632
SAN DIEGO,Nov 2013,CACF,2014,ESCONDIDO COMMUNITY CHILD DEVELOPMENT CTR,CHILD_LUNCH,19,290,81,16,387,3874,1082,214,5170,272.1053
SAN DIEGO,Nov 2013,CACF,2014,ESCONDIDO COMMUNITY CHILD DEVELOPMENT CTR,CHILD_SNACK_PM,19,290,81,16,387,3006,840,165,4011,211.1053
SAN DIEGO,Dec 2013,CACF,2014,ESCONDIDO COMMUNITY CHILD DEVELOPMENT CTR,CHILD_BREAKFAST,19,290,81,16,387,3414,954,188,4556,239.7895
SAN DIEGO,Dec 2013,CACF,2014,ESCONDIDO COMMUNITY CHILD DEVELOPMENT CTR,CHILD_LUNCH,19,290,81,16,387,3883,1085,214,5182,272.7368
SAN DIEGO,Dec 2013,CACF,2014,ESCONDIDO COMMUNITY CHILD DEVELOPMENT CTR,CHILD_SNACK_PM,19,290,81,16,387,3151,880,174,4205,221.3158
SAN DIEGO,Jan 2014,CACF,2014,ESCONDIDO COMMUNITY CHILD DEVELOPMENT CTR,CHILD_BREAKFAST,22,290,81,16,387,4099,1145,226,5470,248.6364
SAN DIEGO,Jan 2014,CACF,2014,ESCONDIDO COMMUNITY CHILD DEVELOPMENT CTR,CHILD_LUNCH,22,290,81,16,387,4595,1283,253,6131,278.6818
SAN DIEGO,Jan 2014,CACF,2014,ESCONDIDO COMMUNITY CHILD DEVELOPMENT CTR,CHILD_SNACK_PM,22,290,81,16,387,3744,1046,206,4996,227.0909
SAN DIEGO,Feb 2014,CACF,2014,ESCONDIDO COMMUNITY CHILD DEVELOPMENT CTR,CHILD_BREAKFAST,20,290,81,16,387,3927,1097,216,5240,262
SAN DIEGO,Feb 2014,CACF,2014,ESCONDIDO COMMUNITY CHILD DEVELOPMENT CTR,CHILD_LUNCH,20,290,81,16,387,4355,1216,240,5811,290.55
SAN DIEGO,Feb 2014,CACF,2014,ESCONDIDO COMMUNITY CHILD DEVELOPMENT CTR,CHILD_SNACK_PM,20,290,81,16,387,3466,968,191,4625,231.25
SAN DIEGO,Mar 2014,CACF,2014,ESCONDIDO COMMUNITY CHILD DEVELOPMENT CTR,CHILD_BREAKFAST,21,290,81,16,387,4136,1155,228,5519,262.8095
SAN DIEGO,Mar 2014,CACF,2014,ESCONDIDO COMMUNITY CHILD DEVELOPMENT CTR,CHILD_LUNCH,21,290,81,16,387,4654,1300,256,6210,295.7143
SAN DIEGO,Mar 2014,CACF,2014,ESCONDIDO COMMUNITY CHILD DEVELOPMENT CTR,CHILD_SNACK_PM,21,290,81,16,387,3664,1023,202,4889,232.8095
SAN DIEGO,Apr 2014,CACF,2014,ESCONDIDO COMMUNITY CHILD DEVELOPMENT CTR,CHILD_BREAKFAST,22,290,81,16,387,4052,1132,223,5407,245.7727
SAN DIEGO,Apr 2014,CACF,2014,ESCONDIDO COMMUNITY CHILD DEVELOPMENT CTR,CHILD_LUNCH,22,290,81,16,387,4717,1318,260,6295,286.1364
SAN DIEGO,Apr 2014,CACF,2014,ESCONDIDO COMMUNITY CHILD DEVELOPMENT CTR,CHILD_SNACK_PM,22,290,81,16,387,3835,1071,212,5118,232.6364
SAN DIEGO,May 2014,CACF,2014,ESCONDIDO COMMUNITY CHILD DEVELOPMENT CTR,CHILD_BREAKFAST,21,290,81,16,387,3864,1079,213,5156,245.5238
SAN DIEGO,May 2014,CACF,2014,ESCONDIDO COMMUNITY CHILD DEVELOPMENT CTR,CHILD_LUNCH,21,290,81,16,387,4461,1246,246,5953,283.4762
SAN DIEGO,May 2014,CACF,2014,ESCONDIDO COMMUNITY CHILD DEVELOPMENT CTR,CHILD_SNACK_PM,21,290,81,16,387,3526,985,194,4705,224.0476
SAN DIEGO,Jun 2014,CACF,2014,ESCONDIDO COMMUNITY CHILD DEVELOPMENT CTR,CHILD_BREAKFAST,20,290,81,16,387,3763,1051,207,5021,251.05
SAN DIEGO,Jun 2014,CACF,2014,ESCONDIDO COMMUNITY CHILD DEVELOPMENT CTR,CHILD_LUNCH,20,290,81,16,387,4323,1207,238,5768,288.4
SAN DIEGO,Jun 2014,CACF,2014,ESCONDIDO COMMUNITY CHILD DEVELOPMENT CTR,CHILD_SNACK_PM,20,290,81,16,387,3421,955,189,4565,228.25
SAN DIEGO,Jul 2014,CACF,2014,ESCONDIDO COMMUNITY CHILD DEVELOPMENT CTR,CHILD_BREAKFAST,19,290,81,16,387,3396,949,187,4532,238.5263
SAN DIEGO,Jul 2014,CACF,2014,ESCONDIDO COMMUNITY CHILD DEVELOPMENT CTR,CHILD_LUNCH,19,290,81,16,387,4011,1120,221,5352,281.6842
SAN DIEGO,Jul 2014,CACF,2014,ESCONDIDO COMMUNITY CHILD DEVELOPMENT CTR,CHILD_SNACK_PM,19,290,81,16,387,3222,900,177,4299,226.2632
SAN DIEGO,Aug 2014,CACF,2014,ESCONDIDO COMMUNITY CHILD DEVELOPMENT CTR,CHILD_BREAKFAST,21,290,81,16,387,3640,1017,200,4857,231.2857
SAN DIEGO,Aug 2014,CACF,2014,ESCONDIDO COMMUNITY CHILD DEVELOPMENT CTR,CHILD_LUNCH,21,290,81,16,387,4203,1174,231,5608,267.0476
SAN DIEGO,Aug 2014,CACF,2014,ESCONDIDO COMMUNITY CHILD DEVELOPMENT CTR,CHILD_SNACK_PM,21,290,81,16,387,3328,930,183,4441,211.4762
SAN DIEGO,Sep 2014,CACF,2014,ESCONDIDO COMMUNITY CHILD DEVELOPMENT CTR,CHILD_BREAKFAST,21,290,81,16,387,3885,1085,214,5184,246.8571
SAN DIEGO,Sep 2014,CACF,2014,ESCONDIDO COMMUNITY CHILD DEVELOPMENT CTR,CHILD_LUNCH,21,290,81,16,387,4281,1196,236,5713,272.0476
SAN DIEGO,Sep 2014,CACF,2014,ESCONDIDO COMMUNITY CHILD DEVELOPMENT CTR,CHILD_SNACK_PM,21,290,81,16,387,3384,945,186,4515,215
SAN DIEGO,Oct 2013,CACF,2014,Escondido Union High School District,CHILD_BREAKFAST,23,22,3,1,26,310,42,14,366,15.913
SAN DIEGO,Oct 2013,CACF,2014,Escondido Union High School District,CHILD_LUNCH,23,22,3,1,26,308,42,14,364,15.8261
SAN DIEGO,Oct 2013,CACF,2014,Escondido Union High School District,CHILD_SNACK_PM,23,22,3,1,26,267,36,13,316,13.7391
SAN DIEGO,Nov 2013,CACF,2014,Escondido Union High School District,CHILD_BREAKFAST,15,22,3,1,26,206,28,9,243,16.2
SAN DIEGO,Nov 2013,CACF,2014,Escondido Union High School District,CHILD_LUNCH,15,22,3,1,26,202,28,9,239,15.9333
SAN DIEGO,Nov 2013,CACF,2014,Escondido Union High School District,CHILD_SNACK_PM,15,22,3,1,26,169,23,8,200,13.3333
SAN DIEGO,Dec 2013,CACF,2014,Escondido Union High School District,CHILD_BREAKFAST,15,22,3,1,26,190,26,8,224,14.9333
SAN DIEGO,Dec 2013,CACF,2014,Escondido Union High School District,CHILD_LUNCH,15,22,3,1,26,190,26,8,224,14.9333
SAN DIEGO,Dec 2013,CACF,2014,Escondido Union High School District,CHILD_SNACK_PM,15,22,3,1,26,141,19,7,167,11.1333
SAN DIEGO,Jan 2014,CACF,2014,Escondido Union High School District,CHILD_BREAKFAST,18,22,3,1,26,238,32,11,281,15.6111
SAN DIEGO,Jan 2014,CACF,2014,Escondido Union High School District,CHILD_LUNCH,18,22,3,1,26,242,33,11,286,15.8889
SAN DIEGO,Jan 2014,CACF,2014,Escondido Union High School District,CHILD_SNACK_PM,18,22,3,1,26,202,28,9,239,13.2778
SAN DIEGO,Feb 2014,CACF,2014,Escondido Union High School District,CHILD_BREAKFAST,18,22,3,1,26,228,31,11,270,15
SAN DIEGO,Feb 2014,CACF,2014,Escondido Union High School District,CHILD_LUNCH,18,22,3,1,26,234,32,10,276,15.3333
SAN DIEGO,Feb 2014,CACF,2014,Escondido Union High School District,CHILD_SNACK_PM,18,22,3,1,26,168,23,7,198,11
SAN DIEGO,Apr 2014,CACF,2014,Escondido Union High School District,CHILD_BREAKFAST,26,23,3,2,28,242,32,21,295,11.3462
SAN DIEGO,Apr 2014,CACF,2014,Escondido Union High School District,CHILD_LUNCH,26,23,3,2,28,228,30,20,278,10.6923
SAN DIEGO,Apr 2014,CACF,2014,Escondido Union High School District,CHILD_SNACK_PM,26,23,3,2,28,113,15,9,137,5.2692
SAN DIEGO,May 2014,CACF,2014,Escondido Union High School District,CHILD_BREAKFAST,22,23,3,2,28,304,40,26,370,16.8182
SAN DIEGO,May 2014,CACF,2014,Escondido Union High School District,CHILD_LUNCH,22,23,3,2,28,305,40,26,371,16.8636
SAN DIEGO,May 2014,CACF,2014,Escondido Union High School District,CHILD_SNACK_PM,22,23,3,2,28,148,19,13,180,8.1818
SAN DIEGO,Jun 2014,CACF,2014,Escondido Union High School District,CHILD_BREAKFAST,16,23,3,2,28,65,8,6,79,4.9375
SAN DIEGO,Jun 2014,CACF,2014,Escondido Union High School District,CHILD_LUNCH,16,23,3,2,28,64,8,6,78,4.875
SAN DIEGO,Jun 2014,CACF,2014,Escondido Union High School District,CHILD_SNACK_PM,16,23,3,2,28,26,3,3,32,2
SAN DIEGO,Aug 2014,CACF,2014,Escondido Union High School District,ATRISK_CHILD_SUPPER,5,639,0,0,639,639,0,0,639,127.8
SAN DIEGO,Aug 2014,CACF,2014,Escondido Union High School District,CHILD_BREAKFAST,10,21,0,1,22,132,0,6,138,13.8
SAN DIEGO,Aug 2014,CACF,2014,Escondido Union High School District,CHILD_LUNCH,10,21,0,1,22,134,0,6,140,14
SAN DIEGO,Aug 2014,CACF,2014,Escondido Union High School District,CHILD_SNACK_PM,10,21,0,1,22,57,0,3,60,6
SAN DIEGO,Sep 2014,CACF,2014,Escondido Union High School District,ATRISK_CHILD_SUPPER,20,4172,0,0,4172,4172,0,0,4172,208.6
SAN DIEGO,Sep 2014,CACF,2014,Escondido Union High School District,CHILD_BREAKFAST,21,21,0,1,22,291,0,14,305,14.5238
SAN DIEGO,Sep 2014,CACF,2014,Escondido Union High School District,CHILD_LUNCH,21,21,0,1,22,283,0,14,297,14.1429
SAN DIEGO,Sep 2014,CACF,2014,Escondido Union High School District,CHILD_SNACK_PM,21,21,0,1,22,130,0,6,136,6.4762
SAN DIEGO,Oct 2013,CACF,2014,Escondido Union School District,ATRISK_CHILD_SNACK_NT,21,9505,0,0,9505,29627,0,0,29627,1410.8095
SAN DIEGO,Oct 2013,CACF,2014,Escondido Union School District,ATRISK_CHILD_SUPPER,21,9505,0,0,9505,2242,0,0,2242,106.7619
SAN DIEGO,Nov 2013,CACF,2014,Escondido Union School District,ATRISK_CHILD_SNACK_NT,15,9502,0,0,9502,20934,0,0,20934,1395.6
SAN DIEGO,Nov 2013,CACF,2014,Escondido Union School District,ATRISK_CHILD_SUPPER,15,9502,0,0,9502,1565,0,0,1565,104.3333
SAN DIEGO,Dec 2013,CACF,2014,Escondido Union School District,ATRISK_CHILD_SNACK,15,10007,0,0,10007,20943,0,0,20943,1396.2
SAN DIEGO,Dec 2013,CACF,2014,Escondido Union School District,ATRISK_CHILD_SUPPER,15,10007,0,0,10007,1453,0,0,1453,96.8667
SAN DIEGO,Jan 2014,CACF,2014,Escondido Union School District,ATRISK_CHILD_SNACK,19,10194,0,0,10194,27174,0,0,27174,1430.2105
SAN DIEGO,Jan 2014,CACF,2014,Escondido Union School District,ATRISK_CHILD_SUPPER,19,10194,0,0,10194,1793,0,0,1793,94.3684
SAN DIEGO,Feb 2014,CACF,2014,Escondido Union School District,ATRISK_CHILD_SNACK,18,10179,0,0,10179,26245,0,0,26245,1458.0556
SAN DIEGO,Feb 2014,CACF,2014,Escondido Union School District,ATRISK_CHILD_SUPPER,18,10179,0,0,10179,1598,0,0,1598,88.7778
SAN DIEGO,Mar 2014,CACF,2014,Escondido Union School District,ATRISK_CHILD_SNACK,21,10209,0,0,10209,30033,0,0,30033,1430.1429
SAN DIEGO,Mar 2014,CACF,2014,Escondido Union School District,ATRISK_CHILD_SUPPER,21,10209,0,0,10209,1885,0,0,1885,89.7619
SAN DIEGO,Apr 2014,CACF,2014,Escondido Union School District,ATRISK_CHILD_LUNCH,22,10131,0,0,10131,1524,0,0,1524,69.2727
SAN DIEGO,Apr 2014,CACF,2014,Escondido Union School District,ATRISK_CHILD_SNACK,22,10131,0,0,10131,15637,0,0,15637,710.7727
SAN DIEGO,Apr 2014,CACF,2014,Escondido Union School District,ATRISK_CHILD_SNACK_NT,22,10131,0,0,10131,420,0,0,420,19.0909
SAN DIEGO,Apr 2014,CACF,2014,Escondido Union School District,ATRISK_CHILD_SUPPER,22,10131,0,0,10131,2558,0,0,2558,116.2727
SAN DIEGO,May 2014,CACF,2014,Escondido Union School District,ATRISK_CHILD_SNACK,19,10197,0,0,10197,18690,0,0,18690,983.6842
SAN DIEGO,May 2014,CACF,2014,Escondido Union School District,ATRISK_CHILD_SUPPER,19,10197,0,0,10197,10667,0,0,10667,561.4211
SAN DIEGO,Jun 2014,CACF,2014,Escondido Union School District,ATRISK_CHILD_SNACK,8,10141,0,0,10141,6999,0,0,6999,874.875
SAN DIEGO,Jun 2014,CACF,2014,Escondido Union School District,ATRISK_CHILD_SUPPER,8,10141,0,0,10141,3862,0,0,3862,482.75
SAN DIEGO,Aug 2014,CACF,2014,Escondido Union School District,ATRISK_CHILD_SNACK,9,9636,0,0,9636,6629,0,0,6629,736.5556
SAN DIEGO,Aug 2014,CACF,2014,Escondido Union School District,ATRISK_CHILD_SUPPER,9,9636,0,0,9636,5048,0,0,5048,560.8889
SAN DIEGO,Sep 2014,CACF,2014,Escondido Union School District,ATRISK_CHILD_SNACK,21,8432,0,0,8432,19197,0,0,19197,914.1429
SAN DIEGO,Sep 2014,CACF,2014,Escondido Union School District,ATRISK_CHILD_SUPPER,21,8432,0,0,8432,10085,0,0,10085,480.2381
SAN DIEGO,Oct 2013,CACF,2014,FALLBROOK CHILD DEVELOP CENTER ,CHILD_BREAKFAST,23,36,9,3,48,677,169,56,902,39.2174
SAN DIEGO,Oct 2013,CACF,2014,FALLBROOK CHILD DEVELOP CENTER ,CHILD_LUNCH,23,36,9,3,48,671,168,56,895,38.913
SAN DIEGO,Oct 2013,CACF,2014,FALLBROOK CHILD DEVELOP CENTER ,CHILD_SNACK_PM,23,36,9,3,48,469,117,39,625,27.1739
SAN DIEGO,Nov 2013,CACF,2014,FALLBROOK CHILD DEVELOP CENTER ,CHILD_BREAKFAST,19,36,9,3,48,521,130,44,695,36.5789
SAN DIEGO,Nov 2013,CACF,2014,FALLBROOK CHILD DEVELOP CENTER ,CHILD_LUNCH,19,36,9,3,48,519,130,43,692,36.4211
SAN DIEGO,Nov 2013,CACF,2014,FALLBROOK CHILD DEVELOP CENTER ,CHILD_SNACK_PM,19,36,9,3,48,389,97,33,519,27.3158
SAN DIEGO,Dec 2013,CACF,2014,FALLBROOK CHILD DEVELOP CENTER ,CHILD_BREAKFAST,15,36,9,3,48,439,110,36,585,39
SAN DIEGO,Dec 2013,CACF,2014,FALLBROOK CHILD DEVELOP CENTER ,CHILD_LUNCH,15,36,9,3,48,434,109,36,579,38.6
SAN DIEGO,Dec 2013,CACF,2014,FALLBROOK CHILD DEVELOP CENTER ,CHILD_SNACK_PM,15,36,9,3,48,326,81,27,434,28.9333
SAN DIEGO,Jan 2014,CACF,2014,FALLBROOK CHILD DEVELOP CENTER ,CHILD_BREAKFAST,20,36,9,3,48,565,141,47,753,37.65
SAN DIEGO,Jan 2014,CACF,2014,FALLBROOK CHILD DEVELOP CENTER ,CHILD_LUNCH,20,36,9,3,48,558,140,46,744,37.2
SAN DIEGO,Jan 2014,CACF,2014,FALLBROOK CHILD DEVELOP CENTER ,CHILD_SNACK_PM,20,36,9,3,48,443,111,36,590,29.5
SAN DIEGO,Feb 2014,CACF,2014,FALLBROOK CHILD DEVELOP CENTER ,CHILD_BREAKFAST,20,36,9,3,48,557,139,47,743,37.15
SAN DIEGO,Feb 2014,CACF,2014,FALLBROOK CHILD DEVELOP CENTER ,CHILD_LUNCH,20,36,9,3,48,553,138,46,737,36.85
SAN DIEGO,Feb 2014,CACF,2014,FALLBROOK CHILD DEVELOP CENTER ,CHILD_SNACK_PM,20,36,9,3,48,416,104,35,555,27.75
SAN DIEGO,Mar 2014,CACF,2014,FALLBROOK CHILD DEVELOP CENTER ,CHILD_BREAKFAST,21,36,9,3,48,662,166,55,883,42.0476
SAN DIEGO,Mar 2014,CACF,2014,FALLBROOK CHILD DEVELOP CENTER ,CHILD_LUNCH,21,36,9,3,48,660,165,55,880,41.9048
SAN DIEGO,Mar 2014,CACF,2014,FALLBROOK CHILD DEVELOP CENTER ,CHILD_SNACK_PM,21,36,9,3,48,490,122,41,653,31.0952
SAN DIEGO,Apr 2014,CACF,2014,FALLBROOK CHILD DEVELOP CENTER ,CHILD_BREAKFAST,22,36,9,3,48,668,167,56,891,40.5
SAN DIEGO,Apr 2014,CACF,2014,FALLBROOK CHILD DEVELOP CENTER ,CHILD_LUNCH,22,36,9,3,48,661,165,55,881,40.0455
SAN DIEGO,Apr 2014,CACF,2014,FALLBROOK CHILD DEVELOP CENTER ,CHILD_SNACK_PM,22,36,9,3,48,495,124,41,660,30
SAN DIEGO,May 2014,CACF,2014,FALLBROOK CHILD DEVELOP CENTER ,CHILD_BREAKFAST,21,36,9,3,48,580,145,48,773,36.8095
SAN DIEGO,May 2014,CACF,2014,FALLBROOK CHILD DEVELOP CENTER ,CHILD_LUNCH,21,36,9,3,48,575,144,47,766,36.4762
SAN DIEGO,May 2014,CACF,2014,FALLBROOK CHILD DEVELOP CENTER ,CHILD_SNACK_PM,21,36,9,3,48,421,105,35,561,26.7143
SAN DIEGO,Jun 2014,CACF,2014,FALLBROOK CHILD DEVELOP CENTER ,CHILD_BREAKFAST,21,36,9,3,48,570,143,47,760,36.1905
SAN DIEGO,Jun 2014,CACF,2014,FALLBROOK CHILD DEVELOP CENTER ,CHILD_LUNCH,21,36,9,3,48,564,141,47,752,35.8095
SAN DIEGO,Jun 2014,CACF,2014,FALLBROOK CHILD DEVELOP CENTER ,CHILD_SNACK_PM,21,36,9,3,48,398,100,33,531,25.2857
SAN DIEGO,Jul 2014,CACF,2014,FALLBROOK CHILD DEVELOP CENTER ,CHILD_BREAKFAST,22,36,9,3,48,544,136,45,725,32.9545
SAN DIEGO,Jul 2014,CACF,2014,FALLBROOK CHILD DEVELOP CENTER ,CHILD_LUNCH,22,36,9,3,48,531,133,44,708,32.1818
SAN DIEGO,Jul 2014,CACF,2014,FALLBROOK CHILD DEVELOP CENTER ,CHILD_SNACK_PM,22,36,9,3,48,371,93,31,495,22.5
SAN DIEGO,Aug 2014,CACF,2014,FALLBROOK CHILD DEVELOP CENTER ,CHILD_BREAKFAST,21,36,9,3,48,503,126,41,670,31.9048
SAN DIEGO,Aug 2014,CACF,2014,FALLBROOK CHILD DEVELOP CENTER ,CHILD_LUNCH,21,36,9,3,48,492,123,41,656,31.2381
SAN DIEGO,Aug 2014,CACF,2014,FALLBROOK CHILD DEVELOP CENTER ,CHILD_SNACK_PM,21,36,9,3,48,356,89,30,475,22.619
SAN DIEGO,Sep 2014,CACF,2014,FALLBROOK CHILD DEVELOP CENTER ,CHILD_BREAKFAST,21,36,9,3,48,593,148,49,790,37.619
SAN DIEGO,Sep 2014,CACF,2014,FALLBROOK CHILD DEVELOP CENTER ,CHILD_LUNCH,21,36,9,3,48,590,147,49,786,37.4286
SAN DIEGO,Sep 2014,CACF,2014,FALLBROOK CHILD DEVELOP CENTER ,CHILD_SNACK_PM,21,36,9,3,48,461,115,38,614,29.2381
SAN DIEGO,Oct 2013,CACF,2014,GARDEN DAY SCHOOL,CHILD_BREAKFAST,23,10,3,18,31,170,51,307,528,22.9565
SAN DIEGO,Oct 2013,CACF,2014,GARDEN DAY SCHOOL,CHILD_LUNCH,23,10,3,18,31,155,46,278,479,20.8261
SAN DIEGO,Oct 2013,CACF,2014,GARDEN DAY SCHOOL,CHILD_SNACK_PM,23,10,3,18,31,183,55,328,566,24.6087
SAN DIEGO,Nov 2013,CACF,2014,GARDEN DAY SCHOOL,CHILD_BREAKFAST,20,12,1,14,27,193,16,225,434,21.7
SAN DIEGO,Nov 2013,CACF,2014,GARDEN DAY SCHOOL,CHILD_LUNCH,20,12,1,14,27,196,16,228,440,22
SAN DIEGO,Nov 2013,CACF,2014,GARDEN DAY SCHOOL,CHILD_SNACK_PM,20,12,1,14,27,182,15,213,410,20.5
SAN DIEGO,Nov 2013,CACF,2014,GARDEN DAY SCHOOL,OSCH_CHILD_BREAKFAST,20,2,0,3,5,27,0,40,67,3.35
SAN DIEGO,Nov 2013,CACF,2014,GARDEN DAY SCHOOL,OSCH_CHILD_LUNCH,20,2,0,3,5,10,0,14,24,1.2
SAN DIEGO,Nov 2013,CACF,2014,GARDEN DAY SCHOOL,OSCH_CHILD_SNACK_PM,20,2,0,3,5,32,0,48,80,4
SAN DIEGO,Dec 2013,CACF,2014,GARDEN DAY SCHOOL,CHILD_BREAKFAST,21,16,1,13,30,238,15,193,446,21.2381
SAN DIEGO,Dec 2013,CACF,2014,GARDEN DAY SCHOOL,CHILD_LUNCH,21,16,1,13,30,263,16,215,494,23.5238
SAN DIEGO,Dec 2013,CACF,2014,GARDEN DAY SCHOOL,CHILD_SNACK_PM,21,16,1,13,30,242,15,197,454,21.619
SAN DIEGO,Dec 2013,CACF,2014,GARDEN DAY SCHOOL,OSCH_CHILD_BREAKFAST,21,2,0,3,5,26,0,40,66,3.1429
SAN DIEGO,Dec 2013,CACF,2014,GARDEN DAY SCHOOL,OSCH_CHILD_LUNCH,21,2,0,3,5,12,0,17,29,1.381
SAN DIEGO,Dec 2013,CACF,2014,GARDEN DAY SCHOOL,OSCH_CHILD_SNACK_PM,21,2,0,3,5,29,0,43,72,3.4286
SAN DIEGO,Jan 2014,CACF,2014,GARDEN DAY SCHOOL,CHILD_BREAKFAST,22,16,1,13,30,256,16,208,480,21.8182
SAN DIEGO,Jan 2014,CACF,2014,GARDEN DAY SCHOOL,CHILD_LUNCH,22,16,1,13,30,283,18,230,531,24.1364
SAN DIEGO,Jan 2014,CACF,2014,GARDEN DAY SCHOOL,CHILD_SNACK_PM,22,16,1,13,30,275,17,223,515,23.4091
SAN DIEGO,Jan 2014,CACF,2014,GARDEN DAY SCHOOL,OSCH_CHILD_BREAKFAST,22,2,0,2,4,27,0,26,53,2.4091
SAN DIEGO,Jan 2014,CACF,2014,GARDEN DAY SCHOOL,OSCH_CHILD_LUNCH,22,2,0,2,4,11,0,10,21,0.9545
SAN DIEGO,Jan 2014,CACF,2014,GARDEN DAY SCHOOL,OSCH_CHILD_SNACK_PM,22,2,0,2,4,33,0,32,65,2.9545
SAN DIEGO,Feb 2014,CACF,2014,GARDEN DAY SCHOOL,CHILD_BREAKFAST,20,21,1,13,35,272,13,168,453,22.65
SAN DIEGO,Feb 2014,CACF,2014,GARDEN DAY SCHOOL,CHILD_LUNCH,20,21,1,13,35,323,15,200,538,26.9
SAN DIEGO,Feb 2014,CACF,2014,GARDEN DAY SCHOOL,CHILD_SNACK_PM,20,21,1,13,35,310,15,192,517,25.85
SAN DIEGO,Feb 2014,CACF,2014,GARDEN DAY SCHOOL,OSCH_CHILD_BREAKFAST,20,2,0,2,4,25,0,24,49,2.45
SAN DIEGO,Feb 2014,CACF,2014,GARDEN DAY SCHOOL,OSCH_CHILD_LUNCH,20,2,0,2,4,14,0,13,27,1.35
SAN DIEGO,Feb 2014,CACF,2014,GARDEN DAY SCHOOL,OSCH_CHILD_SNACK_PM,20,2,0,2,4,31,0,30,61,3.05
SAN DIEGO,Mar 2014,CACF,2014,GARDEN DAY SCHOOL,CHILD_BREAKFAST,21,20,1,14,35,282,14,198,494,23.5238
SAN DIEGO,Mar 2014,CACF,2014,GARDEN DAY SCHOOL,CHILD_LUNCH,21,20,1,14,35,358,18,251,627,29.8571
SAN DIEGO,Mar 2014,CACF,2014,GARDEN DAY SCHOOL,CHILD_SNACK_PM,21,20,1,14,35,338,17,237,592,28.1905
SAN DIEGO,Mar 2014,CACF,2014,GARDEN DAY SCHOOL,OSCH_CHILD_BREAKFAST,21,2,0,2,4,28,0,28,56,2.6667
SAN DIEGO,Mar 2014,CACF,2014,GARDEN DAY SCHOOL,OSCH_CHILD_LUNCH,21,2,0,2,4,12,0,11,23,1.0952
SAN DIEGO,Mar 2014,CACF,2014,GARDEN DAY SCHOOL,OSCH_CHILD_SNACK_PM,21,2,0,2,4,34,0,33,67,3.1905
SAN DIEGO,Apr 2014,CACF,2014,GARDEN DAY SCHOOL,CHILD_BREAKFAST,22,21,1,13,35,292,14,180,486,22.0909
SAN DIEGO,Apr 2014,CACF,2014,GARDEN DAY SCHOOL,CHILD_LUNCH,22,21,1,13,35,409,20,253,682,31
SAN DIEGO,Apr 2014,CACF,2014,GARDEN DAY SCHOOL,CHILD_SNACK_PM,22,21,1,13,35,391,19,242,652,29.6364
SAN DIEGO,Apr 2014,CACF,2014,GARDEN DAY SCHOOL,OSCH_CHILD_BREAKFAST,22,2,0,2,4,29,0,29,58,2.6364
SAN DIEGO,Apr 2014,CACF,2014,GARDEN DAY SCHOOL,OSCH_CHILD_LUNCH,22,2,0,2,4,17,0,17,34,1.5455
SAN DIEGO,Apr 2014,CACF,2014,GARDEN DAY SCHOOL,OSCH_CHILD_SNACK_PM,22,2,0,2,4,32,0,32,64,2.9091
SAN DIEGO,Jun 2014,CACF,2014,GARDEN DAY SCHOOL,CHILD_BREAKFAST,21,21,1,15,37,229,11,163,403,19.1905
SAN DIEGO,Jun 2014,CACF,2014,GARDEN DAY SCHOOL,CHILD_LUNCH,21,21,1,15,37,325,15,232,572,27.2381
SAN DIEGO,Jun 2014,CACF,2014,GARDEN DAY SCHOOL,CHILD_SNACK_PM,21,21,1,15,37,319,15,228,562,26.7619
SAN DIEGO,Jun 2014,CACF,2014,GARDEN DAY SCHOOL,OSCH_CHILD_BREAKFAST,21,5,0,1,6,52,0,11,63,3
SAN DIEGO,Jun 2014,CACF,2014,GARDEN DAY SCHOOL,OSCH_CHILD_LUNCH,21,5,0,1,6,52,0,10,62,2.9524
SAN DIEGO,Jun 2014,CACF,2014,GARDEN DAY SCHOOL,OSCH_CHILD_SNACK_PM,21,5,0,1,6,55,0,11,66,3.1429
SAN DIEGO,Jul 2014,CACF,2014,GARDEN DAY SCHOOL,CHILD_BREAKFAST,22,21,1,12,34,313,15,179,507,23.0455
SAN DIEGO,Jul 2014,CACF,2014,GARDEN DAY SCHOOL,CHILD_LUNCH,22,21,1,12,34,404,19,231,654,29.7273
SAN DIEGO,Jul 2014,CACF,2014,GARDEN DAY SCHOOL,CHILD_SNACK_PM,22,21,1,12,34,382,18,218,618,28.0909
SAN DIEGO,Jul 2014,CACF,2014,GARDEN DAY SCHOOL,OSCH_CHILD_BREAKFAST,22,5,0,1,6,62,0,13,75,3.4091
SAN DIEGO,Jul 2014,CACF,2014,GARDEN DAY SCHOOL,OSCH_CHILD_LUNCH,22,5,0,1,6,86,0,17,103,4.6818
SAN DIEGO,Jul 2014,CACF,2014,GARDEN DAY SCHOOL,OSCH_CHILD_SNACK_PM,22,5,0,1,6,79,0,16,95,4.3182
SAN DIEGO,Oct 2013,CACF,2014,GEORGE G GLENNER ALZHEIMERS FM CTR INC,ADULT_BREAKFAST,23,30,9,61,100,207,62,421,690,30
SAN DIEGO,Oct 2013,CACF,2014,GEORGE G GLENNER ALZHEIMERS FM CTR INC,ADULT_LUNCH,23,30,9,61,100,312,94,633,1039,45.1739
SAN DIEGO,Oct 2013,CACF,2014,GEORGE G GLENNER ALZHEIMERS FM CTR INC,ADULT_SNACK_PM,23,30,9,61,100,313,94,637,1044,45.3913
SAN DIEGO,Nov 2013,CACF,2014,GEORGE G GLENNER ALZHEIMERS FM CTR INC,ADULT_BREAKFAST,19,30,9,61,100,168,50,341,559,29.4211
SAN DIEGO,Nov 2013,CACF,2014,GEORGE G GLENNER ALZHEIMERS FM CTR INC,ADULT_LUNCH,19,30,9,61,100,239,72,487,798,42
SAN DIEGO,Nov 2013,CACF,2014,GEORGE G GLENNER ALZHEIMERS FM CTR INC,ADULT_SNACK_PM,19,30,9,61,100,245,73,498,816,42.9474
SAN DIEGO,Dec 2013,CACF,2014,GEORGE G GLENNER ALZHEIMERS FM CTR INC,ADULT_BREAKFAST,19,30,9,61,100,149,45,302,496,26.1053
SAN DIEGO,Dec 2013,CACF,2014,GEORGE G GLENNER ALZHEIMERS FM CTR INC,ADULT_LUNCH,19,30,9,61,100,222,67,451,740,38.9474
SAN DIEGO,Dec 2013,CACF,2014,GEORGE G GLENNER ALZHEIMERS FM CTR INC,ADULT_SNACK_PM,19,30,9,61,100,229,69,465,763,40.1579
SAN DIEGO,Jan 2014,CACF,2014,GEORGE G GLENNER ALZHEIMERS FM CTR INC,ADULT_BREAKFAST,22,30,9,61,100,180,54,367,601,27.3182
SAN DIEGO,Jan 2014,CACF,2014,GEORGE G GLENNER ALZHEIMERS FM CTR INC,ADULT_LUNCH,22,30,9,61,100,284,85,578,947,43.0455
SAN DIEGO,Jan 2014,CACF,2014,GEORGE G GLENNER ALZHEIMERS FM CTR INC,ADULT_SNACK_PM,22,30,9,61,100,275,82,558,915,41.5909
SAN DIEGO,Feb 2014,CACF,2014,GEORGE G GLENNER ALZHEIMERS FM CTR INC,ADULT_BREAKFAST,19,30,9,61,100,191,57,388,636,33.4737
SAN DIEGO,Feb 2014,CACF,2014,GEORGE G GLENNER ALZHEIMERS FM CTR INC,ADULT_LUNCH,19,30,9,61,100,302,91,613,1006,52.9474
SAN DIEGO,Feb 2014,CACF,2014,GEORGE G GLENNER ALZHEIMERS FM CTR INC,ADULT_SNACK_PM,19,30,9,61,100,280,84,568,932,49.0526
SAN DIEGO,Mar 2014,CACF,2014,GEORGE G GLENNER ALZHEIMERS FM CTR INC,ADULT_BREAKFAST,21,30,9,61,100,228,68,463,759,36.1429
SAN DIEGO,Mar 2014,CACF,2014,GEORGE G GLENNER ALZHEIMERS FM CTR INC,ADULT_LUNCH,21,30,9,61,100,360,108,731,1199,57.0952
SAN DIEGO,Mar 2014,CACF,2014,GEORGE G GLENNER ALZHEIMERS FM CTR INC,ADULT_SNACK_PM,21,30,9,61,100,332,100,675,1107,52.7143
SAN DIEGO,Apr 2014,CACF,2014,GEORGE G GLENNER ALZHEIMERS FM CTR INC,ADULT_BREAKFAST,22,30,9,61,100,213,64,432,709,32.2273
SAN DIEGO,Apr 2014,CACF,2014,GEORGE G GLENNER ALZHEIMERS FM CTR INC,ADULT_LUNCH,22,30,9,61,100,348,104,707,1159,52.6818
SAN DIEGO,Apr 2014,CACF,2014,GEORGE G GLENNER ALZHEIMERS FM CTR INC,ADULT_SNACK_PM,22,30,9,61,100,326,98,664,1088,49.4545
SAN DIEGO,May 2014,CACF,2014,GEORGE G GLENNER ALZHEIMERS FM CTR INC,ADULT_BREAKFAST,21,30,9,61,100,215,64,436,715,34.0476
SAN DIEGO,May 2014,CACF,2014,GEORGE G GLENNER ALZHEIMERS FM CTR INC,ADULT_LUNCH,21,30,9,61,100,339,102,688,1129,53.7619
SAN DIEGO,May 2014,CACF,2014,GEORGE G GLENNER ALZHEIMERS FM CTR INC,ADULT_SNACK_PM,21,30,9,61,100,310,93,629,1032,49.1429
SAN DIEGO,Jun 2014,CACF,2014,GEORGE G GLENNER ALZHEIMERS FM CTR INC,ADULT_BREAKFAST,21,30,9,61,100,209,63,426,698,33.2381
SAN DIEGO,Jun 2014,CACF,2014,GEORGE G GLENNER ALZHEIMERS FM CTR INC,ADULT_LUNCH,21,30,9,61,100,348,104,708,1160,55.2381
SAN DIEGO,Jun 2014,CACF,2014,GEORGE G GLENNER ALZHEIMERS FM CTR INC,ADULT_SNACK_PM,21,30,9,61,100,306,92,623,1021,48.619
SAN DIEGO,Jul 2014,CACF,2014,GEORGE G GLENNER ALZHEIMERS FM CTR INC,ADULT_BREAKFAST,22,30,9,61,100,229,69,466,764,34.7273
SAN DIEGO,Jul 2014,CACF,2014,GEORGE G GLENNER ALZHEIMERS FM CTR INC,ADULT_LUNCH,22,30,9,61,100,352,106,715,1173,53.3182
SAN DIEGO,Jul 2014,CACF,2014,GEORGE G GLENNER ALZHEIMERS FM CTR INC,ADULT_SNACK_PM,22,30,9,61,100,259,78,527,864,39.2727
SAN DIEGO,Aug 2014,CACF,2014,GEORGE G GLENNER ALZHEIMERS FM CTR INC,ADULT_BREAKFAST,21,30,9,61,100,213,64,433,710,33.8095
SAN DIEGO,Aug 2014,CACF,2014,GEORGE G GLENNER ALZHEIMERS FM CTR INC,ADULT_LUNCH,21,30,9,61,100,343,103,698,1144,54.4762
SAN DIEGO,Aug 2014,CACF,2014,GEORGE G GLENNER ALZHEIMERS FM CTR INC,ADULT_SNACK_PM,21,30,9,61,100,257,77,524,858,40.8571
SAN DIEGO,Sep 2014,CACF,2014,GEORGE G GLENNER ALZHEIMERS FM CTR INC,ADULT_BREAKFAST,21,30,9,61,100,206,62,419,687,32.7143
SAN DIEGO,Sep 2014,CACF,2014,GEORGE G GLENNER ALZHEIMERS FM CTR INC,ADULT_LUNCH,21,30,9,61,100,343,103,696,1142,54.381
SAN DIEGO,Sep 2014,CACF,2014,GEORGE G GLENNER ALZHEIMERS FM CTR INC,ADULT_SNACK_PM,21,30,9,61,100,247,74,501,822,39.1429
SAN DIEGO,Oct 2013,CACF,2014,GIGGLES & SMILES CHILD CARE CENTER  ,CHILD_BREAKFAST,23,18,7,55,80,300,117,915,1332,57.913
SAN DIEGO,Oct 2013,CACF,2014,GIGGLES & SMILES CHILD CARE CENTER  ,CHILD_LUNCH,23,18,7,55,80,322,125,982,1429,62.1304
SAN DIEGO,Oct 2013,CACF,2014,GIGGLES & SMILES CHILD CARE CENTER  ,CHILD_SNACK_PM,23,18,7,55,80,293,114,894,1301,56.5652
SAN DIEGO,Nov 2013,CACF,2014,GIGGLES & SMILES CHILD CARE CENTER  ,CHILD_BREAKFAST,18,18,7,55,80,251,98,767,1116,62
SAN DIEGO,Nov 2013,CACF,2014,GIGGLES & SMILES CHILD CARE CENTER  ,CHILD_LUNCH,18,18,7,55,80,266,103,813,1182,65.6667
SAN DIEGO,Nov 2013,CACF,2014,GIGGLES & SMILES CHILD CARE CENTER  ,CHILD_SNACK_PM,18,18,7,55,80,238,92,726,1056,58.6667
SAN DIEGO,Dec 2013,CACF,2014,GIGGLES & SMILES CHILD CARE CENTER  ,CHILD_BREAKFAST,19,18,7,55,80,236,92,723,1051,55.3158
SAN DIEGO,Dec 2013,CACF,2014,GIGGLES & SMILES CHILD CARE CENTER  ,CHILD_LUNCH,19,18,7,55,80,255,99,781,1135,59.7368
SAN DIEGO,Dec 2013,CACF,2014,GIGGLES & SMILES CHILD CARE CENTER  ,CHILD_SNACK_PM,19,18,7,55,80,238,93,728,1059,55.7368
SAN DIEGO,Jan 2014,CACF,2014,GIGGLES & SMILES CHILD CARE CENTER  ,CHILD_BREAKFAST,21,18,7,55,80,270,105,824,1199,57.0952
SAN DIEGO,Jan 2014,CACF,2014,GIGGLES & SMILES CHILD CARE CENTER  ,CHILD_LUNCH,21,18,7,55,80,293,114,893,1300,61.9048
SAN DIEGO,Jan 2014,CACF,2014,GIGGLES & SMILES CHILD CARE CENTER  ,CHILD_SNACK_PM,21,18,7,55,80,275,107,838,1220,58.0952
SAN DIEGO,Feb 2014,CACF,2014,GIGGLES & SMILES CHILD CARE CENTER  ,CHILD_BREAKFAST,19,18,7,55,80,258,100,790,1148,60.4211
SAN DIEGO,Feb 2014,CACF,2014,GIGGLES & SMILES CHILD CARE CENTER  ,CHILD_LUNCH,19,18,7,55,80,283,110,863,1256,66.1053
SAN DIEGO,Feb 2014,CACF,2014,GIGGLES & SMILES CHILD CARE CENTER  ,CHILD_SNACK_PM,19,18,7,55,80,267,104,814,1185,62.3684
SAN DIEGO,Mar 2014,CACF,2014,GIGGLES & SMILES CHILD CARE CENTER  ,CHILD_BREAKFAST,21,18,7,55,80,265,103,811,1179,56.1429
SAN DIEGO,Mar 2014,CACF,2014,GIGGLES & SMILES CHILD CARE CENTER  ,CHILD_LUNCH,21,18,7,55,80,297,116,908,1321,62.9048
SAN DIEGO,Mar 2014,CACF,2014,GIGGLES & SMILES CHILD CARE CENTER  ,CHILD_SNACK_PM,21,18,7,55,80,275,107,842,1224,58.2857
SAN DIEGO,Apr 2014,CACF,2014,GIGGLES & SMILES CHILD CARE CENTER  ,CHILD_BREAKFAST,21,18,7,55,80,250,97,762,1109,52.8095
SAN DIEGO,Apr 2014,CACF,2014,GIGGLES & SMILES CHILD CARE CENTER  ,CHILD_LUNCH,21,18,7,55,80,277,108,848,1233,58.7143
SAN DIEGO,Apr 2014,CACF,2014,GIGGLES & SMILES CHILD CARE CENTER  ,CHILD_SNACK_PM,21,18,7,55,80,264,103,808,1175,55.9524
SAN DIEGO,May 2014,CACF,2014,GIGGLES & SMILES CHILD CARE CENTER  ,CHILD_BREAKFAST,21,18,7,55,80,261,101,797,1159,55.1905
SAN DIEGO,May 2014,CACF,2014,GIGGLES & SMILES CHILD CARE CENTER  ,CHILD_LUNCH,21,18,7,55,80,288,112,882,1282,61.0476
SAN DIEGO,May 2014,CACF,2014,GIGGLES & SMILES CHILD CARE CENTER  ,CHILD_SNACK_PM,21,18,7,55,80,275,107,841,1223,58.2381
SAN DIEGO,Jun 2014,CACF,2014,GIGGLES & SMILES CHILD CARE CENTER  ,CHILD_BREAKFAST,21,18,7,55,80,256,99,781,1136,54.0952
SAN DIEGO,Jun 2014,CACF,2014,GIGGLES & SMILES CHILD CARE CENTER  ,CHILD_LUNCH,21,18,7,55,80,285,111,871,1267,60.3333
SAN DIEGO,Jun 2014,CACF,2014,GIGGLES & SMILES CHILD CARE CENTER  ,CHILD_SNACK_PM,21,18,7,55,80,270,105,824,1199,57.0952
SAN DIEGO,Jul 2014,CACF,2014,GIGGLES & SMILES CHILD CARE CENTER  ,CHILD_BREAKFAST,22,18,7,55,80,254,99,777,1130,51.3636
SAN DIEGO,Jul 2014,CACF,2014,GIGGLES & SMILES CHILD CARE CENTER  ,CHILD_LUNCH,22,18,7,55,80,296,115,906,1317,59.8636
SAN DIEGO,Jul 2014,CACF,2014,GIGGLES & SMILES CHILD CARE CENTER  ,CHILD_SNACK_PM,22,18,7,55,80,275,107,839,1221,55.5
SAN DIEGO,Aug 2014,CACF,2014,GIGGLES & SMILES CHILD CARE CENTER  ,CHILD_BREAKFAST,21,18,7,55,80,254,99,774,1127,53.6667
SAN DIEGO,Aug 2014,CACF,2014,GIGGLES & SMILES CHILD CARE CENTER  ,CHILD_LUNCH,21,18,7,55,80,278,108,851,1237,58.9048
SAN DIEGO,Aug 2014,CACF,2014,GIGGLES & SMILES CHILD CARE CENTER  ,CHILD_SNACK_PM,21,18,7,55,80,255,99,781,1135,54.0476
SAN DIEGO,Sep 2014,CACF,2014,GIGGLES & SMILES CHILD CARE CENTER  ,CHILD_BREAKFAST,21,18,7,55,80,268,104,818,1190,56.6667
SAN DIEGO,Sep 2014,CACF,2014,GIGGLES & SMILES CHILD CARE CENTER  ,CHILD_LUNCH,21,18,7,55,80,286,111,873,1270,60.4762
SAN DIEGO,Sep 2014,CACF,2014,GIGGLES & SMILES CHILD CARE CENTER  ,CHILD_SNACK_PM,21,18,7,55,80,264,103,805,1172,55.8095
SAN DIEGO,Oct 2013,CACF,2014,GROSSMONT CUYAMACA COMMUNITY COLLEGE DISTRICT ,CHILD_BREAKFAST,23,82,13,54,149,711,113,468,1292,56.1739
SAN DIEGO,Oct 2013,CACF,2014,GROSSMONT CUYAMACA COMMUNITY COLLEGE DISTRICT ,CHILD_LUNCH,23,82,13,54,149,1263,200,833,2296,99.8261
SAN DIEGO,Oct 2013,CACF,2014,GROSSMONT CUYAMACA COMMUNITY COLLEGE DISTRICT ,CHILD_SNACK_PM,23,82,13,54,149,596,94,393,1083,47.087
SAN DIEGO,Nov 2013,CACF,2014,GROSSMONT CUYAMACA COMMUNITY COLLEGE DISTRICT ,CHILD_BREAKFAST,18,82,13,54,149,544,86,358,988,54.8889
SAN DIEGO,Nov 2013,CACF,2014,GROSSMONT CUYAMACA COMMUNITY COLLEGE DISTRICT ,CHILD_LUNCH,18,82,13,54,149,934,148,615,1697,94.2778
SAN DIEGO,Nov 2013,CACF,2014,GROSSMONT CUYAMACA COMMUNITY COLLEGE DISTRICT ,CHILD_SNACK_PM,18,82,13,54,149,391,62,257,710,39.4444
SAN DIEGO,Dec 2013,CACF,2014,GROSSMONT CUYAMACA COMMUNITY COLLEGE DISTRICT ,CHILD_BREAKFAST,15,82,13,54,149,307,49,202,558,37.2
SAN DIEGO,Dec 2013,CACF,2014,GROSSMONT CUYAMACA COMMUNITY COLLEGE DISTRICT ,CHILD_LUNCH,15,82,13,54,149,592,94,389,1075,71.6667
SAN DIEGO,Dec 2013,CACF,2014,GROSSMONT CUYAMACA COMMUNITY COLLEGE DISTRICT ,CHILD_SNACK_PM,15,82,13,54,149,254,40,167,461,30.7333
SAN DIEGO,Jan 2014,CACF,2014,GROSSMONT CUYAMACA COMMUNITY COLLEGE DISTRICT ,CHILD_BREAKFAST,21,82,13,54,149,261,41,172,474,22.5714
SAN DIEGO,Jan 2014,CACF,2014,GROSSMONT CUYAMACA COMMUNITY COLLEGE DISTRICT ,CHILD_LUNCH,21,82,13,54,149,550,87,363,1000,47.619
SAN DIEGO,Jan 2014,CACF,2014,GROSSMONT CUYAMACA COMMUNITY COLLEGE DISTRICT ,CHILD_SNACK_PM,21,82,13,54,149,229,36,151,416,19.8095
SAN DIEGO,Feb 2014,CACF,2014,GROSSMONT CUYAMACA COMMUNITY COLLEGE DISTRICT ,CHILD_BREAKFAST,18,82,13,54,149,526,83,346,955,53.0556
SAN DIEGO,Feb 2014,CACF,2014,GROSSMONT CUYAMACA COMMUNITY COLLEGE DISTRICT ,CHILD_LUNCH,18,82,13,54,149,978,155,644,1777,98.7222
SAN DIEGO,Feb 2014,CACF,2014,GROSSMONT CUYAMACA COMMUNITY COLLEGE DISTRICT ,CHILD_SNACK_PM,18,82,13,54,149,445,71,293,809,44.9444
SAN DIEGO,Mar 2014,CACF,2014,GROSSMONT CUYAMACA COMMUNITY COLLEGE DISTRICT ,CHILD_BREAKFAST,21,82,13,54,149,643,102,423,1168,55.619
SAN DIEGO,Mar 2014,CACF,2014,GROSSMONT CUYAMACA COMMUNITY COLLEGE DISTRICT ,CHILD_LUNCH,21,82,13,54,149,1178,187,776,2141,101.9524
SAN DIEGO,Mar 2014,CACF,2014,GROSSMONT CUYAMACA COMMUNITY COLLEGE DISTRICT ,CHILD_SNACK_PM,21,82,13,54,149,538,85,355,978,46.5714
SAN DIEGO,Apr 2014,CACF,2014,GROSSMONT CUYAMACA COMMUNITY COLLEGE DISTRICT ,CHILD_BREAKFAST,21,82,13,54,149,545,86,360,991,47.1905
SAN DIEGO,Apr 2014,CACF,2014,GROSSMONT CUYAMACA COMMUNITY COLLEGE DISTRICT ,CHILD_LUNCH,21,82,13,54,149,1010,160,666,1836,87.4286
SAN DIEGO,Apr 2014,CACF,2014,GROSSMONT CUYAMACA COMMUNITY COLLEGE DISTRICT ,CHILD_SNACK_PM,21,82,13,54,149,415,66,274,755,35.9524
SAN DIEGO,May 2014,CACF,2014,GROSSMONT CUYAMACA COMMUNITY COLLEGE DISTRICT ,CHILD_BREAKFAST,21,82,13,54,149,576,91,379,1046,49.8095
SAN DIEGO,May 2014,CACF,2014,GROSSMONT CUYAMACA COMMUNITY COLLEGE DISTRICT ,CHILD_LUNCH,21,82,13,54,149,1064,169,700,1933,92.0476
SAN DIEGO,May 2014,CACF,2014,GROSSMONT CUYAMACA COMMUNITY COLLEGE DISTRICT ,CHILD_SNACK_PM,21,82,13,54,149,446,71,294,811,38.619
SAN DIEGO,Jun 2014,CACF,2014,GROSSMONT CUYAMACA COMMUNITY COLLEGE DISTRICT ,CHILD_BREAKFAST,21,82,13,54,149,150,24,98,272,12.9524
SAN DIEGO,Jun 2014,CACF,2014,GROSSMONT CUYAMACA COMMUNITY COLLEGE DISTRICT ,CHILD_LUNCH,21,82,13,54,149,310,49,205,564,26.8571
SAN DIEGO,Jun 2014,CACF,2014,GROSSMONT CUYAMACA COMMUNITY COLLEGE DISTRICT ,CHILD_SNACK_PM,21,82,13,54,149,139,22,92,253,12.0476
SAN DIEGO,Jul 2014,CACF,2014,GROSSMONT CUYAMACA COMMUNITY COLLEGE DISTRICT ,CHILD_BREAKFAST,22,82,13,54,149,109,17,72,198,9
SAN DIEGO,Jul 2014,CACF,2014,GROSSMONT CUYAMACA COMMUNITY COLLEGE DISTRICT ,CHILD_LUNCH,22,82,13,54,149,273,43,181,497,22.5909
SAN DIEGO,Jul 2014,CACF,2014,GROSSMONT CUYAMACA COMMUNITY COLLEGE DISTRICT ,CHILD_SNACK_PM,22,82,13,54,149,118,19,77,214,9.7273
SAN DIEGO,Aug 2014,CACF,2014,GROSSMONT CUYAMACA COMMUNITY COLLEGE DISTRICT ,CHILD_BREAKFAST,17,82,13,54,149,325,52,214,591,34.7647
SAN DIEGO,Aug 2014,CACF,2014,GROSSMONT CUYAMACA COMMUNITY COLLEGE DISTRICT ,CHILD_LUNCH,17,82,13,54,149,636,101,418,1155,67.9412
SAN DIEGO,Aug 2014,CACF,2014,GROSSMONT CUYAMACA COMMUNITY COLLEGE DISTRICT ,CHILD_SNACK_PM,17,82,13,54,149,304,48,200,552,32.4706
SAN DIEGO,Sep 2014,CACF,2014,GROSSMONT CUYAMACA COMMUNITY COLLEGE DISTRICT ,CHILD_BREAKFAST,21,82,13,54,149,631,100,416,1147,54.619
SAN DIEGO,Sep 2014,CACF,2014,GROSSMONT CUYAMACA COMMUNITY COLLEGE DISTRICT ,CHILD_LUNCH,21,82,13,54,149,1144,181,754,2079,99
SAN DIEGO,Sep 2014,CACF,2014,GROSSMONT CUYAMACA COMMUNITY COLLEGE DISTRICT ,CHILD_SNACK_PM,21,82,13,54,149,548,87,360,995,47.381
SAN DIEGO,Oct 2013,CACF,2014,Grossmont Union High School District,ATRISK_CHILD_SUPPER,25,1185,0,0,1185,17970,0,0,17970,718.8
SAN DIEGO,Nov 2013,CACF,2014,Grossmont Union High School District,ATRISK_CHILD_SUPPER,17,915,0,0,915,11559,0,0,11559,679.9412
SAN DIEGO,Dec 2013,CACF,2014,Grossmont Union High School District,ATRISK_CHILD_SUPPER,15,993,0,0,993,11357,0,0,11357,757.1333
SAN DIEGO,Jan 2014,CACF,2014,Grossmont Union High School District,ATRISK_CHILD_SUPPER,22,825,0,0,825,14004,0,0,14004,636.5455
SAN DIEGO,Feb 2014,CACF,2014,Grossmont Union High School District,ATRISK_CHILD_SUPPER,23,801,0,0,801,14190,0,0,14190,616.9565
SAN DIEGO,Mar 2014,CACF,2014,Grossmont Union High School District,ATRISK_CHILD_SUPPER,25,840,0,0,840,16342,0,0,16342,653.68
SAN DIEGO,Apr 2014,CACF,2014,Grossmont Union High School District,ATRISK_CHILD_SUPPER,20,885,0,0,885,14247,0,0,14247,712.35
SAN DIEGO,May 2014,CACF,2014,Grossmont Union High School District,ATRISK_CHILD_SUPPER,26,718,0,0,718,14714,0,0,14714,565.9231
SAN DIEGO,Jun 2014,CACF,2014,Grossmont Union High School District,ATRISK_CHILD_SUPPER,14,683,0,0,683,7339,0,0,7339,524.2143
SAN DIEGO,Sep 2014,CACF,2014,Grossmont Union High School District,ATRISK_CHILD_SUPPER,24,927,0,0,927,15334,0,0,15334,638.9167
SAN DIEGO,Oct 2013,CACF,2014,GSCA INC ,CHILD_BREAKFAST,23,55,8,15,78,600,87,164,851,37
SAN DIEGO,Oct 2013,CACF,2014,GSCA INC ,CHILD_LUNCH,23,55,8,15,78,1250,182,341,1773,77.087
SAN DIEGO,Oct 2013,CACF,2014,GSCA INC ,CHILD_SNACK_AM,23,55,8,15,78,645,94,176,915,39.7826
SAN DIEGO,Oct 2013,CACF,2014,GSCA INC ,CHILD_SNACK_PM,23,55,8,15,78,600,87,164,851,37
SAN DIEGO,Oct 2013,CACF,2014,GSCA INC ,CHILD_SUPPER,23,55,8,15,78,640,93,174,907,39.4348
SAN DIEGO,Oct 2013,CACF,2014,GSCA INC ,OSCH_CHILD_SNACK_AM,23,15,0,2,17,79,0,11,90,3.913
SAN DIEGO,Oct 2013,CACF,2014,GSCA INC ,OSCH_CHILD_SUPPER,23,15,0,2,17,223,0,30,253,11
SAN DIEGO,Nov 2013,CACF,2014,GSCA INC ,CHILD_BREAKFAST,19,55,8,15,78,429,62,117,608,32
SAN DIEGO,Nov 2013,CACF,2014,GSCA INC ,CHILD_LUNCH,19,55,8,15,78,984,143,269,1396,73.4737
SAN DIEGO,Nov 2013,CACF,2014,GSCA INC ,CHILD_SNACK_AM,19,55,8,15,78,516,75,141,732,38.5263
SAN DIEGO,Nov 2013,CACF,2014,GSCA INC ,CHILD_SNACK_PM,19,55,8,15,78,457,66,125,648,34.1053
SAN DIEGO,Nov 2013,CACF,2014,GSCA INC ,CHILD_SUPPER,19,55,8,15,78,513,75,140,728,38.3158
SAN DIEGO,Nov 2013,CACF,2014,GSCA INC ,OSCH_CHILD_LUNCH,19,15,0,2,17,165,0,22,187,9.8421
SAN DIEGO,Nov 2013,CACF,2014,GSCA INC ,OSCH_CHILD_SNACK_AM,19,15,0,2,17,35,0,5,40,2.1053
SAN DIEGO,Nov 2013,CACF,2014,GSCA INC ,OSCH_CHILD_SUPPER,19,15,0,2,17,165,0,22,187,9.8421
SAN DIEGO,Dec 2013,CACF,2014,GSCA INC ,CHILD_BREAKFAST,20,55,8,15,78,479,70,131,680,34
SAN DIEGO,Dec 2013,CACF,2014,GSCA INC ,CHILD_LUNCH,20,55,8,15,78,1085,158,296,1539,76.95
SAN DIEGO,Dec 2013,CACF,2014,GSCA INC ,CHILD_SNACK_AM,20,55,8,15,78,598,87,163,848,42.4
SAN DIEGO,Dec 2013,CACF,2014,GSCA INC ,CHILD_SNACK_PM,20,55,8,15,78,479,70,131,680,34
SAN DIEGO,Dec 2013,CACF,2014,GSCA INC ,CHILD_SUPPER,20,55,8,15,78,604,88,165,857,42.85
SAN DIEGO,Dec 2013,CACF,2014,GSCA INC ,OSCH_CHILD_LUNCH,20,15,0,2,17,163,0,22,185,9.25
SAN DIEGO,Dec 2013,CACF,2014,GSCA INC ,OSCH_CHILD_SNACK_AM,20,15,0,2,17,44,0,6,50,2.5
SAN DIEGO,Dec 2013,CACF,2014,GSCA INC ,OSCH_CHILD_SUPPER,20,15,0,2,17,159,0,21,180,9
SAN DIEGO,Jan 2014,CACF,2014,GSCA INC ,CHILD_BREAKFAST,22,71,9,17,97,572,72,137,781,35.5
SAN DIEGO,Jan 2014,CACF,2014,GSCA INC ,CHILD_LUNCH,22,71,9,17,97,1265,160,303,1728,78.5455
SAN DIEGO,Jan 2014,CACF,2014,GSCA INC ,CHILD_SNACK_AM,22,71,9,17,97,692,88,166,946,43
SAN DIEGO,Jan 2014,CACF,2014,GSCA INC ,CHILD_SNACK_PM,22,71,9,17,97,582,74,139,795,36.1364
SAN DIEGO,Jan 2014,CACF,2014,GSCA INC ,CHILD_SUPPER,22,71,9,17,97,632,80,152,864,39.2727
SAN DIEGO,Jan 2014,CACF,2014,GSCA INC ,OSCH_CHILD_LUNCH,22,12,2,2,16,32,5,5,42,1.9091
SAN DIEGO,Jan 2014,CACF,2014,GSCA INC ,OSCH_CHILD_SNACK_AM,22,12,2,2,16,23,4,3,30,1.3636
SAN DIEGO,Jan 2014,CACF,2014,GSCA INC ,OSCH_CHILD_SUPPER,22,12,2,2,16,165,28,27,220,10
SAN DIEGO,Feb 2014,CACF,2014,GSCA INC ,CHILD_BREAKFAST,19,71,9,18,98,496,63,126,685,36.0526
SAN DIEGO,Feb 2014,CACF,2014,GSCA INC ,CHILD_LUNCH,19,71,9,18,98,1100,139,279,1518,79.8947
SAN DIEGO,Feb 2014,CACF,2014,GSCA INC ,CHILD_SNACK_AM,19,71,9,18,98,596,75,151,822,43.2632
SAN DIEGO,Feb 2014,CACF,2014,GSCA INC ,CHILD_SNACK_PM,19,71,9,18,98,499,63,127,689,36.2632
SAN DIEGO,Feb 2014,CACF,2014,GSCA INC ,CHILD_SUPPER,19,71,9,18,98,544,69,138,751,39.5263
SAN DIEGO,Feb 2014,CACF,2014,GSCA INC ,OSCH_CHILD_LUNCH,19,10,2,0,12,20,4,0,24,1.2632
SAN DIEGO,Feb 2014,CACF,2014,GSCA INC ,OSCH_CHILD_SNACK_AM,19,10,2,0,12,7,2,0,9,0.4737
SAN DIEGO,Feb 2014,CACF,2014,GSCA INC ,OSCH_CHILD_SUPPER,19,10,2,0,12,157,32,0,189,9.9474
SAN DIEGO,Mar 2014,CACF,2014,GSCA INC ,CHILD_BREAKFAST,21,71,9,17,97,550,70,131,751,35.7619
SAN DIEGO,Mar 2014,CACF,2014,GSCA INC ,CHILD_LUNCH,21,71,9,17,97,1208,153,289,1650,78.5714
SAN DIEGO,Mar 2014,CACF,2014,GSCA INC ,CHILD_SNACK_AM,21,71,9,17,97,653,83,156,892,42.4762
SAN DIEGO,Mar 2014,CACF,2014,GSCA INC ,CHILD_SNACK_PM,21,71,9,17,97,555,70,133,758,36.0952
SAN DIEGO,Mar 2014,CACF,2014,GSCA INC ,CHILD_SUPPER,21,71,9,17,97,613,78,147,838,39.9048
SAN DIEGO,Mar 2014,CACF,2014,GSCA INC ,OSCH_CHILD_LUNCH,21,10,2,0,12,20,4,0,24,1.1429
SAN DIEGO,Mar 2014,CACF,2014,GSCA INC ,OSCH_CHILD_SNACK_AM,21,10,2,0,12,8,2,0,10,0.4762
SAN DIEGO,Mar 2014,CACF,2014,GSCA INC ,OSCH_CHILD_SUPPER,21,10,2,0,12,174,35,0,209,9.9524
SAN DIEGO,Apr 2014,CACF,2014,GSCA INC ,CHILD_BREAKFAST,22,69,9,16,94,576,75,134,785,35.6818
SAN DIEGO,Apr 2014,CACF,2014,GSCA INC ,CHILD_LUNCH,22,69,9,16,94,1273,166,296,1735,78.8636
SAN DIEGO,Apr 2014,CACF,2014,GSCA INC ,CHILD_SNACK_AM,22,69,9,16,94,698,91,162,951,43.2273
SAN DIEGO,Apr 2014,CACF,2014,GSCA INC ,CHILD_SNACK_PM,22,69,9,16,94,584,76,135,795,36.1364
SAN DIEGO,Apr 2014,CACF,2014,GSCA INC ,CHILD_SUPPER,22,69,9,16,94,610,80,141,831,37.7727
SAN DIEGO,Apr 2014,CACF,2014,GSCA INC ,OSCH_CHILD_LUNCH,22,10,2,0,12,72,15,0,87,3.9545
SAN DIEGO,Apr 2014,CACF,2014,GSCA INC ,OSCH_CHILD_SNACK_AM,22,10,2,0,12,62,13,0,75,3.4091
SAN DIEGO,Apr 2014,CACF,2014,GSCA INC ,OSCH_CHILD_SUPPER,22,10,2,0,12,162,33,0,195,8.8636
SAN DIEGO,May 2014,CACF,2014,GSCA INC ,CHILD_BREAKFAST,21,69,9,16,94,545,71,126,742,35.3333
SAN DIEGO,May 2014,CACF,2014,GSCA INC ,CHILD_LUNCH,21,69,9,16,94,1222,159,284,1665,79.2857
SAN DIEGO,May 2014,CACF,2014,GSCA INC ,CHILD_SNACK_AM,21,69,9,16,94,657,86,152,895,42.619
SAN DIEGO,May 2014,CACF,2014,GSCA INC ,CHILD_SNACK_PM,21,69,9,16,94,550,72,127,749,35.6667
SAN DIEGO,May 2014,CACF,2014,GSCA INC ,CHILD_SUPPER,21,69,9,16,94,660,86,153,899,42.8095
SAN DIEGO,May 2014,CACF,2014,GSCA INC ,OSCH_CHILD_LUNCH,21,10,2,0,12,175,35,0,210,10
SAN DIEGO,May 2014,CACF,2014,GSCA INC ,OSCH_CHILD_SUPPER,21,10,2,0,12,175,35,0,210,10
SAN DIEGO,Jun 2014,CACF,2014,GSCA INC ,CHILD_BREAKFAST,21,69,9,16,94,524,68,122,714,34
SAN DIEGO,Jun 2014,CACF,2014,GSCA INC ,CHILD_LUNCH,21,69,9,16,94,1216,159,282,1657,78.9048
SAN DIEGO,Jun 2014,CACF,2014,GSCA INC ,CHILD_SNACK_AM,21,69,9,16,94,657,86,152,895,42.619
SAN DIEGO,Jun 2014,CACF,2014,GSCA INC ,CHILD_SNACK_PM,21,69,9,16,94,551,72,127,750,35.7143
SAN DIEGO,Jun 2014,CACF,2014,GSCA INC ,CHILD_SUPPER,21,69,9,16,94,652,85,151,888,42.2857
SAN DIEGO,Jun 2014,CACF,2014,GSCA INC ,OSCH_CHILD_LUNCH,21,10,2,0,12,175,35,0,210,10
SAN DIEGO,Jun 2014,CACF,2014,GSCA INC ,OSCH_CHILD_SNACK_AM,21,10,2,0,12,92,18,0,110,5.2381
SAN DIEGO,Jun 2014,CACF,2014,GSCA INC ,OSCH_CHILD_SUPPER,21,10,2,0,12,175,35,0,210,10
SAN DIEGO,Jul 2014,CACF,2014,GSCA INC ,CHILD_BREAKFAST,22,69,9,16,94,531,69,124,724,32.9091
SAN DIEGO,Jul 2014,CACF,2014,GSCA INC ,CHILD_LUNCH,22,69,9,16,94,1212,158,281,1651,75.0455
SAN DIEGO,Jul 2014,CACF,2014,GSCA INC ,CHILD_SNACK_AM,22,69,9,16,94,661,86,153,900,40.9091
SAN DIEGO,Jul 2014,CACF,2014,GSCA INC ,CHILD_SNACK_PM,22,69,9,16,94,316,41,74,431,19.5909
SAN DIEGO,Jul 2014,CACF,2014,GSCA INC ,CHILD_SUPPER,22,69,9,16,94,624,81,145,850,38.6364
SAN DIEGO,Jul 2014,CACF,2014,GSCA INC ,OSCH_CHILD_LUNCH,22,10,2,0,12,157,31,0,188,8.5455
SAN DIEGO,Jul 2014,CACF,2014,GSCA INC ,OSCH_CHILD_SNACK_AM,22,10,2,0,12,158,32,0,190,8.6364
SAN DIEGO,Jul 2014,CACF,2014,GSCA INC ,OSCH_CHILD_SUPPER,22,10,2,0,12,148,30,0,178,8.0909
SAN DIEGO,Aug 2014,CACF,2014,GSCA INC ,CHILD_BREAKFAST,21,69,9,16,94,528,69,122,719,34.2381
SAN DIEGO,Aug 2014,CACF,2014,GSCA INC ,CHILD_LUNCH,21,69,9,16,94,1184,154,275,1613,76.8095
SAN DIEGO,Aug 2014,CACF,2014,GSCA INC ,CHILD_SNACK_AM,21,69,9,16,94,631,82,146,859,40.9048
SAN DIEGO,Aug 2014,CACF,2014,GSCA INC ,CHILD_SNACK_PM,21,69,9,16,94,531,69,124,724,34.4762
SAN DIEGO,Aug 2014,CACF,2014,GSCA INC ,CHILD_SUPPER,21,69,9,16,94,622,81,145,848,40.381
SAN DIEGO,Aug 2014,CACF,2014,GSCA INC ,OSCH_CHILD_LUNCH,21,10,2,0,12,131,26,0,157,7.4762
SAN DIEGO,Aug 2014,CACF,2014,GSCA INC ,OSCH_CHILD_SNACK_AM,21,10,2,0,12,129,26,0,155,7.381
SAN DIEGO,Aug 2014,CACF,2014,GSCA INC ,OSCH_CHILD_SUPPER,21,10,2,0,12,117,24,0,141,6.7143
SAN DIEGO,Sep 2014,CACF,2014,GSCA INC ,CHILD_BREAKFAST,21,69,9,16,94,510,67,118,695,33.0952
SAN DIEGO,Sep 2014,CACF,2014,GSCA INC ,CHILD_LUNCH,21,69,9,16,94,1141,149,264,1554,74
SAN DIEGO,Sep 2014,CACF,2014,GSCA INC ,CHILD_SNACK_AM,21,69,9,16,94,621,81,144,846,40.2857
SAN DIEGO,Sep 2014,CACF,2014,GSCA INC ,CHILD_SNACK_PM,21,69,9,16,94,512,67,118,697,33.1905
SAN DIEGO,Sep 2014,CACF,2014,GSCA INC ,CHILD_SUPPER,21,69,9,16,94,608,79,142,829,39.4762
SAN DIEGO,Sep 2014,CACF,2014,GSCA INC ,OSCH_CHILD_LUNCH,21,10,2,0,12,151,30,0,181,8.619
SAN DIEGO,Sep 2014,CACF,2014,GSCA INC ,OSCH_CHILD_SUPPER,21,10,2,0,12,146,29,0,175,8.3333
SAN DIEGO,Oct 2013,CACF,2014,HAGAR & SHRYOCK,CHILD_BREAKFAST,23,29,8,19,56,400,110,263,773,33.6087
SAN DIEGO,Oct 2013,CACF,2014,HAGAR & SHRYOCK,CHILD_LUNCH,23,29,8,19,56,418,115,275,808,35.1304
SAN DIEGO,Oct 2013,CACF,2014,HAGAR & SHRYOCK,CHILD_SNACK_PM,23,29,8,19,56,471,130,309,910,39.5652
SAN DIEGO,Nov 2013,CACF,2014,HAGAR & SHRYOCK,CHILD_BREAKFAST,19,29,8,19,56,384,106,252,742,39.0526
SAN DIEGO,Nov 2013,CACF,2014,HAGAR & SHRYOCK,CHILD_LUNCH,19,29,8,19,56,383,106,251,740,38.9474
SAN DIEGO,Nov 2013,CACF,2014,HAGAR & SHRYOCK,CHILD_SNACK_PM,19,29,8,19,56,411,113,270,794,41.7895
SAN DIEGO,Dec 2013,CACF,2014,HAGAR & SHRYOCK,CHILD_BREAKFAST,21,29,5,22,56,355,61,270,686,32.6667
SAN DIEGO,Dec 2013,CACF,2014,HAGAR & SHRYOCK,CHILD_LUNCH,21,29,5,22,56,369,64,280,713,33.9524
SAN DIEGO,Dec 2013,CACF,2014,HAGAR & SHRYOCK,CHILD_SNACK_PM,21,29,5,22,56,396,68,300,764,36.381
SAN DIEGO,Jan 2014,CACF,2014,HAGAR & SHRYOCK,CHILD_BREAKFAST,22,29,5,22,56,305,53,231,589,26.7727
SAN DIEGO,Jan 2014,CACF,2014,HAGAR & SHRYOCK,CHILD_LUNCH,22,29,5,22,56,342,59,259,660,30
SAN DIEGO,Jan 2014,CACF,2014,HAGAR & SHRYOCK,CHILD_SNACK_PM,22,29,5,22,56,393,68,297,758,34.4545
SAN DIEGO,Feb 2014,CACF,2014,HAGAR & SHRYOCK,CHILD_BREAKFAST,19,29,5,22,56,330,57,251,638,33.5789
SAN DIEGO,Feb 2014,CACF,2014,HAGAR & SHRYOCK,CHILD_LUNCH,19,29,5,22,56,369,64,279,712,37.4737
SAN DIEGO,Feb 2014,CACF,2014,HAGAR & SHRYOCK,CHILD_SNACK_PM,19,29,5,22,56,402,69,305,776,40.8421
SAN DIEGO,Mar 2014,CACF,2014,HAGAR & SHRYOCK,CHILD_BREAKFAST,21,29,5,22,56,401,69,304,774,36.8571
SAN DIEGO,Mar 2014,CACF,2014,HAGAR & SHRYOCK,CHILD_LUNCH,21,29,5,22,56,433,75,329,837,39.8571
SAN DIEGO,Mar 2014,CACF,2014,HAGAR & SHRYOCK,CHILD_SNACK_PM,21,29,5,22,56,463,80,351,894,42.5714
SAN DIEGO,Apr 2014,CACF,2014,HAGAR & SHRYOCK,CHILD_BREAKFAST,22,29,5,22,56,414,71,315,800,36.3636
SAN DIEGO,Apr 2014,CACF,2014,HAGAR & SHRYOCK,CHILD_LUNCH,22,29,5,22,56,468,81,354,903,41.0455
SAN DIEGO,Apr 2014,CACF,2014,HAGAR & SHRYOCK,CHILD_SNACK_PM,22,29,5,22,56,491,85,373,949,43.1364
SAN DIEGO,May 2014,CACF,2014,HAGAR & SHRYOCK,CHILD_BREAKFAST,21,29,5,22,56,375,65,285,725,34.5238
SAN DIEGO,May 2014,CACF,2014,HAGAR & SHRYOCK,CHILD_LUNCH,21,29,5,22,56,416,72,315,803,38.2381
SAN DIEGO,May 2014,CACF,2014,HAGAR & SHRYOCK,CHILD_SNACK_PM,21,29,5,22,56,443,76,336,855,40.7143
SAN DIEGO,Jun 2014,CACF,2014,HAGAR & SHRYOCK,CHILD_BREAKFAST,21,29,5,22,56,334,58,253,645,30.7143
SAN DIEGO,Jun 2014,CACF,2014,HAGAR & SHRYOCK,CHILD_LUNCH,21,29,5,22,56,397,68,302,767,36.5238
SAN DIEGO,Jun 2014,CACF,2014,HAGAR & SHRYOCK,CHILD_SNACK_PM,21,29,5,22,56,400,69,304,773,36.8095
SAN DIEGO,Jul 2014,CACF,2014,HAGAR & SHRYOCK,CHILD_BREAKFAST,23,29,5,22,56,379,65,288,732,31.8261
SAN DIEGO,Jul 2014,CACF,2014,HAGAR & SHRYOCK,CHILD_LUNCH,23,29,5,22,56,450,78,341,869,37.7826
SAN DIEGO,Jul 2014,CACF,2014,HAGAR & SHRYOCK,CHILD_SNACK_PM,23,29,5,22,56,441,76,335,852,37.0435
SAN DIEGO,Aug 2014,CACF,2014,HAGAR & SHRYOCK,CHILD_BREAKFAST,21,29,5,22,56,352,61,266,679,32.3333
SAN DIEGO,Aug 2014,CACF,2014,HAGAR & SHRYOCK,CHILD_LUNCH,21,29,5,22,56,360,62,274,696,33.1429
SAN DIEGO,Aug 2014,CACF,2014,HAGAR & SHRYOCK,CHILD_SNACK_PM,21,29,5,22,56,408,70,310,788,37.5238
SAN DIEGO,Sep 2014,CACF,2014,HAGAR & SHRYOCK,CHILD_BREAKFAST,21,29,5,22,56,328,57,249,634,30.1905
SAN DIEGO,Sep 2014,CACF,2014,HAGAR & SHRYOCK,CHILD_LUNCH,21,29,5,22,56,304,52,231,587,27.9524
SAN DIEGO,Sep 2014,CACF,2014,HAGAR & SHRYOCK,CHILD_SNACK_PM,21,29,5,22,56,369,64,279,712,33.9048
SAN DIEGO,Oct 2013,CACF,2014,"Harriet Tubman Village Charter School, Inc.",ATRISK_CHILD_SUPPER,18,150,0,0,150,2258,0,0,2258,125.4444
SAN DIEGO,Nov 2013,CACF,2014,"Harriet Tubman Village Charter School, Inc.",ATRISK_CHILD_SUPPER,14,294,0,0,294,1823,0,0,1823,130.2143
SAN DIEGO,Dec 2013,CACF,2014,"Harriet Tubman Village Charter School, Inc.",ATRISK_CHILD_SUPPER,15,140,0,0,140,1961,0,0,1961,130.7333
SAN DIEGO,Jan 2014,CACF,2014,"Harriet Tubman Village Charter School, Inc.",ATRISK_CHILD_SUPPER,18,140,0,0,140,864,0,0,864,48
SAN DIEGO,Feb 2014,CACF,2014,"Harriet Tubman Village Charter School, Inc.",ATRISK_CHILD_SUPPER,18,140,0,0,140,990,0,0,990,55
SAN DIEGO,Mar 2014,CACF,2014,"Harriet Tubman Village Charter School, Inc.",ATRISK_CHILD_SUPPER,21,147,0,0,147,1250,0,0,1250,59.5238
SAN DIEGO,Apr 2014,CACF,2014,"Harriet Tubman Village Charter School, Inc.",ATRISK_CHILD_SUPPER,11,140,0,0,140,753,0,0,753,68.4545
SAN DIEGO,Dec 2013,CACF,2014,HEALTHY SOLUTIONS FOR PARENTS,CHILD_BREAKFAST,22,20,0,0,20,218,0,0,218,9.9091
SAN DIEGO,Dec 2013,CACF,2014,HEALTHY SOLUTIONS FOR PARENTS,CHILD_LUNCH,22,20,0,0,20,241,0,0,241,10.9545
SAN DIEGO,Dec 2013,CACF,2014,HEALTHY SOLUTIONS FOR PARENTS,CHILD_SNACK_PM,22,20,0,0,20,222,0,0,222,10.0909
SAN DIEGO,Jan 2014,CACF,2014,HEALTHY SOLUTIONS FOR PARENTS,CHILD_BREAKFAST,23,18,2,0,20,192,21,0,213,9.2609
SAN DIEGO,Jan 2014,CACF,2014,HEALTHY SOLUTIONS FOR PARENTS,CHILD_LUNCH,23,18,2,0,20,163,18,0,181,7.8696
SAN DIEGO,Jan 2014,CACF,2014,HEALTHY SOLUTIONS FOR PARENTS,CHILD_SNACK_PM,23,18,2,0,20,191,21,0,212,9.2174
SAN DIEGO,Feb 2014,CACF,2014,HEALTHY SOLUTIONS FOR PARENTS,CHILD_BREAKFAST,20,18,2,0,20,239,27,0,266,13.3
SAN DIEGO,Feb 2014,CACF,2014,HEALTHY SOLUTIONS FOR PARENTS,CHILD_LUNCH,20,18,2,0,20,197,22,0,219,10.95
SAN DIEGO,Feb 2014,CACF,2014,HEALTHY SOLUTIONS FOR PARENTS,CHILD_SNACK_PM,20,18,2,0,20,106,12,0,118,5.9
SAN DIEGO,Mar 2014,CACF,2014,HEALTHY SOLUTIONS FOR PARENTS,CHILD_BREAKFAST,21,26,2,0,28,201,15,0,216,10.2857
SAN DIEGO,Mar 2014,CACF,2014,HEALTHY SOLUTIONS FOR PARENTS,CHILD_LUNCH,21,26,2,0,28,267,21,0,288,13.7143
SAN DIEGO,Mar 2014,CACF,2014,HEALTHY SOLUTIONS FOR PARENTS,CHILD_SNACK_PM,21,26,2,0,28,158,12,0,170,8.0952
SAN DIEGO,Apr 2014,CACF,2014,HEALTHY SOLUTIONS FOR PARENTS,CHILD_BREAKFAST,22,22,1,0,23,239,11,0,250,11.3636
SAN DIEGO,Apr 2014,CACF,2014,HEALTHY SOLUTIONS FOR PARENTS,CHILD_LUNCH,22,22,1,0,23,287,13,0,300,13.6364
SAN DIEGO,Apr 2014,CACF,2014,HEALTHY SOLUTIONS FOR PARENTS,CHILD_SNACK_PM,22,22,1,0,23,204,9,0,213,9.6818
SAN DIEGO,May 2014,CACF,2014,HEALTHY SOLUTIONS FOR PARENTS,CHILD_BREAKFAST,19,22,1,0,23,187,8,0,195,10.2632
SAN DIEGO,May 2014,CACF,2014,HEALTHY SOLUTIONS FOR PARENTS,CHILD_LUNCH,19,22,1,0,23,317,14,0,331,17.4211
SAN DIEGO,May 2014,CACF,2014,HEALTHY SOLUTIONS FOR PARENTS,CHILD_SNACK_PM,19,22,1,0,23,218,10,0,228,12
SAN DIEGO,Jun 2014,CACF,2014,HEALTHY SOLUTIONS FOR PARENTS,CHILD_BREAKFAST,19,23,1,0,24,187,8,0,195,10.2632
SAN DIEGO,Jun 2014,CACF,2014,HEALTHY SOLUTIONS FOR PARENTS,CHILD_LUNCH,19,23,1,0,24,308,13,0,321,16.8947
SAN DIEGO,Jun 2014,CACF,2014,HEALTHY SOLUTIONS FOR PARENTS,CHILD_SNACK_PM,19,23,1,0,24,218,10,0,228,12
SAN DIEGO,Jul 2014,CACF,2014,HEALTHY SOLUTIONS FOR PARENTS,CHILD_BREAKFAST,23,23,1,0,24,138,6,0,144,6.2609
SAN DIEGO,Jul 2014,CACF,2014,HEALTHY SOLUTIONS FOR PARENTS,CHILD_LUNCH,23,23,1,0,24,138,6,0,144,6.2609
SAN DIEGO,Jul 2014,CACF,2014,HEALTHY SOLUTIONS FOR PARENTS,CHILD_SNACK_PM,23,23,1,0,24,138,6,0,144,6.2609
SAN DIEGO,Aug 2014,CACF,2014,HEALTHY SOLUTIONS FOR PARENTS,CHILD_BREAKFAST,21,23,1,0,24,141,6,0,147,7
SAN DIEGO,Aug 2014,CACF,2014,HEALTHY SOLUTIONS FOR PARENTS,CHILD_LUNCH,21,23,1,0,24,141,6,0,147,7
SAN DIEGO,Aug 2014,CACF,2014,HEALTHY SOLUTIONS FOR PARENTS,CHILD_SNACK_PM,21,23,1,0,24,141,6,0,147,7
SAN DIEGO,Sep 2014,CACF,2014,HEALTHY SOLUTIONS FOR PARENTS,CHILD_BREAKFAST,22,23,1,0,24,106,5,0,111,5.0455
SAN DIEGO,Sep 2014,CACF,2014,HEALTHY SOLUTIONS FOR PARENTS,CHILD_LUNCH,22,23,1,0,24,106,5,0,111,5.0455
SAN DIEGO,Sep 2014,CACF,2014,HEALTHY SOLUTIONS FOR PARENTS,CHILD_SNACK_PM,22,23,1,0,24,106,5,0,111,5.0455
SAN DIEGO,Aug 2014,CACF,2014,HEAVEN'S WINDOWS,ATRISK_CHILD_LUNCH,13,130,0,0,130,215,0,0,215,16.5385
SAN DIEGO,Aug 2014,CACF,2014,HEAVEN'S WINDOWS,ATRISK_CHILD_SNACK,13,130,0,0,130,1040,0,0,1040,80
SAN DIEGO,Aug 2014,CACF,2014,HEAVEN'S WINDOWS,ATRISK_CHILD_SNACK_NT,13,130,0,0,130,211,0,0,211,16.2308
SAN DIEGO,Aug 2014,CACF,2014,HEAVEN'S WINDOWS,ATRISK_CHILD_SUPPER,13,130,0,0,130,1300,0,0,1300,100
SAN DIEGO,Sep 2014,CACF,2014,HEAVEN'S WINDOWS,ATRISK_CHILD_LUNCH,22,150,0,0,150,325,0,0,325,14.7727
SAN DIEGO,Sep 2014,CACF,2014,HEAVEN'S WINDOWS,ATRISK_CHILD_SNACK,22,150,0,0,150,1342,0,0,1342,61
SAN DIEGO,Sep 2014,CACF,2014,HEAVEN'S WINDOWS,ATRISK_CHILD_SNACK_NT,22,150,0,0,150,337,0,0,337,15.3182
SAN DIEGO,Sep 2014,CACF,2014,HEAVEN'S WINDOWS,ATRISK_CHILD_SUPPER,22,150,0,0,150,1855,0,0,1855,84.3182
SAN DIEGO,Oct 2013,CACF,2014,HIGHER LEARNING ACADEMY INC,CHILD_LUNCH,22,39,0,7,46,447,0,80,527,23.9545
SAN DIEGO,Oct 2013,CACF,2014,HIGHER LEARNING ACADEMY INC,CHILD_SNACK_AM,22,39,0,7,46,433,0,78,511,23.2273
SAN DIEGO,Oct 2013,CACF,2014,HIGHER LEARNING ACADEMY INC,CHILD_SUPPER,22,39,0,7,46,447,0,80,527,23.9545
SAN DIEGO,Nov 2013,CACF,2014,HIGHER LEARNING ACADEMY INC,CHILD_LUNCH,17,39,0,7,46,404,0,72,476,28
SAN DIEGO,Nov 2013,CACF,2014,HIGHER LEARNING ACADEMY INC,CHILD_SNACK_AM,17,39,0,7,46,399,0,72,471,27.7059
SAN DIEGO,Nov 2013,CACF,2014,HIGHER LEARNING ACADEMY INC,CHILD_SUPPER,17,39,0,7,46,422,0,76,498,29.2941
SAN DIEGO,Dec 2013,CACF,2014,HIGHER LEARNING ACADEMY INC,CHILD_LUNCH,19,39,0,7,46,430,0,77,507,26.6842
SAN DIEGO,Dec 2013,CACF,2014,HIGHER LEARNING ACADEMY INC,CHILD_SNACK_AM,19,39,0,7,46,461,0,83,544,28.6316
SAN DIEGO,Dec 2013,CACF,2014,HIGHER LEARNING ACADEMY INC,CHILD_SUPPER,19,39,0,7,46,477,0,86,563,29.6316
SAN DIEGO,Jan 2014,CACF,2014,HIGHER LEARNING ACADEMY INC,CHILD_LUNCH,22,39,0,7,46,518,0,93,611,27.7727
SAN DIEGO,Jan 2014,CACF,2014,HIGHER LEARNING ACADEMY INC,CHILD_SNACK_AM,22,39,0,7,46,588,0,105,693,31.5
SAN DIEGO,Jan 2014,CACF,2014,HIGHER LEARNING ACADEMY INC,CHILD_SUPPER,22,39,0,7,46,618,0,111,729,33.1364
SAN DIEGO,Feb 2014,CACF,2014,HIGHER LEARNING ACADEMY INC,CHILD_LUNCH,19,39,0,7,46,502,0,90,592,31.1579
SAN DIEGO,Feb 2014,CACF,2014,HIGHER LEARNING ACADEMY INC,CHILD_SNACK_AM,19,39,0,7,46,589,0,106,695,36.5789
SAN DIEGO,Feb 2014,CACF,2014,HIGHER LEARNING ACADEMY INC,CHILD_SUPPER,19,39,0,7,46,596,0,107,703,37
SAN DIEGO,Mar 2014,CACF,2014,HIGHER LEARNING ACADEMY INC,CHILD_LUNCH,21,39,0,7,46,536,0,96,632,30.0952
SAN DIEGO,Mar 2014,CACF,2014,HIGHER LEARNING ACADEMY INC,CHILD_SNACK_AM,21,39,0,7,46,597,0,107,704,33.5238
SAN DIEGO,Mar 2014,CACF,2014,HIGHER LEARNING ACADEMY INC,CHILD_SUPPER,21,39,0,7,46,675,0,121,796,37.9048
SAN DIEGO,Apr 2014,CACF,2014,HIGHER LEARNING ACADEMY INC,CHILD_LUNCH,22,54,4,10,68,637,47,118,802,36.4545
SAN DIEGO,Apr 2014,CACF,2014,HIGHER LEARNING ACADEMY INC,CHILD_SNACK_AM,22,54,4,10,68,677,50,125,852,38.7273
SAN DIEGO,Apr 2014,CACF,2014,HIGHER LEARNING ACADEMY INC,CHILD_SUPPER,22,54,4,10,68,694,51,129,874,39.7273
SAN DIEGO,May 2014,CACF,2014,HIGHER LEARNING ACADEMY INC,CHILD_LUNCH,21,54,4,10,68,688,51,127,866,41.2381
SAN DIEGO,May 2014,CACF,2014,HIGHER LEARNING ACADEMY INC,CHILD_SNACK_AM,21,54,4,10,68,779,58,144,981,46.7143
SAN DIEGO,May 2014,CACF,2014,HIGHER LEARNING ACADEMY INC,CHILD_SUPPER,21,54,4,10,68,745,55,138,938,44.6667
SAN DIEGO,Jun 2014,CACF,2014,HIGHER LEARNING ACADEMY INC,CHILD_LUNCH,21,54,4,10,68,679,50,126,855,40.7143
SAN DIEGO,Jun 2014,CACF,2014,HIGHER LEARNING ACADEMY INC,CHILD_SNACK_AM,21,54,4,10,68,725,54,134,913,43.4762
SAN DIEGO,Jun 2014,CACF,2014,HIGHER LEARNING ACADEMY INC,CHILD_SUPPER,21,54,4,10,68,688,51,128,867,41.2857
SAN DIEGO,Jul 2014,CACF,2014,HIGHER LEARNING ACADEMY INC,CHILD_LUNCH,22,63,5,11,79,783,62,137,982,44.6364
SAN DIEGO,Jul 2014,CACF,2014,HIGHER LEARNING ACADEMY INC,CHILD_SNACK_AM,22,63,5,11,79,826,66,144,1036,47.0909
SAN DIEGO,Jul 2014,CACF,2014,HIGHER LEARNING ACADEMY INC,CHILD_SUPPER,22,63,5,11,79,776,62,135,973,44.2273
SAN DIEGO,Aug 2014,CACF,2014,HIGHER LEARNING ACADEMY INC,CHILD_LUNCH,21,63,5,11,79,667,53,116,836,39.8095
SAN DIEGO,Aug 2014,CACF,2014,HIGHER LEARNING ACADEMY INC,CHILD_SNACK_AM,21,63,5,11,79,683,54,119,856,40.7619
SAN DIEGO,Aug 2014,CACF,2014,HIGHER LEARNING ACADEMY INC,CHILD_SUPPER,21,63,5,11,79,684,54,120,858,40.8571
SAN DIEGO,Sep 2014,CACF,2014,HIGHER LEARNING ACADEMY INC,CHILD_LUNCH,21,63,5,11,79,615,49,107,771,36.7143
SAN DIEGO,Sep 2014,CACF,2014,HIGHER LEARNING ACADEMY INC,CHILD_SNACK_AM,21,63,5,11,79,704,56,123,883,42.0476
SAN DIEGO,Sep 2014,CACF,2014,HIGHER LEARNING ACADEMY INC,CHILD_SUPPER,21,63,5,11,79,710,56,124,890,42.381
SAN DIEGO,Oct 2013,CACF,2014,HORIZONS ADHC CENTER INC,ADULT_BREAKFAST,23,236,0,2,238,2654,0,22,2676,116.3478
SAN DIEGO,Oct 2013,CACF,2014,HORIZONS ADHC CENTER INC,ADULT_LUNCH,23,236,0,2,238,2743,0,23,2766,120.2609
SAN DIEGO,Oct 2013,CACF,2014,HORIZONS ADHC CENTER INC,ADULT_SNACK_AM,23,236,0,2,238,89,0,1,90,3.913
SAN DIEGO,Oct 2013,CACF,2014,HORIZONS ADHC CENTER INC,ADULT_SNACK_PM,23,236,0,2,238,767,0,6,773,33.6087
SAN DIEGO,Nov 2013,CACF,2014,HORIZONS ADHC CENTER INC,ADULT_BREAKFAST,20,236,0,2,238,2371,0,20,2391,119.55
SAN DIEGO,Nov 2013,CACF,2014,HORIZONS ADHC CENTER INC,ADULT_LUNCH,20,236,0,2,238,2461,0,21,2482,124.1
SAN DIEGO,Nov 2013,CACF,2014,HORIZONS ADHC CENTER INC,ADULT_SNACK_AM,20,236,0,2,238,90,0,1,91,4.55
SAN DIEGO,Nov 2013,CACF,2014,HORIZONS ADHC CENTER INC,ADULT_SNACK_PM,20,236,0,2,238,689,0,6,695,34.75
SAN DIEGO,Dec 2013,CACF,2014,HORIZONS ADHC CENTER INC,ADULT_BREAKFAST,21,236,0,2,238,2411,0,20,2431,115.7619
SAN DIEGO,Dec 2013,CACF,2014,HORIZONS ADHC CENTER INC,ADULT_LUNCH,21,236,0,2,238,2524,0,21,2545,121.1905
SAN DIEGO,Dec 2013,CACF,2014,HORIZONS ADHC CENTER INC,ADULT_SNACK_AM,21,236,0,2,238,113,0,1,114,5.4286
SAN DIEGO,Dec 2013,CACF,2014,HORIZONS ADHC CENTER INC,ADULT_SNACK_PM,21,236,0,2,238,740,0,6,746,35.5238
SAN DIEGO,Jan 2014,CACF,2014,HORIZONS ADHC CENTER INC,ADULT_BREAKFAST,22,236,0,2,238,2558,0,22,2580,117.2727
SAN DIEGO,Jan 2014,CACF,2014,HORIZONS ADHC CENTER INC,ADULT_LUNCH,22,236,0,2,238,2786,0,24,2810,127.7273
SAN DIEGO,Jan 2014,CACF,2014,HORIZONS ADHC CENTER INC,ADULT_SNACK_AM,22,236,0,2,238,228,0,2,230,10.4545
SAN DIEGO,Jan 2014,CACF,2014,HORIZONS ADHC CENTER INC,ADULT_SNACK_PM,22,236,0,2,238,952,0,8,960,43.6364
SAN DIEGO,Feb 2014,CACF,2014,HORIZONS ADHC CENTER INC,ADULT_BREAKFAST,20,236,0,2,238,2215,0,19,2234,111.7
SAN DIEGO,Feb 2014,CACF,2014,HORIZONS ADHC CENTER INC,ADULT_LUNCH,20,236,0,2,238,2435,0,21,2456,122.8
SAN DIEGO,Feb 2014,CACF,2014,HORIZONS ADHC CENTER INC,ADULT_SNACK_AM,20,236,0,2,238,221,0,2,223,11.15
SAN DIEGO,Feb 2014,CACF,2014,HORIZONS ADHC CENTER INC,ADULT_SNACK_PM,20,236,0,2,238,826,0,7,833,41.65
SAN DIEGO,Mar 2014,CACF,2014,HORIZONS ADHC CENTER INC,ADULT_BREAKFAST,21,236,0,2,238,2384,0,20,2404,114.4762
SAN DIEGO,Mar 2014,CACF,2014,HORIZONS ADHC CENTER INC,ADULT_LUNCH,21,236,0,2,238,2612,0,22,2634,125.4286
SAN DIEGO,Mar 2014,CACF,2014,HORIZONS ADHC CENTER INC,ADULT_SNACK_AM,21,236,0,2,238,227,0,2,229,10.9048
SAN DIEGO,Mar 2014,CACF,2014,HORIZONS ADHC CENTER INC,ADULT_SNACK_PM,21,236,0,2,238,924,0,8,932,44.381
SAN DIEGO,Apr 2014,CACF,2014,HORIZONS ADHC CENTER INC,ADULT_BREAKFAST,22,236,0,2,238,2401,0,20,2421,110.0455
SAN DIEGO,Apr 2014,CACF,2014,HORIZONS ADHC CENTER INC,ADULT_LUNCH,22,236,0,2,238,2734,0,23,2757,125.3182
SAN DIEGO,Apr 2014,CACF,2014,HORIZONS ADHC CENTER INC,ADULT_SNACK_AM,22,236,0,2,238,333,0,3,336,15.2727
SAN DIEGO,Apr 2014,CACF,2014,HORIZONS ADHC CENTER INC,ADULT_SNACK_PM,22,236,0,2,238,1006,0,9,1015,46.1364
SAN DIEGO,May 2014,CACF,2014,HORIZONS ADHC CENTER INC,ADULT_BREAKFAST,22,236,0,2,238,2561,0,22,2583,117.4091
SAN DIEGO,May 2014,CACF,2014,HORIZONS ADHC CENTER INC,ADULT_LUNCH,22,236,0,2,238,2926,0,25,2951,134.1364
SAN DIEGO,May 2014,CACF,2014,HORIZONS ADHC CENTER INC,ADULT_SNACK_AM,22,236,0,2,238,365,0,3,368,16.7273
SAN DIEGO,May 2014,CACF,2014,HORIZONS ADHC CENTER INC,ADULT_SNACK_PM,22,236,0,2,238,1094,0,9,1103,50.1364
SAN DIEGO,Jun 2014,CACF,2014,HORIZONS ADHC CENTER INC,ADULT_BREAKFAST,21,236,0,2,238,2599,0,22,2621,124.8095
SAN DIEGO,Jun 2014,CACF,2014,HORIZONS ADHC CENTER INC,ADULT_LUNCH,21,236,0,2,238,2890,0,24,2914,138.7619
SAN DIEGO,Jun 2014,CACF,2014,HORIZONS ADHC CENTER INC,ADULT_SNACK_AM,21,236,0,2,238,291,0,2,293,13.9524
SAN DIEGO,Jun 2014,CACF,2014,HORIZONS ADHC CENTER INC,ADULT_SNACK_PM,21,236,0,2,238,1135,0,10,1145,54.5238
SAN DIEGO,Jul 2014,CACF,2014,HORIZONS ADHC CENTER INC,ADULT_BREAKFAST,23,236,0,2,238,2844,0,24,2868,124.6957
SAN DIEGO,Jul 2014,CACF,2014,HORIZONS ADHC CENTER INC,ADULT_LUNCH,23,236,0,2,238,3014,0,26,3040,132.1739
SAN DIEGO,Jul 2014,CACF,2014,HORIZONS ADHC CENTER INC,ADULT_SNACK_AM,23,236,0,2,238,316,0,3,319,13.8696
SAN DIEGO,Jul 2014,CACF,2014,HORIZONS ADHC CENTER INC,ADULT_SNACK_PM,23,236,0,2,238,1233,0,10,1243,54.0435
SAN DIEGO,Aug 2014,CACF,2014,HORIZONS ADHC CENTER INC,ADULT_BREAKFAST,21,236,0,2,238,2636,0,22,2658,126.5714
SAN DIEGO,Aug 2014,CACF,2014,HORIZONS ADHC CENTER INC,ADULT_LUNCH,21,236,0,2,238,2845,0,24,2869,136.619
SAN DIEGO,Aug 2014,CACF,2014,HORIZONS ADHC CENTER INC,ADULT_SNACK_AM,21,236,0,2,238,328,0,3,331,15.7619
SAN DIEGO,Aug 2014,CACF,2014,HORIZONS ADHC CENTER INC,ADULT_SNACK_PM,21,236,0,2,238,1133,0,10,1143,54.4286
SAN DIEGO,Sep 2014,CACF,2014,HORIZONS ADHC CENTER INC,ADULT_BREAKFAST,22,236,0,2,238,2747,0,23,2770,125.9091
SAN DIEGO,Sep 2014,CACF,2014,HORIZONS ADHC CENTER INC,ADULT_LUNCH,22,236,0,2,238,3162,0,27,3189,144.9545
SAN DIEGO,Sep 2014,CACF,2014,HORIZONS ADHC CENTER INC,ADULT_SNACK_AM,22,236,0,2,238,415,0,4,419,19.0455
SAN DIEGO,Sep 2014,CACF,2014,HORIZONS ADHC CENTER INC,ADULT_SNACK_PM,22,236,0,2,238,1298,0,11,1309,59.5
SAN DIEGO,Oct 2013,CACF,2014,J GELT CORPORATION CASA PACIFICA ADHC,ADULT_BREAKFAST,23,187,0,3,190,1024,0,16,1040,45.2174
SAN DIEGO,Oct 2013,CACF,2014,J GELT CORPORATION CASA PACIFICA ADHC,ADULT_LUNCH,23,187,0,3,190,2939,0,47,2986,129.8261
SAN DIEGO,Oct 2013,CACF,2014,J GELT CORPORATION CASA PACIFICA ADHC,ADULT_SNACK_AM,23,187,0,3,190,372,0,6,378,16.4348
SAN DIEGO,Oct 2013,CACF,2014,J GELT CORPORATION CASA PACIFICA ADHC,ADULT_SNACK_PM,23,187,0,3,190,1378,0,22,1400,60.8696
SAN DIEGO,Nov 2013,CACF,2014,J GELT CORPORATION CASA PACIFICA ADHC,ADULT_BREAKFAST,20,187,0,3,190,902,0,14,916,45.8
SAN DIEGO,Nov 2013,CACF,2014,J GELT CORPORATION CASA PACIFICA ADHC,ADULT_LUNCH,20,187,0,3,190,2447,0,39,2486,124.3
SAN DIEGO,Nov 2013,CACF,2014,J GELT CORPORATION CASA PACIFICA ADHC,ADULT_SNACK_AM,20,187,0,3,190,252,0,4,256,12.8
SAN DIEGO,Nov 2013,CACF,2014,J GELT CORPORATION CASA PACIFICA ADHC,ADULT_SNACK_PM,20,187,0,3,190,1117,0,18,1135,56.75
SAN DIEGO,Dec 2013,CACF,2014,J GELT CORPORATION CASA PACIFICA ADHC,ADULT_BREAKFAST,21,187,0,3,190,922,0,15,937,44.619
SAN DIEGO,Dec 2013,CACF,2014,J GELT CORPORATION CASA PACIFICA ADHC,ADULT_LUNCH,21,187,0,3,190,2543,0,41,2584,123.0476
SAN DIEGO,Dec 2013,CACF,2014,J GELT CORPORATION CASA PACIFICA ADHC,ADULT_SNACK_AM,21,187,0,3,190,274,0,4,278,13.2381
SAN DIEGO,Dec 2013,CACF,2014,J GELT CORPORATION CASA PACIFICA ADHC,ADULT_SNACK_PM,21,187,0,3,190,1041,0,17,1058,50.381
SAN DIEGO,Jan 2014,CACF,2014,J GELT CORPORATION CASA PACIFICA ADHC,ADULT_BREAKFAST,22,187,0,3,190,1005,0,16,1021,46.4091
SAN DIEGO,Jan 2014,CACF,2014,J GELT CORPORATION CASA PACIFICA ADHC,ADULT_LUNCH,22,187,0,3,190,2710,0,43,2753,125.1364
SAN DIEGO,Jan 2014,CACF,2014,J GELT CORPORATION CASA PACIFICA ADHC,ADULT_SNACK_AM,22,187,0,3,190,267,0,4,271,12.3182
SAN DIEGO,Jan 2014,CACF,2014,J GELT CORPORATION CASA PACIFICA ADHC,ADULT_SNACK_PM,22,187,0,3,190,1166,0,19,1185,53.8636
SAN DIEGO,Feb 2014,CACF,2014,J GELT CORPORATION CASA PACIFICA ADHC,ADULT_BREAKFAST,20,187,0,3,190,999,0,16,1015,50.75
SAN DIEGO,Feb 2014,CACF,2014,J GELT CORPORATION CASA PACIFICA ADHC,ADULT_LUNCH,20,187,0,3,190,2411,0,39,2450,122.5
SAN DIEGO,Feb 2014,CACF,2014,J GELT CORPORATION CASA PACIFICA ADHC,ADULT_SNACK_AM,20,187,0,3,190,255,0,4,259,12.95
SAN DIEGO,Feb 2014,CACF,2014,J GELT CORPORATION CASA PACIFICA ADHC,ADULT_SNACK_PM,20,187,0,3,190,1031,0,17,1048,52.4
SAN DIEGO,Mar 2014,CACF,2014,J GELT CORPORATION CASA PACIFICA ADHC,ADULT_BREAKFAST,21,187,0,3,190,1058,0,17,1075,51.1905
SAN DIEGO,Mar 2014,CACF,2014,J GELT CORPORATION CASA PACIFICA ADHC,ADULT_LUNCH,21,187,0,3,190,2514,0,40,2554,121.619
SAN DIEGO,Mar 2014,CACF,2014,J GELT CORPORATION CASA PACIFICA ADHC,ADULT_SNACK_AM,21,187,0,3,190,345,0,6,351,16.7143
SAN DIEGO,Mar 2014,CACF,2014,J GELT CORPORATION CASA PACIFICA ADHC,ADULT_SNACK_PM,21,187,0,3,190,1068,0,17,1085,51.6667
SAN DIEGO,Apr 2014,CACF,2014,J GELT CORPORATION CASA PACIFICA ADHC,ADULT_BREAKFAST,22,187,0,3,190,1159,0,19,1178,53.5455
SAN DIEGO,Apr 2014,CACF,2014,J GELT CORPORATION CASA PACIFICA ADHC,ADULT_LUNCH,22,187,0,3,190,2689,0,43,2732,124.1818
SAN DIEGO,Apr 2014,CACF,2014,J GELT CORPORATION CASA PACIFICA ADHC,ADULT_SNACK_AM,22,187,0,3,190,366,0,6,372,16.9091
SAN DIEGO,Apr 2014,CACF,2014,J GELT CORPORATION CASA PACIFICA ADHC,ADULT_SNACK_PM,22,187,0,3,190,1182,0,19,1201,54.5909
SAN DIEGO,May 2014,CACF,2014,J GELT CORPORATION CASA PACIFICA ADHC,ADULT_BREAKFAST,21,187,0,3,190,1114,0,18,1132,53.9048
SAN DIEGO,May 2014,CACF,2014,J GELT CORPORATION CASA PACIFICA ADHC,ADULT_LUNCH,21,187,0,3,190,2595,0,42,2637,125.5714
SAN DIEGO,May 2014,CACF,2014,J GELT CORPORATION CASA PACIFICA ADHC,ADULT_SNACK_AM,21,187,0,3,190,336,0,5,341,16.2381
SAN DIEGO,May 2014,CACF,2014,J GELT CORPORATION CASA PACIFICA ADHC,ADULT_SNACK_PM,21,187,0,3,190,1176,0,19,1195,56.9048
SAN DIEGO,Jun 2014,CACF,2014,J GELT CORPORATION CASA PACIFICA ADHC,ADULT_BREAKFAST,21,187,0,3,190,1017,0,16,1033,49.1905
SAN DIEGO,Jun 2014,CACF,2014,J GELT CORPORATION CASA PACIFICA ADHC,ADULT_LUNCH,21,187,0,3,190,2572,0,41,2613,124.4286
SAN DIEGO,Jun 2014,CACF,2014,J GELT CORPORATION CASA PACIFICA ADHC,ADULT_SNACK_AM,21,187,0,3,190,405,0,7,412,19.619
SAN DIEGO,Jun 2014,CACF,2014,J GELT CORPORATION CASA PACIFICA ADHC,ADULT_SNACK_PM,21,187,0,3,190,1160,0,19,1179,56.1429
SAN DIEGO,Jul 2014,CACF,2014,J GELT CORPORATION CASA PACIFICA ADHC,ADULT_BREAKFAST,22,187,0,3,190,854,0,14,868,39.4545
SAN DIEGO,Jul 2014,CACF,2014,J GELT CORPORATION CASA PACIFICA ADHC,ADULT_LUNCH,22,187,0,3,190,2709,0,43,2752,125.0909
SAN DIEGO,Jul 2014,CACF,2014,J GELT CORPORATION CASA PACIFICA ADHC,ADULT_SNACK_AM,22,187,0,3,190,748,0,12,760,34.5455
SAN DIEGO,Jul 2014,CACF,2014,J GELT CORPORATION CASA PACIFICA ADHC,ADULT_SNACK_PM,22,187,0,3,190,1155,0,19,1174,53.3636
SAN DIEGO,Aug 2014,CACF,2014,J GELT CORPORATION CASA PACIFICA ADHC,ADULT_BREAKFAST,21,187,0,3,190,753,0,12,765,36.4286
SAN DIEGO,Aug 2014,CACF,2014,J GELT CORPORATION CASA PACIFICA ADHC,ADULT_LUNCH,21,187,0,3,190,2627,0,42,2669,127.0952
SAN DIEGO,Aug 2014,CACF,2014,J GELT CORPORATION CASA PACIFICA ADHC,ADULT_SNACK_AM,21,187,0,3,190,735,0,12,747,35.5714
SAN DIEGO,Aug 2014,CACF,2014,J GELT CORPORATION CASA PACIFICA ADHC,ADULT_SNACK_PM,21,187,0,3,190,1111,0,18,1129,53.7619
SAN DIEGO,Sep 2014,CACF,2014,J GELT CORPORATION CASA PACIFICA ADHC,ADULT_BREAKFAST,21,187,0,3,190,687,0,11,698,33.2381
SAN DIEGO,Sep 2014,CACF,2014,J GELT CORPORATION CASA PACIFICA ADHC,ADULT_LUNCH,21,187,0,3,190,2595,0,42,2637,125.5714
SAN DIEGO,Sep 2014,CACF,2014,J GELT CORPORATION CASA PACIFICA ADHC,ADULT_SNACK_AM,21,187,0,3,190,830,0,13,843,40.1429
SAN DIEGO,Sep 2014,CACF,2014,J GELT CORPORATION CASA PACIFICA ADHC,ADULT_SNACK_PM,21,187,0,3,190,1116,0,18,1134,54
SAN DIEGO,Aug 2014,CACF,2014,Julian Union Elementary School District,ATRISK_CHILD_SNACK_NT,10,309,0,0,309,340,0,0,340,34
SAN DIEGO,Aug 2014,CACF,2014,Julian Union Elementary School District,ATRISK_CHILD_SUPPER,10,309,0,0,309,709,0,0,709,70.9
SAN DIEGO,Sep 2014,CACF,2014,Julian Union Elementary School District,ATRISK_CHILD_SNACK_NT,21,309,0,0,309,1106,0,0,1106,52.6667
SAN DIEGO,Sep 2014,CACF,2014,Julian Union Elementary School District,ATRISK_CHILD_SUPPER,21,309,0,0,309,2034,0,0,2034,96.8571
SAN DIEGO,Oct 2013,CACF,2014,LA JOLLA BAND OF LUISENO,ATRISK_CHILD_SUPPER,16,366,0,0,366,366,0,0,366,22.875
SAN DIEGO,Nov 2013,CACF,2014,LA JOLLA BAND OF LUISENO,ATRISK_CHILD_SUPPER,9,212,0,0,212,212,0,0,212,23.5556
SAN DIEGO,Dec 2013,CACF,2014,LA JOLLA BAND OF LUISENO,ATRISK_CHILD_SUPPER,8,118,0,0,118,118,0,0,118,14.75
SAN DIEGO,Jan 2014,CACF,2014,LA JOLLA BAND OF LUISENO,ATRISK_CHILD_SUPPER,14,60,0,0,60,293,0,0,293,20.9286
SAN DIEGO,Feb 2014,CACF,2014,LA JOLLA BAND OF LUISENO,ATRISK_CHILD_SUPPER,12,40,0,0,40,319,0,0,319,26.5833
SAN DIEGO,Mar 2014,CACF,2014,LA JOLLA BAND OF LUISENO,ATRISK_CHILD_SUPPER,17,60,0,0,60,391,0,0,391,23
SAN DIEGO,Apr 2014,CACF,2014,LA JOLLA BAND OF LUISENO,ATRISK_CHILD_SUPPER,12,40,0,0,40,252,0,0,252,21
SAN DIEGO,May 2014,CACF,2014,LA JOLLA BAND OF LUISENO,ATRISK_CHILD_SUPPER,19,40,0,0,40,326,0,0,326,17.1579
SAN DIEGO,Jun 2014,CACF,2014,LA JOLLA BAND OF LUISENO,ATRISK_CHILD_SUPPER,4,40,0,0,40,72,0,0,72,18
SAN DIEGO,Sep 2014,CACF,2014,LA JOLLA BAND OF LUISENO,ATRISK_CHILD_SUPPER,14,40,0,0,40,322,0,0,322,23
SAN DIEGO,Oct 2013,CACF,2014,La Mesa-Spring Valley School District,ATRISK_CHILD_SNACK,19,1794,0,0,1794,12934,0,0,12934,680.7368
SAN DIEGO,Oct 2013,CACF,2014,La Mesa-Spring Valley School District,ATRISK_CHILD_SUPPER,19,1794,0,0,1794,10720,0,0,10720,564.2105
SAN DIEGO,Nov 2013,CACF,2014,La Mesa-Spring Valley School District,ATRISK_CHILD_SNACK,15,1793,0,0,1793,10305,0,0,10305,687
SAN DIEGO,Nov 2013,CACF,2014,La Mesa-Spring Valley School District,ATRISK_CHILD_SUPPER,15,1793,0,0,1793,12495,0,0,12495,833
SAN DIEGO,Dec 2013,CACF,2014,La Mesa-Spring Valley School District,ATRISK_CHILD_SNACK,15,1790,0,0,1790,10212,0,0,10212,680.8
SAN DIEGO,Dec 2013,CACF,2014,La Mesa-Spring Valley School District,ATRISK_CHILD_SUPPER,15,1790,0,0,1790,12427,0,0,12427,828.4667
SAN DIEGO,Jan 2014,CACF,2014,La Mesa-Spring Valley School District,ATRISK_CHILD_SNACK,19,1789,0,0,1789,12901,0,0,12901,679
SAN DIEGO,Jan 2014,CACF,2014,La Mesa-Spring Valley School District,ATRISK_CHILD_SUPPER,19,1789,0,0,1789,15729,0,0,15729,827.8421
SAN DIEGO,Feb 2014,CACF,2014,La Mesa-Spring Valley School District,ATRISK_CHILD_SNACK,18,1794,0,0,1794,11793,0,0,11793,655.1667
SAN DIEGO,Feb 2014,CACF,2014,La Mesa-Spring Valley School District,ATRISK_CHILD_SUPPER,18,1794,0,0,1794,15128,0,0,15128,840.4444
SAN DIEGO,Mar 2014,CACF,2014,La Mesa-Spring Valley School District,ATRISK_CHILD_SNACK,21,1790,0,0,1790,13005,0,0,13005,619.2857
SAN DIEGO,Mar 2014,CACF,2014,La Mesa-Spring Valley School District,ATRISK_CHILD_SUPPER,21,1790,0,0,1790,17547,0,0,17547,835.5714
SAN DIEGO,Apr 2014,CACF,2014,La Mesa-Spring Valley School District,ATRISK_CHILD_SNACK,15,1809,0,0,1809,10951,0,0,10951,730.0667
SAN DIEGO,Apr 2014,CACF,2014,La Mesa-Spring Valley School District,ATRISK_CHILD_SUPPER,15,1809,0,0,1809,9953,0,0,9953,663.5333
SAN DIEGO,May 2014,CACF,2014,La Mesa-Spring Valley School District,ATRISK_CHILD_SNACK,20,1774,0,0,1774,13625,0,0,13625,681.25
SAN DIEGO,May 2014,CACF,2014,La Mesa-Spring Valley School District,ATRISK_CHILD_SUPPER,20,1774,0,0,1774,16128,0,0,16128,806.4
SAN DIEGO,Jun 2014,CACF,2014,La Mesa-Spring Valley School District,ATRISK_CHILD_SNACK,10,1699,0,0,1699,6575,0,0,6575,657.5
SAN DIEGO,Jun 2014,CACF,2014,La Mesa-Spring Valley School District,ATRISK_CHILD_SUPPER,10,1699,0,0,1699,7368,0,0,7368,736.8
SAN DIEGO,Aug 2014,CACF,2014,La Mesa-Spring Valley School District,ATRISK_CHILD_SNACK,12,1864,0,0,1864,7546,0,0,7546,628.8333
SAN DIEGO,Aug 2014,CACF,2014,La Mesa-Spring Valley School District,ATRISK_CHILD_SUPPER,12,1864,0,0,1864,8761,0,0,8761,730.0833
SAN DIEGO,Sep 2014,CACF,2014,La Mesa-Spring Valley School District,ATRISK_CHILD_SNACK,21,2007,0,0,2007,13331,0,0,13331,634.8095
SAN DIEGO,Sep 2014,CACF,2014,La Mesa-Spring Valley School District,ATRISK_CHILD_SUPPER,21,2007,0,0,2007,16216,0,0,16216,772.1905
SAN DIEGO,Oct 2013,CACF,2014,Lakeside Union Elementary School District,ATRISK_CHILD_SUPPER,23,615,0,0,615,11248,0,0,11248,489.0435
SAN DIEGO,Nov 2013,CACF,2014,Lakeside Union Elementary School District,ATRISK_CHILD_SUPPER,14,579,0,0,579,6767,0,0,6767,483.3571
SAN DIEGO,Dec 2013,CACF,2014,Lakeside Union Elementary School District,ATRISK_CHILD_SUPPER,15,680,0,0,680,7696,0,0,7696,513.0667
SAN DIEGO,Jan 2014,CACF,2014,Lakeside Union Elementary School District,ATRISK_CHILD_SUPPER,19,668,0,0,668,10024,0,0,10024,527.5789
SAN DIEGO,Feb 2014,CACF,2014,Lakeside Union Elementary School District,ATRISK_CHILD_SUPPER,18,680,0,0,680,10542,0,0,10542,585.6667
SAN DIEGO,Mar 2014,CACF,2014,Lakeside Union Elementary School District,ATRISK_CHILD_SUPPER,21,704,0,0,704,11486,0,0,11486,546.9524
SAN DIEGO,Apr 2014,CACF,2014,Lakeside Union Elementary School District,ATRISK_CHILD_SUPPER,12,685,0,0,685,6266,0,0,6266,522.1667
SAN DIEGO,May 2014,CACF,2014,Lakeside Union Elementary School District,ATRISK_CHILD_SUPPER,20,680,0,0,680,10508,0,0,10508,525.4
SAN DIEGO,Jun 2014,CACF,2014,Lakeside Union Elementary School District,ATRISK_CHILD_SUPPER,15,572,0,0,572,6437,0,0,6437,429.1333
SAN DIEGO,Sep 2014,CACF,2014,Lakeside Union Elementary School District,ATRISK_CHILD_SUPPER,21,687,0,0,687,10368,0,0,10368,493.7143
SAN DIEGO,Oct 2013,CACF,2014,Lemon Grove School District,ATRISK_CHILD_SUPPER,23,737,0,0,737,13958,0,0,13958,606.8696
SAN DIEGO,Nov 2013,CACF,2014,Lemon Grove School District,ATRISK_CHILD_SUPPER,15,813,0,0,813,9458,0,0,9458,630.5333
SAN DIEGO,Dec 2013,CACF,2014,Lemon Grove School District,ATRISK_CHILD_SUPPER,14,799,0,0,799,9048,0,0,9048,646.2857
SAN DIEGO,Jan 2014,CACF,2014,Lemon Grove School District,ATRISK_CHILD_SUPPER,19,917,0,0,917,11555,0,0,11555,608.1579
SAN DIEGO,Feb 2014,CACF,2014,Lemon Grove School District,ATRISK_CHILD_SUPPER,18,920,0,0,920,11274,0,0,11274,626.3333
SAN DIEGO,Mar 2014,CACF,2014,Lemon Grove School District,ATRISK_CHILD_SUPPER,21,920,0,0,920,13212,0,0,13212,629.1429
SAN DIEGO,Apr 2014,CACF,2014,Lemon Grove School District,ATRISK_CHILD_SUPPER,15,890,0,0,890,9541,0,0,9541,636.0667
SAN DIEGO,May 2014,CACF,2014,Lemon Grove School District,ATRISK_CHILD_SUPPER,20,920,0,0,920,11003,0,0,11003,550.15
SAN DIEGO,Jun 2014,CACF,2014,Lemon Grove School District,ATRISK_CHILD_SUPPER,9,920,0,0,920,4631,0,0,4631,514.5556
SAN DIEGO,Aug 2014,CACF,2014,Lemon Grove School District,ATRISK_CHILD_SUPPER,8,1194,0,0,1194,4630,0,0,4630,578.75
SAN DIEGO,Sep 2014,CACF,2014,Lemon Grove School District,ATRISK_CHILD_SUPPER,21,766,0,0,766,12170,0,0,12170,579.5238
SAN DIEGO,Oct 2013,CACF,2014,LIFEBRIDGE CHURCH,CHILD_LUNCH,23,0,0,120,120,0,0,1855,1855,80.6522
SAN DIEGO,Oct 2013,CACF,2014,LIFEBRIDGE CHURCH,CHILD_SNACK_AM,23,0,0,120,120,0,0,1959,1959,85.1739
SAN DIEGO,Oct 2013,CACF,2014,LIFEBRIDGE CHURCH,CHILD_SNACK_PM,23,0,0,120,120,0,0,1550,1550,67.3913
SAN DIEGO,Nov 2013,CACF,2014,LIFEBRIDGE CHURCH,CHILD_LUNCH,19,0,0,120,120,0,0,1171,1171,61.6316
SAN DIEGO,Nov 2013,CACF,2014,LIFEBRIDGE CHURCH,CHILD_SNACK_AM,19,0,0,120,120,0,0,1280,1280,67.3684
SAN DIEGO,Nov 2013,CACF,2014,LIFEBRIDGE CHURCH,CHILD_SNACK_PM,19,0,0,120,120,0,0,1070,1070,56.3158
SAN DIEGO,Dec 2013,CACF,2014,LIFEBRIDGE CHURCH,CHILD_LUNCH,16,0,0,120,120,0,0,1277,1277,79.8125
SAN DIEGO,Dec 2013,CACF,2014,LIFEBRIDGE CHURCH,CHILD_SNACK_AM,16,0,0,120,120,0,0,1288,1288,80.5
SAN DIEGO,Dec 2013,CACF,2014,LIFEBRIDGE CHURCH,CHILD_SNACK_PM,16,0,0,120,120,0,0,1010,1010,63.125
SAN DIEGO,Jan 2014,CACF,2014,LIFEBRIDGE CHURCH,CHILD_LUNCH,22,0,0,120,120,0,0,1661,1661,75.5
SAN DIEGO,Jan 2014,CACF,2014,LIFEBRIDGE CHURCH,CHILD_SNACK_AM,22,0,0,120,120,0,0,1766,1766,80.2727
SAN DIEGO,Jan 2014,CACF,2014,LIFEBRIDGE CHURCH,CHILD_SNACK_PM,22,0,0,120,120,0,0,1397,1397,63.5
SAN DIEGO,Feb 2014,CACF,2014,LIFEBRIDGE CHURCH,CHILD_LUNCH,19,0,0,120,120,0,0,1580,1580,83.1579
SAN DIEGO,Feb 2014,CACF,2014,LIFEBRIDGE CHURCH,CHILD_SNACK_AM,19,0,0,120,120,0,0,1693,1693,89.1053
SAN DIEGO,Feb 2014,CACF,2014,LIFEBRIDGE CHURCH,CHILD_SNACK_PM,19,0,0,120,120,0,0,1284,1284,67.5789
SAN DIEGO,Mar 2014,CACF,2014,LIFEBRIDGE CHURCH,CHILD_LUNCH,21,0,0,120,120,0,0,1825,1825,86.9048
SAN DIEGO,Mar 2014,CACF,2014,LIFEBRIDGE CHURCH,CHILD_SNACK_AM,21,0,0,120,120,0,0,1827,1827,87
SAN DIEGO,Mar 2014,CACF,2014,LIFEBRIDGE CHURCH,CHILD_SNACK_PM,21,0,0,120,120,0,0,1642,1642,78.1905
SAN DIEGO,Apr 2014,CACF,2014,LIFEBRIDGE CHURCH,CHILD_LUNCH,21,0,0,120,120,0,0,1803,1803,85.8571
SAN DIEGO,Apr 2014,CACF,2014,LIFEBRIDGE CHURCH,CHILD_SNACK_AM,21,0,0,120,120,0,0,1937,1937,92.2381
SAN DIEGO,Apr 2014,CACF,2014,LIFEBRIDGE CHURCH,CHILD_SNACK_PM,21,0,0,120,120,0,0,1565,1565,74.5238
SAN DIEGO,May 2014,CACF,2014,LIFEBRIDGE CHURCH,CHILD_LUNCH,19,0,0,120,120,0,0,1682,1682,88.5263
SAN DIEGO,May 2014,CACF,2014,LIFEBRIDGE CHURCH,CHILD_SNACK_AM,19,0,0,120,120,0,0,1778,1778,93.5789
SAN DIEGO,May 2014,CACF,2014,LIFEBRIDGE CHURCH,CHILD_SNACK_PM,19,0,0,120,120,0,0,1474,1474,77.5789
SAN DIEGO,Jun 2014,CACF,2014,LIFEBRIDGE CHURCH,CHILD_LUNCH,20,0,0,120,120,0,0,1453,1453,72.65
SAN DIEGO,Jun 2014,CACF,2014,LIFEBRIDGE CHURCH,CHILD_SNACK_AM,20,0,0,120,120,0,0,1548,1548,77.4
SAN DIEGO,Jun 2014,CACF,2014,LIFEBRIDGE CHURCH,CHILD_SNACK_PM,20,0,0,120,120,0,0,1326,1326,66.3
SAN DIEGO,Jul 2014,CACF,2014,LIFEBRIDGE CHURCH,CHILD_LUNCH,22,0,0,120,120,0,0,1425,1425,64.7727
SAN DIEGO,Jul 2014,CACF,2014,LIFEBRIDGE CHURCH,CHILD_SNACK_AM,22,0,0,120,120,0,0,1476,1476,67.0909
SAN DIEGO,Jul 2014,CACF,2014,LIFEBRIDGE CHURCH,CHILD_SNACK_PM,22,0,0,120,120,0,0,1272,1272,57.8182
SAN DIEGO,Aug 2014,CACF,2014,LIFEBRIDGE CHURCH,CHILD_LUNCH,20,0,0,120,120,0,0,1374,1374,68.7
SAN DIEGO,Aug 2014,CACF,2014,LIFEBRIDGE CHURCH,CHILD_SNACK_AM,20,0,0,120,120,0,0,1461,1461,73.05
SAN DIEGO,Aug 2014,CACF,2014,LIFEBRIDGE CHURCH,CHILD_SNACK_PM,20,0,0,120,120,0,0,1191,1191,59.55
SAN DIEGO,Sep 2014,CACF,2014,LIFEBRIDGE CHURCH,CHILD_LUNCH,21,0,0,120,120,0,0,1501,1501,71.4762
SAN DIEGO,Sep 2014,CACF,2014,LIFEBRIDGE CHURCH,CHILD_SNACK_AM,21,0,0,120,120,0,0,1665,1665,79.2857
SAN DIEGO,Sep 2014,CACF,2014,LIFEBRIDGE CHURCH,CHILD_SNACK_PM,21,0,0,120,120,0,0,1281,1281,61
SAN DIEGO,Oct 2013,CACF,2014,LINERS CORP ,ADULT_LUNCH,23,118,0,2,120,1578,0,27,1605,69.7826
SAN DIEGO,Oct 2013,CACF,2014,LINERS CORP ,ADULT_SNACK_AM,23,118,0,2,120,1581,0,27,1608,69.913
SAN DIEGO,Nov 2013,CACF,2014,LINERS CORP ,ADULT_LUNCH,20,115,0,2,117,1309,0,23,1332,66.6
SAN DIEGO,Nov 2013,CACF,2014,LINERS CORP ,ADULT_SNACK_AM,20,115,0,2,117,1316,0,23,1339,66.95
SAN DIEGO,Dec 2013,CACF,2014,LINERS CORP ,ADULT_LUNCH,21,116,0,3,119,1447,0,37,1484,70.6667
SAN DIEGO,Dec 2013,CACF,2014,LINERS CORP ,ADULT_SNACK_AM,21,116,0,3,119,1447,0,37,1484,70.6667
SAN DIEGO,Jan 2014,CACF,2014,LINERS CORP ,ADULT_LUNCH,22,117,0,2,119,1547,0,26,1573,71.5
SAN DIEGO,Jan 2014,CACF,2014,LINERS CORP ,ADULT_SNACK_AM,22,117,0,2,119,1547,0,26,1573,71.5
SAN DIEGO,Feb 2014,CACF,2014,LINERS CORP ,ADULT_LUNCH,20,118,0,2,120,1410,0,24,1434,71.7
SAN DIEGO,Feb 2014,CACF,2014,LINERS CORP ,ADULT_SNACK_AM,20,118,0,2,120,1410,0,24,1434,71.7
SAN DIEGO,Mar 2014,CACF,2014,LINERS CORP ,ADULT_LUNCH,21,120,0,2,122,1522,0,25,1547,73.6667
SAN DIEGO,Mar 2014,CACF,2014,LINERS CORP ,ADULT_SNACK_AM,21,120,0,2,122,1522,0,25,1547,73.6667
SAN DIEGO,Apr 2014,CACF,2014,LINERS CORP ,ADULT_LUNCH,22,116,0,2,118,1552,0,27,1579,71.7727
SAN DIEGO,Apr 2014,CACF,2014,LINERS CORP ,ADULT_SNACK_AM,22,116,0,2,118,1552,0,27,1579,71.7727
SAN DIEGO,May 2014,CACF,2014,LINERS CORP ,ADULT_LUNCH,22,119,0,2,121,1555,0,26,1581,71.8636
SAN DIEGO,May 2014,CACF,2014,LINERS CORP ,ADULT_SNACK_AM,22,119,0,2,121,1555,0,26,1581,71.8636
SAN DIEGO,Jun 2014,CACF,2014,LINERS CORP ,ADULT_LUNCH,21,122,0,2,124,1525,0,25,1550,73.8095
SAN DIEGO,Jun 2014,CACF,2014,LINERS CORP ,ADULT_SNACK_AM,21,122,0,2,124,1549,0,25,1574,74.9524
SAN DIEGO,Jul 2014,CACF,2014,LINERS CORP ,ADULT_LUNCH,22,122,0,2,124,1558,0,26,1584,72
SAN DIEGO,Jul 2014,CACF,2014,LINERS CORP ,ADULT_SNACK_AM,22,122,0,2,124,1558,0,26,1584,72
SAN DIEGO,Aug 2014,CACF,2014,LINERS CORP ,ADULT_LUNCH,21,122,0,2,124,1625,0,27,1652,78.6667
SAN DIEGO,Aug 2014,CACF,2014,LINERS CORP ,ADULT_SNACK_AM,21,122,0,2,124,1625,0,27,1652,78.6667
SAN DIEGO,Sep 2014,CACF,2014,LINERS CORP ,ADULT_LUNCH,21,122,0,2,124,1744,0,29,1773,84.4286
SAN DIEGO,Sep 2014,CACF,2014,LINERS CORP ,ADULT_SNACK_AM,21,122,0,2,124,1745,0,29,1774,84.4762
SAN DIEGO,Oct 2013,CACF,2014,LITTLE BEARS DAYCARE INC,CHILD_BREAKFAST,23,20,1,2,23,239,12,24,275,11.9565
SAN DIEGO,Oct 2013,CACF,2014,LITTLE BEARS DAYCARE INC,CHILD_LUNCH,23,20,1,2,23,337,17,34,388,16.8696
SAN DIEGO,Oct 2013,CACF,2014,LITTLE BEARS DAYCARE INC,CHILD_SNACK_PM,23,20,1,2,23,327,16,33,376,16.3478
SAN DIEGO,Oct 2013,CACF,2014,LITTLE BEARS DAYCARE INC,CHILD_SUPPER,23,20,1,2,23,7,0,1,8,0.3478
SAN DIEGO,Oct 2013,CACF,2014,LITTLE BEARS DAYCARE INC,OSCH_CHILD_BREAKFAST,23,32,4,5,41,297,37,46,380,16.5217
SAN DIEGO,Oct 2013,CACF,2014,LITTLE BEARS DAYCARE INC,OSCH_CHILD_LUNCH,23,32,4,5,41,38,5,6,49,2.1304
SAN DIEGO,Oct 2013,CACF,2014,LITTLE BEARS DAYCARE INC,OSCH_CHILD_SNACK_PM,23,32,4,5,41,485,61,76,622,27.0435
SAN DIEGO,Oct 2013,CACF,2014,LITTLE BEARS DAYCARE INC,OSCH_CHILD_SUPPER,23,32,4,5,41,28,4,4,36,1.5652
SAN DIEGO,Nov 2013,CACF,2014,LITTLE BEARS DAYCARE INC,CHILD_BREAKFAST,18,20,1,2,23,184,9,19,212,11.7778
SAN DIEGO,Nov 2013,CACF,2014,LITTLE BEARS DAYCARE INC,CHILD_LUNCH,18,20,1,2,23,266,13,27,306,17
SAN DIEGO,Nov 2013,CACF,2014,LITTLE BEARS DAYCARE INC,CHILD_SNACK_PM,18,20,1,2,23,254,13,25,292,16.2222
SAN DIEGO,Nov 2013,CACF,2014,LITTLE BEARS DAYCARE INC,CHILD_SUPPER,18,20,1,2,23,2,0,0,2,0.1111
SAN DIEGO,Nov 2013,CACF,2014,LITTLE BEARS DAYCARE INC,OSCH_CHILD_BREAKFAST,18,32,4,5,41,223,28,35,286,15.8889
SAN DIEGO,Nov 2013,CACF,2014,LITTLE BEARS DAYCARE INC,OSCH_CHILD_LUNCH,18,32,4,5,41,54,7,8,69,3.8333
SAN DIEGO,Nov 2013,CACF,2014,LITTLE BEARS DAYCARE INC,OSCH_CHILD_SNACK_PM,18,32,4,5,41,375,47,58,480,26.6667
SAN DIEGO,Dec 2013,CACF,2014,LITTLE BEARS DAYCARE INC,CHILD_BREAKFAST,21,20,1,2,23,211,11,21,243,11.5714
SAN DIEGO,Dec 2013,CACF,2014,LITTLE BEARS DAYCARE INC,CHILD_LUNCH,21,20,1,2,23,299,15,30,344,16.381
SAN DIEGO,Dec 2013,CACF,2014,LITTLE BEARS DAYCARE INC,CHILD_SNACK_PM,21,20,1,2,23,298,15,30,343,16.3333
SAN DIEGO,Dec 2013,CACF,2014,LITTLE BEARS DAYCARE INC,OSCH_CHILD_BREAKFAST,21,32,4,5,41,307,38,48,393,18.7143
SAN DIEGO,Dec 2013,CACF,2014,LITTLE BEARS DAYCARE INC,OSCH_CHILD_LUNCH,21,32,4,5,41,153,19,24,196,9.3333
SAN DIEGO,Dec 2013,CACF,2014,LITTLE BEARS DAYCARE INC,OSCH_CHILD_SNACK_PM,21,32,4,5,41,507,63,79,649,30.9048
SAN DIEGO,Jan 2014,CACF,2014,LITTLE BEARS DAYCARE INC,CHILD_BREAKFAST,21,20,1,2,23,248,12,25,285,13.5714
SAN DIEGO,Jan 2014,CACF,2014,LITTLE BEARS DAYCARE INC,CHILD_LUNCH,21,20,1,2,23,328,16,33,377,17.9524
SAN DIEGO,Jan 2014,CACF,2014,LITTLE BEARS DAYCARE INC,CHILD_SNACK_PM,21,20,1,2,23,326,16,33,375,17.8571
SAN DIEGO,Jan 2014,CACF,2014,LITTLE BEARS DAYCARE INC,OSCH_CHILD_BREAKFAST,21,32,4,5,41,322,40,51,413,19.6667
SAN DIEGO,Jan 2014,CACF,2014,LITTLE BEARS DAYCARE INC,OSCH_CHILD_LUNCH,21,32,4,5,41,66,8,11,85,4.0476
SAN DIEGO,Jan 2014,CACF,2014,LITTLE BEARS DAYCARE INC,OSCH_CHILD_SNACK_PM,21,32,4,5,41,485,61,76,622,29.619
SAN DIEGO,Feb 2014,CACF,2014,LITTLE BEARS DAYCARE INC,CHILD_BREAKFAST,19,20,1,2,23,239,12,24,275,14.4737
SAN DIEGO,Feb 2014,CACF,2014,LITTLE BEARS DAYCARE INC,CHILD_LUNCH,19,20,1,2,23,296,15,29,340,17.8947
SAN DIEGO,Feb 2014,CACF,2014,LITTLE BEARS DAYCARE INC,CHILD_SNACK_PM,19,20,1,2,23,277,14,27,318,16.7368
SAN DIEGO,Feb 2014,CACF,2014,LITTLE BEARS DAYCARE INC,OSCH_CHILD_BREAKFAST,19,32,4,5,41,319,40,50,409,21.5263
SAN DIEGO,Feb 2014,CACF,2014,LITTLE BEARS DAYCARE INC,OSCH_CHILD_LUNCH,19,32,4,5,41,128,16,20,164,8.6316
SAN DIEGO,Feb 2014,CACF,2014,LITTLE BEARS DAYCARE INC,OSCH_CHILD_SNACK_PM,19,32,4,5,41,473,59,74,606,31.8947
SAN DIEGO,Mar 2014,CACF,2014,LITTLE BEARS DAYCARE INC,CHILD_BREAKFAST,21,20,1,2,23,203,10,20,233,11.0952
SAN DIEGO,Mar 2014,CACF,2014,LITTLE BEARS DAYCARE INC,CHILD_LUNCH,21,20,1,2,23,263,13,27,303,14.4286
SAN DIEGO,Mar 2014,CACF,2014,LITTLE BEARS DAYCARE INC,CHILD_SNACK_PM,21,20,1,2,23,251,13,25,289,13.7619
SAN DIEGO,Mar 2014,CACF,2014,LITTLE BEARS DAYCARE INC,OSCH_CHILD_BREAKFAST,21,32,4,5,41,277,35,43,355,16.9048
SAN DIEGO,Mar 2014,CACF,2014,LITTLE BEARS DAYCARE INC,OSCH_CHILD_LUNCH,21,32,4,5,41,46,6,7,59,2.8095
SAN DIEGO,Mar 2014,CACF,2014,LITTLE BEARS DAYCARE INC,OSCH_CHILD_SNACK_PM,21,32,4,5,41,453,57,71,581,27.6667
SAN DIEGO,Oct 2013,CACF,2014,LOVING CARE ADHC LIMITED ,ADULT_BREAKFAST,23,101,0,0,101,1332,0,0,1332,57.913
SAN DIEGO,Oct 2013,CACF,2014,LOVING CARE ADHC LIMITED ,ADULT_LUNCH,23,101,0,0,101,1331,0,0,1331,57.8696
SAN DIEGO,Oct 2013,CACF,2014,LOVING CARE ADHC LIMITED ,ADULT_SNACK_AM,23,101,0,0,101,1331,0,0,1331,57.8696
SAN DIEGO,Nov 2013,CACF,2014,LOVING CARE ADHC LIMITED ,ADULT_BREAKFAST,21,101,0,0,101,1219,0,0,1219,58.0476
SAN DIEGO,Nov 2013,CACF,2014,LOVING CARE ADHC LIMITED ,ADULT_LUNCH,21,101,0,0,101,1217,0,0,1217,57.9524
SAN DIEGO,Nov 2013,CACF,2014,LOVING CARE ADHC LIMITED ,ADULT_SNACK_AM,21,101,0,0,101,1217,0,0,1217,57.9524
SAN DIEGO,Dec 2013,CACF,2014,LOVING CARE ADHC LIMITED ,ADULT_BREAKFAST,21,101,0,0,101,1271,0,0,1271,60.5238
SAN DIEGO,Dec 2013,CACF,2014,LOVING CARE ADHC LIMITED ,ADULT_LUNCH,21,101,0,0,101,1270,0,0,1270,60.4762
SAN DIEGO,Dec 2013,CACF,2014,LOVING CARE ADHC LIMITED ,ADULT_SNACK_AM,21,101,0,0,101,1271,0,0,1271,60.5238
SAN DIEGO,Jan 2014,CACF,2014,LOVING CARE ADHC LIMITED ,ADULT_BREAKFAST,22,101,0,0,101,1268,0,0,1268,57.6364
SAN DIEGO,Jan 2014,CACF,2014,LOVING CARE ADHC LIMITED ,ADULT_LUNCH,22,101,0,0,101,1266,0,0,1266,57.5455
SAN DIEGO,Jan 2014,CACF,2014,LOVING CARE ADHC LIMITED ,ADULT_SNACK_AM,22,101,0,0,101,1266,0,0,1266,57.5455
SAN DIEGO,Feb 2014,CACF,2014,LOVING CARE ADHC LIMITED ,ADULT_BREAKFAST,20,101,0,0,101,1160,0,0,1160,58
SAN DIEGO,Feb 2014,CACF,2014,LOVING CARE ADHC LIMITED ,ADULT_LUNCH,20,101,0,0,101,1159,0,0,1159,57.95
SAN DIEGO,Feb 2014,CACF,2014,LOVING CARE ADHC LIMITED ,ADULT_SNACK_AM,20,101,0,0,101,1160,0,0,1160,58
SAN DIEGO,Mar 2014,CACF,2014,LOVING CARE ADHC LIMITED ,ADULT_BREAKFAST,21,101,0,0,101,1303,0,0,1303,62.0476
SAN DIEGO,Mar 2014,CACF,2014,LOVING CARE ADHC LIMITED ,ADULT_LUNCH,21,101,0,0,101,1302,0,0,1302,62
SAN DIEGO,Mar 2014,CACF,2014,LOVING CARE ADHC LIMITED ,ADULT_SNACK_AM,21,101,0,0,101,1302,0,0,1302,62
SAN DIEGO,Apr 2014,CACF,2014,LOVING CARE ADHC LIMITED ,ADULT_BREAKFAST,22,101,0,0,101,1376,0,0,1376,62.5455
SAN DIEGO,Apr 2014,CACF,2014,LOVING CARE ADHC LIMITED ,ADULT_LUNCH,22,101,0,0,101,1377,0,0,1377,62.5909
SAN DIEGO,Apr 2014,CACF,2014,LOVING CARE ADHC LIMITED ,ADULT_SNACK_AM,22,101,0,0,101,1377,0,0,1377,62.5909
SAN DIEGO,May 2014,CACF,2014,LOVING CARE ADHC LIMITED ,ADULT_BREAKFAST,22,101,0,0,101,1352,0,0,1352,61.4545
SAN DIEGO,May 2014,CACF,2014,LOVING CARE ADHC LIMITED ,ADULT_LUNCH,22,101,0,0,101,1354,0,0,1354,61.5455
SAN DIEGO,May 2014,CACF,2014,LOVING CARE ADHC LIMITED ,ADULT_SNACK_AM,22,101,0,0,101,1353,0,0,1353,61.5
SAN DIEGO,Jun 2014,CACF,2014,LOVING CARE ADHC LIMITED ,ADULT_BREAKFAST,21,101,0,0,101,1322,0,0,1322,62.9524
SAN DIEGO,Jun 2014,CACF,2014,LOVING CARE ADHC LIMITED ,ADULT_LUNCH,21,101,0,0,101,1322,0,0,1322,62.9524
SAN DIEGO,Jun 2014,CACF,2014,LOVING CARE ADHC LIMITED ,ADULT_SNACK_AM,21,101,0,0,101,1321,0,0,1321,62.9048
SAN DIEGO,Jul 2014,CACF,2014,LOVING CARE ADHC LIMITED ,ADULT_BREAKFAST,23,101,0,0,101,1474,0,0,1474,64.087
SAN DIEGO,Jul 2014,CACF,2014,LOVING CARE ADHC LIMITED ,ADULT_LUNCH,23,101,0,0,101,1475,0,0,1475,64.1304
SAN DIEGO,Jul 2014,CACF,2014,LOVING CARE ADHC LIMITED ,ADULT_SNACK_AM,23,101,0,0,101,1475,0,0,1475,64.1304
SAN DIEGO,Aug 2014,CACF,2014,LOVING CARE ADHC LIMITED ,ADULT_BREAKFAST,21,101,0,0,101,1329,0,0,1329,63.2857
SAN DIEGO,Aug 2014,CACF,2014,LOVING CARE ADHC LIMITED ,ADULT_LUNCH,21,101,0,0,101,1328,0,0,1328,63.2381
SAN DIEGO,Aug 2014,CACF,2014,LOVING CARE ADHC LIMITED ,ADULT_SNACK_AM,21,101,0,0,101,1328,0,0,1328,63.2381
SAN DIEGO,Sep 2014,CACF,2014,LOVING CARE ADHC LIMITED ,ADULT_BREAKFAST,22,101,0,0,101,1434,0,0,1434,65.1818
SAN DIEGO,Sep 2014,CACF,2014,LOVING CARE ADHC LIMITED ,ADULT_LUNCH,22,101,0,0,101,1432,0,0,1432,65.0909
SAN DIEGO,Sep 2014,CACF,2014,LOVING CARE ADHC LIMITED ,ADULT_SNACK_AM,22,101,0,0,101,1432,0,0,1432,65.0909
SAN DIEGO,Oct 2013,CACF,2014,MARANGELYS KIDS INC KIDDIE ACADEMY CHILD CARE CTR,CHILD_BREAKFAST,23,64,4,51,119,816,51,651,1518,66
SAN DIEGO,Oct 2013,CACF,2014,MARANGELYS KIDS INC KIDDIE ACADEMY CHILD CARE CTR,CHILD_LUNCH,23,64,4,51,119,1072,67,854,1993,86.6522
SAN DIEGO,Oct 2013,CACF,2014,MARANGELYS KIDS INC KIDDIE ACADEMY CHILD CARE CTR,CHILD_SNACK_PM,23,64,4,51,119,998,62,795,1855,80.6522
SAN DIEGO,Oct 2013,CACF,2014,MARANGELYS KIDS INC KIDDIE ACADEMY CHILD CARE CTR,OSCH_CHILD_BREAKFAST,23,64,5,17,86,613,48,163,824,35.8261
SAN DIEGO,Oct 2013,CACF,2014,MARANGELYS KIDS INC KIDDIE ACADEMY CHILD CARE CTR,OSCH_CHILD_LUNCH,23,64,5,17,86,83,7,22,112,4.8696
SAN DIEGO,Oct 2013,CACF,2014,MARANGELYS KIDS INC KIDDIE ACADEMY CHILD CARE CTR,OSCH_CHILD_SNACK_PM,23,64,5,17,86,1078,84,287,1449,63
SAN DIEGO,Nov 2013,CACF,2014,MARANGELYS KIDS INC KIDDIE ACADEMY CHILD CARE CTR,CHILD_BREAKFAST,20,64,4,51,119,655,41,521,1217,60.85
SAN DIEGO,Nov 2013,CACF,2014,MARANGELYS KIDS INC KIDDIE ACADEMY CHILD CARE CTR,CHILD_LUNCH,20,64,4,51,119,848,53,676,1577,78.85
SAN DIEGO,Nov 2013,CACF,2014,MARANGELYS KIDS INC KIDDIE ACADEMY CHILD CARE CTR,CHILD_SNACK_PM,20,64,4,51,119,791,49,631,1471,73.55
SAN DIEGO,Nov 2013,CACF,2014,MARANGELYS KIDS INC KIDDIE ACADEMY CHILD CARE CTR,OSCH_CHILD_BREAKFAST,20,64,5,17,86,519,41,138,698,34.9
SAN DIEGO,Nov 2013,CACF,2014,MARANGELYS KIDS INC KIDDIE ACADEMY CHILD CARE CTR,OSCH_CHILD_LUNCH,20,64,5,17,86,130,10,35,175,8.75
SAN DIEGO,Nov 2013,CACF,2014,MARANGELYS KIDS INC KIDDIE ACADEMY CHILD CARE CTR,OSCH_CHILD_SNACK_PM,20,64,5,17,86,916,72,243,1231,61.55
SAN DIEGO,Dec 2013,CACF,2014,MARANGELYS KIDS INC KIDDIE ACADEMY CHILD CARE CTR,CHILD_BREAKFAST,21,64,4,51,119,630,39,503,1172,55.8095
SAN DIEGO,Dec 2013,CACF,2014,MARANGELYS KIDS INC KIDDIE ACADEMY CHILD CARE CTR,CHILD_LUNCH,21,64,4,51,119,857,54,682,1593,75.8571
SAN DIEGO,Dec 2013,CACF,2014,MARANGELYS KIDS INC KIDDIE ACADEMY CHILD CARE CTR,CHILD_SNACK_PM,21,64,4,51,119,795,50,633,1478,70.381
SAN DIEGO,Dec 2013,CACF,2014,MARANGELYS KIDS INC KIDDIE ACADEMY CHILD CARE CTR,OSCH_CHILD_BREAKFAST,21,64,5,17,86,506,40,134,680,32.381
SAN DIEGO,Dec 2013,CACF,2014,MARANGELYS KIDS INC KIDDIE ACADEMY CHILD CARE CTR,OSCH_CHILD_LUNCH,21,64,5,17,86,181,14,48,243,11.5714
SAN DIEGO,Dec 2013,CACF,2014,MARANGELYS KIDS INC KIDDIE ACADEMY CHILD CARE CTR,OSCH_CHILD_SNACK_PM,21,64,5,17,86,866,68,230,1164,55.4286
SAN DIEGO,Jan 2014,CACF,2014,MARANGELYS KIDS INC KIDDIE ACADEMY CHILD CARE CTR,CHILD_BREAKFAST,22,64,4,51,119,752,47,600,1399,63.5909
SAN DIEGO,Jan 2014,CACF,2014,MARANGELYS KIDS INC KIDDIE ACADEMY CHILD CARE CTR,CHILD_LUNCH,22,64,4,51,119,965,60,769,1794,81.5455
SAN DIEGO,Jan 2014,CACF,2014,MARANGELYS KIDS INC KIDDIE ACADEMY CHILD CARE CTR,CHILD_SNACK_PM,22,64,4,51,119,911,57,726,1694,77
SAN DIEGO,Jan 2014,CACF,2014,MARANGELYS KIDS INC KIDDIE ACADEMY CHILD CARE CTR,OSCH_CHILD_BREAKFAST,22,64,5,17,86,545,43,145,733,33.3182
SAN DIEGO,Jan 2014,CACF,2014,MARANGELYS KIDS INC KIDDIE ACADEMY CHILD CARE CTR,OSCH_CHILD_LUNCH,22,64,5,17,86,100,8,27,135,6.1364
SAN DIEGO,Jan 2014,CACF,2014,MARANGELYS KIDS INC KIDDIE ACADEMY CHILD CARE CTR,OSCH_CHILD_SNACK_PM,22,64,5,17,86,883,69,234,1186,53.9091
SAN DIEGO,Feb 2014,CACF,2014,MARANGELYS KIDS INC KIDDIE ACADEMY CHILD CARE CTR,CHILD_BREAKFAST,20,64,4,51,119,739,46,589,1374,68.7
SAN DIEGO,Feb 2014,CACF,2014,MARANGELYS KIDS INC KIDDIE ACADEMY CHILD CARE CTR,CHILD_LUNCH,20,64,4,51,119,938,59,748,1745,87.25
SAN DIEGO,Feb 2014,CACF,2014,MARANGELYS KIDS INC KIDDIE ACADEMY CHILD CARE CTR,CHILD_SNACK_PM,20,64,4,51,119,840,52,669,1561,78.05
SAN DIEGO,Feb 2014,CACF,2014,MARANGELYS KIDS INC KIDDIE ACADEMY CHILD CARE CTR,OSCH_CHILD_BREAKFAST,20,64,5,17,86,521,41,138,700,35
SAN DIEGO,Feb 2014,CACF,2014,MARANGELYS KIDS INC KIDDIE ACADEMY CHILD CARE CTR,OSCH_CHILD_LUNCH,20,64,5,17,86,223,17,59,299,14.95
SAN DIEGO,Feb 2014,CACF,2014,MARANGELYS KIDS INC KIDDIE ACADEMY CHILD CARE CTR,OSCH_CHILD_SNACK_PM,20,64,5,17,86,813,63,216,1092,54.6
SAN DIEGO,Mar 2014,CACF,2014,MARANGELYS KIDS INC KIDDIE ACADEMY CHILD CARE CTR,CHILD_BREAKFAST,21,64,4,51,119,771,48,615,1434,68.2857
SAN DIEGO,Mar 2014,CACF,2014,MARANGELYS KIDS INC KIDDIE ACADEMY CHILD CARE CTR,CHILD_LUNCH,21,64,4,51,119,1009,63,804,1876,89.3333
SAN DIEGO,Mar 2014,CACF,2014,MARANGELYS KIDS INC KIDDIE ACADEMY CHILD CARE CTR,CHILD_SNACK_PM,21,64,4,51,119,931,58,743,1732,82.4762
SAN DIEGO,Mar 2014,CACF,2014,MARANGELYS KIDS INC KIDDIE ACADEMY CHILD CARE CTR,OSCH_CHILD_BREAKFAST,21,64,5,17,86,564,44,150,758,36.0952
SAN DIEGO,Mar 2014,CACF,2014,MARANGELYS KIDS INC KIDDIE ACADEMY CHILD CARE CTR,OSCH_CHILD_LUNCH,21,64,5,17,86,127,10,34,171,8.1429
SAN DIEGO,Mar 2014,CACF,2014,MARANGELYS KIDS INC KIDDIE ACADEMY CHILD CARE CTR,OSCH_CHILD_SNACK_PM,21,64,5,17,86,945,74,251,1270,60.4762
SAN DIEGO,Apr 2014,CACF,2014,MARANGELYS KIDS INC KIDDIE ACADEMY CHILD CARE CTR,CHILD_BREAKFAST,22,64,4,51,119,821,51,655,1527,69.4091
SAN DIEGO,Apr 2014,CACF,2014,MARANGELYS KIDS INC KIDDIE ACADEMY CHILD CARE CTR,CHILD_LUNCH,22,64,4,51,119,1103,69,879,2051,93.2273
SAN DIEGO,Apr 2014,CACF,2014,MARANGELYS KIDS INC KIDDIE ACADEMY CHILD CARE CTR,CHILD_SNACK_PM,22,64,4,51,119,1014,63,808,1885,85.6818
SAN DIEGO,Apr 2014,CACF,2014,MARANGELYS KIDS INC KIDDIE ACADEMY CHILD CARE CTR,OSCH_CHILD_BREAKFAST,22,64,5,17,86,622,49,165,836,38
SAN DIEGO,Apr 2014,CACF,2014,MARANGELYS KIDS INC KIDDIE ACADEMY CHILD CARE CTR,OSCH_CHILD_LUNCH,22,64,5,17,86,296,23,79,398,18.0909
SAN DIEGO,Apr 2014,CACF,2014,MARANGELYS KIDS INC KIDDIE ACADEMY CHILD CARE CTR,OSCH_CHILD_SNACK_PM,22,64,5,17,86,1039,81,276,1396,63.4545
SAN DIEGO,May 2014,CACF,2014,MARANGELYS KIDS INC KIDDIE ACADEMY CHILD CARE CTR,CHILD_BREAKFAST,21,64,4,51,119,871,54,695,1620,77.1429
SAN DIEGO,May 2014,CACF,2014,MARANGELYS KIDS INC KIDDIE ACADEMY CHILD CARE CTR,CHILD_LUNCH,21,64,4,51,119,1134,71,904,2109,100.4286
SAN DIEGO,May 2014,CACF,2014,MARANGELYS KIDS INC KIDDIE ACADEMY CHILD CARE CTR,CHILD_SNACK_PM,21,64,4,51,119,1034,65,824,1923,91.5714
SAN DIEGO,May 2014,CACF,2014,MARANGELYS KIDS INC KIDDIE ACADEMY CHILD CARE CTR,OSCH_CHILD_BREAKFAST,21,64,5,17,86,558,44,148,750,35.7143
SAN DIEGO,May 2014,CACF,2014,MARANGELYS KIDS INC KIDDIE ACADEMY CHILD CARE CTR,OSCH_CHILD_LUNCH,21,64,5,17,86,185,14,49,248,11.8095
SAN DIEGO,May 2014,CACF,2014,MARANGELYS KIDS INC KIDDIE ACADEMY CHILD CARE CTR,OSCH_CHILD_SNACK_PM,21,64,5,17,86,960,75,255,1290,61.4286
SAN DIEGO,Jun 2014,CACF,2014,MARANGELYS KIDS INC KIDDIE ACADEMY CHILD CARE CTR,CHILD_BREAKFAST,21,64,4,51,119,931,58,743,1732,82.4762
SAN DIEGO,Jun 2014,CACF,2014,MARANGELYS KIDS INC KIDDIE ACADEMY CHILD CARE CTR,CHILD_LUNCH,21,64,4,51,119,1186,74,946,2206,105.0476
SAN DIEGO,Jun 2014,CACF,2014,MARANGELYS KIDS INC KIDDIE ACADEMY CHILD CARE CTR,CHILD_SNACK_PM,21,64,4,51,119,1012,63,807,1882,89.619
SAN DIEGO,Jun 2014,CACF,2014,MARANGELYS KIDS INC KIDDIE ACADEMY CHILD CARE CTR,OSCH_CHILD_BREAKFAST,21,64,5,17,86,674,53,178,905,43.0952
SAN DIEGO,Jun 2014,CACF,2014,MARANGELYS KIDS INC KIDDIE ACADEMY CHILD CARE CTR,OSCH_CHILD_LUNCH,21,64,5,17,86,677,53,180,910,43.3333
SAN DIEGO,Jun 2014,CACF,2014,MARANGELYS KIDS INC KIDDIE ACADEMY CHILD CARE CTR,OSCH_CHILD_SNACK_PM,21,64,5,17,86,854,67,226,1147,54.619
SAN DIEGO,Jul 2014,CACF,2014,MARANGELYS KIDS INC KIDDIE ACADEMY CHILD CARE CTR,CHILD_BREAKFAST,22,64,4,51,119,918,57,732,1707,77.5909
SAN DIEGO,Jul 2014,CACF,2014,MARANGELYS KIDS INC KIDDIE ACADEMY CHILD CARE CTR,CHILD_LUNCH,22,64,4,51,119,1271,79,1014,2364,107.4545
SAN DIEGO,Jul 2014,CACF,2014,MARANGELYS KIDS INC KIDDIE ACADEMY CHILD CARE CTR,CHILD_SNACK_PM,22,64,4,51,119,1063,66,848,1977,89.8636
SAN DIEGO,Jul 2014,CACF,2014,MARANGELYS KIDS INC KIDDIE ACADEMY CHILD CARE CTR,OSCH_CHILD_BREAKFAST,22,64,5,17,86,717,56,191,964,43.8182
SAN DIEGO,Jul 2014,CACF,2014,MARANGELYS KIDS INC KIDDIE ACADEMY CHILD CARE CTR,OSCH_CHILD_LUNCH,22,64,5,17,86,900,70,240,1210,55
SAN DIEGO,Jul 2014,CACF,2014,MARANGELYS KIDS INC KIDDIE ACADEMY CHILD CARE CTR,OSCH_CHILD_SNACK_PM,22,64,5,17,86,831,65,221,1117,50.7727
SAN DIEGO,Aug 2014,CACF,2014,MARANGELYS KIDS INC KIDDIE ACADEMY CHILD CARE CTR,CHILD_BREAKFAST,21,64,4,51,119,805,50,642,1497,71.2857
SAN DIEGO,Aug 2014,CACF,2014,MARANGELYS KIDS INC KIDDIE ACADEMY CHILD CARE CTR,CHILD_LUNCH,21,64,4,51,119,1036,65,826,1927,91.7619
SAN DIEGO,Aug 2014,CACF,2014,MARANGELYS KIDS INC KIDDIE ACADEMY CHILD CARE CTR,CHILD_SNACK_PM,21,64,4,51,119,918,57,732,1707,81.2857
SAN DIEGO,Aug 2014,CACF,2014,MARANGELYS KIDS INC KIDDIE ACADEMY CHILD CARE CTR,OSCH_CHILD_BREAKFAST,21,64,5,17,86,671,52,178,901,42.9048
SAN DIEGO,Aug 2014,CACF,2014,MARANGELYS KIDS INC KIDDIE ACADEMY CHILD CARE CTR,OSCH_CHILD_LUNCH,21,64,5,17,86,529,41,141,711,33.8571
SAN DIEGO,Aug 2014,CACF,2014,MARANGELYS KIDS INC KIDDIE ACADEMY CHILD CARE CTR,OSCH_CHILD_SNACK_PM,21,64,5,17,86,917,72,243,1232,58.6667
SAN DIEGO,Sep 2014,CACF,2014,MARANGELYS KIDS INC KIDDIE ACADEMY CHILD CARE CTR,CHILD_BREAKFAST,21,64,4,51,119,776,48,618,1442,68.6667
SAN DIEGO,Sep 2014,CACF,2014,MARANGELYS KIDS INC KIDDIE ACADEMY CHILD CARE CTR,CHILD_LUNCH,21,64,4,51,119,988,62,788,1838,87.5238
SAN DIEGO,Sep 2014,CACF,2014,MARANGELYS KIDS INC KIDDIE ACADEMY CHILD CARE CTR,CHILD_SNACK_PM,21,64,4,51,119,888,55,708,1651,78.619
SAN DIEGO,Sep 2014,CACF,2014,MARANGELYS KIDS INC KIDDIE ACADEMY CHILD CARE CTR,OSCH_CHILD_BREAKFAST,21,64,5,17,86,588,46,156,790,37.619
SAN DIEGO,Sep 2014,CACF,2014,MARANGELYS KIDS INC KIDDIE ACADEMY CHILD CARE CTR,OSCH_CHILD_LUNCH,21,64,5,17,86,112,9,30,151,7.1905
SAN DIEGO,Sep 2014,CACF,2014,MARANGELYS KIDS INC KIDDIE ACADEMY CHILD CARE CTR,OSCH_CHILD_SNACK_PM,21,64,5,17,86,1089,85,289,1463,69.6667
SAN DIEGO,Oct 2013,CACF,2014,Marine Corps Air Station,ATRISK_CHILD_SNACK,22,127,0,0,127,2178,0,0,2178,99
SAN DIEGO,Oct 2013,CACF,2014,Marine Corps Air Station,CHILD_SNACK_AM,22,7,13,37,57,44,82,232,358,16.2727
SAN DIEGO,Oct 2013,CACF,2014,Marine Corps Air Station,CHILD_SNACK_PM,22,7,13,37,57,27,50,144,221,10.0455
SAN DIEGO,Nov 2013,CACF,2014,Marine Corps Air Station,ATRISK_CHILD_SNACK,19,118,0,0,118,1748,0,0,1748,92
SAN DIEGO,Nov 2013,CACF,2014,Marine Corps Air Station,ATRISK_CHILD_SUPPER,19,118,0,0,118,83,0,0,83,4.3684
SAN DIEGO,Nov 2013,CACF,2014,Marine Corps Air Station,CHILD_SNACK_AM,15,7,13,37,57,30,56,160,246,16.4
SAN DIEGO,Nov 2013,CACF,2014,Marine Corps Air Station,CHILD_SNACK_PM,15,7,13,37,57,19,34,98,151,10.0667
SAN DIEGO,Dec 2013,CACF,2014,Marine Corps Air Station,ATRISK_CHILD_SNACK,21,112,0,0,112,1806,0,0,1806,86
SAN DIEGO,Dec 2013,CACF,2014,Marine Corps Air Station,CHILD_SNACK_AM,15,7,13,37,57,31,57,164,252,16.8
SAN DIEGO,Dec 2013,CACF,2014,Marine Corps Air Station,CHILD_SNACK_PM,15,7,13,37,57,14,25,72,111,7.4
SAN DIEGO,Jan 2014,CACF,2014,Marine Corps Air Station,ATRISK_CHILD_SNACK,21,116,0,0,116,1762,0,0,1762,83.9048
SAN DIEGO,Jan 2014,CACF,2014,Marine Corps Air Station,CHILD_SNACK_AM,19,7,13,37,57,39,72,203,314,16.5263
SAN DIEGO,Jan 2014,CACF,2014,Marine Corps Air Station,CHILD_SNACK_PM,19,7,13,37,57,21,38,109,168,8.8421
SAN DIEGO,Feb 2014,CACF,2014,Marine Corps Air Station,ATRISK_CHILD_SNACK,19,117,0,0,117,1824,0,0,1824,96
SAN DIEGO,Feb 2014,CACF,2014,Marine Corps Air Station,CHILD_SNACK_AM,19,7,13,37,57,46,85,241,372,19.5789
SAN DIEGO,Feb 2014,CACF,2014,Marine Corps Air Station,CHILD_SNACK_PM,19,7,13,37,57,24,45,130,199,10.4737
SAN DIEGO,Mar 2014,CACF,2014,Marine Corps Air Station,ATRISK_CHILD_SNACK,21,113,0,0,113,1989,0,0,1989,94.7143
SAN DIEGO,Mar 2014,CACF,2014,Marine Corps Air Station,ATRISK_CHILD_SNACK_AM,21,113,0,0,113,53,0,0,53,2.5238
SAN DIEGO,Mar 2014,CACF,2014,Marine Corps Air Station,CHILD_SNACK_AM,20,7,13,37,57,43,81,229,353,17.65
SAN DIEGO,Mar 2014,CACF,2014,Marine Corps Air Station,CHILD_SNACK_PM,20,7,13,37,57,25,46,129,200,10
SAN DIEGO,Apr 2014,CACF,2014,Marine Corps Air Station,ATRISK_CHILD_SNACK,22,122,0,0,122,2024,0,0,2024,92
SAN DIEGO,Apr 2014,CACF,2014,Marine Corps Air Station,ATRISK_CHILD_SNACK_AM,22,122,0,0,122,852,0,0,852,38.7273
SAN DIEGO,Apr 2014,CACF,2014,Marine Corps Air Station,CHILD_SNACK_AM,18,7,13,37,57,36,67,192,295,16.3889
SAN DIEGO,Apr 2014,CACF,2014,Marine Corps Air Station,CHILD_SNACK_PM,18,7,13,37,57,24,44,125,193,10.7222
SAN DIEGO,May 2014,CACF,2014,Marine Corps Air Station,ATRISK_CHILD_LUNCH,21,113,0,0,113,103,0,0,103,4.9048
SAN DIEGO,May 2014,CACF,2014,Marine Corps Air Station,ATRISK_CHILD_SNACK,21,113,0,0,113,1911,0,0,1911,91
SAN DIEGO,May 2014,CACF,2014,Marine Corps Air Station,ATRISK_CHILD_SNACK_AM,21,113,0,0,113,117,0,0,117,5.5714
SAN DIEGO,May 2014,CACF,2014,Marine Corps Air Station,CHILD_SNACK_AM,20,7,13,37,57,52,97,278,427,21.35
SAN DIEGO,May 2014,CACF,2014,Marine Corps Air Station,CHILD_SNACK_PM,20,7,13,37,57,9,16,46,71,3.55
SAN DIEGO,Jun 2014,CACF,2014,Marine Corps Air Station,ATRISK_CHILD_BREAKFAST,20,109,0,0,109,212,0,0,212,10.6
SAN DIEGO,Jun 2014,CACF,2014,Marine Corps Air Station,ATRISK_CHILD_LUNCH,20,109,0,0,109,148,0,0,148,7.4
SAN DIEGO,Jun 2014,CACF,2014,Marine Corps Air Station,ATRISK_CHILD_SNACK,20,109,0,0,109,1860,0,0,1860,93
SAN DIEGO,Jun 2014,CACF,2014,Marine Corps Air Station,ATRISK_CHILD_SNACK_AM,20,109,0,0,109,163,0,0,163,8.15
SAN DIEGO,Jun 2014,CACF,2014,Marine Corps Air Station,CHILD_BREAKFAST,11,7,13,37,57,2,4,13,19,1.7273
SAN DIEGO,Jun 2014,CACF,2014,Marine Corps Air Station,CHILD_LUNCH,11,7,13,37,57,5,9,27,41,3.7273
SAN DIEGO,Jun 2014,CACF,2014,Marine Corps Air Station,CHILD_SNACK_AM,11,7,13,37,57,4,8,24,36,3.2727
SAN DIEGO,Jun 2014,CACF,2014,Marine Corps Air Station,CHILD_SNACK_PM,11,7,13,37,57,3,6,16,25,2.2727
SAN DIEGO,Jul 2014,CACF,2014,Marine Corps Air Station,CHILD_LUNCH,22,0,2,20,22,0,44,440,484,22
SAN DIEGO,Jul 2014,CACF,2014,Marine Corps Air Station,CHILD_SNACK_AM,22,0,2,20,22,0,44,440,484,22
SAN DIEGO,Jul 2014,CACF,2014,Marine Corps Air Station,CHILD_SNACK_PM,22,0,2,20,22,0,38,384,422,19.1818
SAN DIEGO,Jul 2014,CACF,2014,Marine Corps Air Station,OSCH_CHILD_SNACK_AM,22,5,9,193,207,36,65,1394,1495,67.9545
SAN DIEGO,Jul 2014,CACF,2014,Marine Corps Air Station,OSCH_CHILD_SNACK_PM,22,5,9,193,207,52,94,2014,2160,98.1818
SAN DIEGO,Aug 2014,CACF,2014,Marine Corps Air Station,CHILD_BREAKFAST,21,0,2,20,22,0,32,323,355,16.9048
SAN DIEGO,Aug 2014,CACF,2014,Marine Corps Air Station,CHILD_LUNCH,21,0,2,20,22,0,42,416,458,21.8095
SAN DIEGO,Aug 2014,CACF,2014,Marine Corps Air Station,CHILD_SNACK_PM,21,0,2,20,22,0,38,384,422,20.0952
SAN DIEGO,Aug 2014,CACF,2014,Marine Corps Air Station,OSCH_CHILD_LUNCH,21,5,9,193,207,9,16,334,359,17.0952
SAN DIEGO,Aug 2014,CACF,2014,Marine Corps Air Station,OSCH_CHILD_SNACK_AM,21,5,9,193,207,39,70,1489,1598,76.0952
SAN DIEGO,Aug 2014,CACF,2014,Marine Corps Air Station,OSCH_CHILD_SNACK_PM,21,5,9,193,207,40,73,1556,1669,79.4762
SAN DIEGO,Sep 2014,CACF,2014,Marine Corps Air Station,ATRISK_CHILD_SNACK,21,120,0,0,120,2184,0,0,2184,104
SAN DIEGO,Sep 2014,CACF,2014,Marine Corps Air Station,CHILD_LUNCH,21,0,2,20,22,0,42,420,462,22
SAN DIEGO,Sep 2014,CACF,2014,Marine Corps Air Station,CHILD_SNACK_AM,21,0,2,20,22,0,42,420,462,22
SAN DIEGO,Sep 2014,CACF,2014,Marine Corps Air Station,CHILD_SNACK_PM,21,0,2,20,22,0,39,390,429,20.4286
SAN DIEGO,Oct 2013,CACF,2014,Marine Corps Community Services,CHILD_BREAKFAST,22,13,35,519,567,189,511,7575,8275,376.1364
SAN DIEGO,Oct 2013,CACF,2014,Marine Corps Community Services,CHILD_LUNCH,22,13,35,519,567,209,563,8346,9118,414.4545
SAN DIEGO,Oct 2013,CACF,2014,Marine Corps Community Services,CHILD_SNACK_AM,22,13,35,519,567,18,47,703,768,34.9091
SAN DIEGO,Oct 2013,CACF,2014,Marine Corps Community Services,CHILD_SNACK_PM,22,13,35,519,567,201,540,8016,8757,398.0455
SAN DIEGO,Oct 2013,CACF,2014,Marine Corps Community Services,OSCH_CHILD_BREAKFAST,22,5,9,164,178,27,48,881,956,43.4545
SAN DIEGO,Oct 2013,CACF,2014,Marine Corps Community Services,OSCH_CHILD_LUNCH,22,5,9,164,178,5,10,174,189,8.5909
SAN DIEGO,Oct 2013,CACF,2014,Marine Corps Community Services,OSCH_CHILD_SNACK_PM,22,5,9,164,178,79,142,2590,2811,127.7727
SAN DIEGO,Nov 2013,CACF,2014,Marine Corps Community Services,CHILD_BREAKFAST,19,13,35,519,567,153,413,6123,6689,352.0526
SAN DIEGO,Nov 2013,CACF,2014,Marine Corps Community Services,CHILD_LUNCH,19,13,35,519,567,171,461,6836,7468,393.0526
SAN DIEGO,Nov 2013,CACF,2014,Marine Corps Community Services,CHILD_SNACK_AM,19,13,35,519,567,13,36,535,584,30.7368
SAN DIEGO,Nov 2013,CACF,2014,Marine Corps Community Services,CHILD_SNACK_PM,19,13,35,519,567,160,430,6379,6969,366.7895
SAN DIEGO,Nov 2013,CACF,2014,Marine Corps Community Services,OSCH_CHILD_BREAKFAST,19,5,9,164,178,24,43,775,842,44.3158
SAN DIEGO,Nov 2013,CACF,2014,Marine Corps Community Services,OSCH_CHILD_LUNCH,19,5,9,164,178,5,8,148,161,8.4737
SAN DIEGO,Nov 2013,CACF,2014,Marine Corps Community Services,OSCH_CHILD_SNACK_PM,19,5,9,164,178,63,114,2074,2251,118.4737
SAN DIEGO,Dec 2013,CACF,2014,Marine Corps Community Services,CHILD_BREAKFAST,21,13,35,519,567,158,426,6318,6902,328.6667
SAN DIEGO,Dec 2013,CACF,2014,Marine Corps Community Services,CHILD_LUNCH,21,13,35,519,567,176,475,7051,7702,366.7619
SAN DIEGO,Dec 2013,CACF,2014,Marine Corps Community Services,CHILD_SNACK_AM,21,13,35,519,567,16,44,652,712,33.9048
SAN DIEGO,Dec 2013,CACF,2014,Marine Corps Community Services,CHILD_SNACK_PM,21,13,35,519,567,167,451,6695,7313,348.2381
SAN DIEGO,Dec 2013,CACF,2014,Marine Corps Community Services,OSCH_CHILD_BREAKFAST,21,5,9,164,178,22,40,724,786,37.4286
SAN DIEGO,Dec 2013,CACF,2014,Marine Corps Community Services,OSCH_CHILD_LUNCH,21,5,9,164,178,9,15,281,305,14.5238
SAN DIEGO,Dec 2013,CACF,2014,Marine Corps Community Services,OSCH_CHILD_SNACK_PM,21,5,9,164,178,55,100,1813,1968,93.7143
SAN DIEGO,Jan 2014,CACF,2014,Marine Corps Community Services,CHILD_BREAKFAST,21,13,35,519,567,191,513,7617,8321,396.2381
SAN DIEGO,Jan 2014,CACF,2014,Marine Corps Community Services,CHILD_LUNCH,21,13,35,519,567,214,577,8559,9350,445.2381
SAN DIEGO,Jan 2014,CACF,2014,Marine Corps Community Services,CHILD_SNACK_AM,21,13,35,519,567,17,46,687,750,35.7143
SAN DIEGO,Jan 2014,CACF,2014,Marine Corps Community Services,CHILD_SNACK_PM,21,13,35,519,567,207,557,8267,9031,430.0476
SAN DIEGO,Jan 2014,CACF,2014,Marine Corps Community Services,OSCH_CHILD_BREAKFAST,21,5,9,164,178,24,44,795,863,41.0952
SAN DIEGO,Jan 2014,CACF,2014,Marine Corps Community Services,OSCH_CHILD_LUNCH,21,5,9,164,178,7,13,234,254,12.0952
SAN DIEGO,Jan 2014,CACF,2014,Marine Corps Community Services,OSCH_CHILD_SNACK_PM,21,5,9,164,178,62,112,2033,2207,105.0952
SAN DIEGO,Feb 2014,CACF,2014,Marine Corps Community Services,CHILD_BREAKFAST,19,28,46,620,694,347,570,7682,8599,452.5789
SAN DIEGO,Feb 2014,CACF,2014,Marine Corps Community Services,CHILD_LUNCH,19,28,46,620,694,385,633,8533,9551,502.6842
SAN DIEGO,Feb 2014,CACF,2014,Marine Corps Community Services,CHILD_SNACK_AM,19,28,46,620,694,32,53,712,797,41.9474
SAN DIEGO,Feb 2014,CACF,2014,Marine Corps Community Services,CHILD_SNACK_PM,19,28,46,620,694,371,611,8230,9212,484.8421
SAN DIEGO,Feb 2014,CACF,2014,Marine Corps Community Services,OSCH_CHILD_BREAKFAST,19,10,10,148,168,49,49,726,824,43.3684
SAN DIEGO,Feb 2014,CACF,2014,Marine Corps Community Services,OSCH_CHILD_LUNCH,19,10,10,148,168,22,22,320,364,19.1579
SAN DIEGO,Feb 2014,CACF,2014,Marine Corps Community Services,OSCH_CHILD_SNACK_PM,19,10,10,148,168,126,126,1862,2114,111.2632
SAN DIEGO,Mar 2014,CACF,2014,Marine Corps Community Services,CHILD_BREAKFAST,21,28,46,620,694,395,650,8766,9811,467.1905
SAN DIEGO,Mar 2014,CACF,2014,Marine Corps Community Services,CHILD_LUNCH,21,28,46,620,694,446,734,9894,11074,527.3333
SAN DIEGO,Mar 2014,CACF,2014,Marine Corps Community Services,CHILD_SNACK_AM,21,28,46,620,694,41,68,915,1024,48.7619
SAN DIEGO,Mar 2014,CACF,2014,Marine Corps Community Services,CHILD_SNACK_PM,21,28,46,620,694,427,703,9467,10597,504.619
SAN DIEGO,Mar 2014,CACF,2014,Marine Corps Community Services,OSCH_CHILD_BREAKFAST,21,10,10,148,168,47,47,692,786,37.4286
SAN DIEGO,Mar 2014,CACF,2014,Marine Corps Community Services,OSCH_CHILD_LUNCH,21,10,10,148,168,15,15,215,245,11.6667
SAN DIEGO,Mar 2014,CACF,2014,Marine Corps Community Services,OSCH_CHILD_SNACK_PM,21,10,10,148,168,159,159,2347,2665,126.9048
SAN DIEGO,Apr 2014,CACF,2014,Marine Corps Community Services,CHILD_BREAKFAST,22,32,51,681,764,422,672,8971,10065,457.5
SAN DIEGO,Apr 2014,CACF,2014,Marine Corps Community Services,CHILD_LUNCH,22,32,51,681,764,483,770,10271,11524,523.8182
SAN DIEGO,Apr 2014,CACF,2014,Marine Corps Community Services,CHILD_SNACK_AM,22,32,51,681,764,35,56,743,834,37.9091
SAN DIEGO,Apr 2014,CACF,2014,Marine Corps Community Services,CHILD_SNACK_PM,22,32,51,681,764,456,728,9710,10894,495.1818
SAN DIEGO,Apr 2014,CACF,2014,Marine Corps Community Services,OSCH_CHILD_BREAKFAST,22,10,10,148,168,56,56,826,938,42.6364
SAN DIEGO,Apr 2014,CACF,2014,Marine Corps Community Services,OSCH_CHILD_LUNCH,22,10,10,148,168,34,34,503,571,25.9545
SAN DIEGO,Apr 2014,CACF,2014,Marine Corps Community Services,OSCH_CHILD_SNACK_PM,22,10,10,148,168,138,138,2047,2323,105.5909
SAN DIEGO,May 2014,CACF,2014,Marine Corps Community Services,CHILD_BREAKFAST,21,32,51,681,764,395,630,8408,9433,449.1905
SAN DIEGO,May 2014,CACF,2014,Marine Corps Community Services,CHILD_LUNCH,21,32,51,681,764,449,716,9553,10718,510.381
SAN DIEGO,May 2014,CACF,2014,Marine Corps Community Services,CHILD_SNACK_AM,21,32,51,681,764,29,45,607,681,32.4286
SAN DIEGO,May 2014,CACF,2014,Marine Corps Community Services,CHILD_SNACK_PM,21,32,51,681,764,433,691,9222,10346,492.6667
SAN DIEGO,May 2014,CACF,2014,Marine Corps Community Services,OSCH_CHILD_BREAKFAST,21,10,10,148,168,51,51,750,852,40.5714
SAN DIEGO,May 2014,CACF,2014,Marine Corps Community Services,OSCH_CHILD_LUNCH,21,10,10,148,168,26,26,378,430,20.4762
SAN DIEGO,May 2014,CACF,2014,Marine Corps Community Services,OSCH_CHILD_SNACK_PM,21,10,10,148,168,136,136,2008,2280,108.5714
SAN DIEGO,Jun 2014,CACF,2014,Marine Corps Community Services,CHILD_BREAKFAST,21,32,51,681,764,347,554,7386,8287,394.619
SAN DIEGO,Jun 2014,CACF,2014,Marine Corps Community Services,CHILD_LUNCH,21,32,51,681,764,400,637,8498,9535,454.0476
SAN DIEGO,Jun 2014,CACF,2014,Marine Corps Community Services,CHILD_SNACK_AM,21,32,51,681,764,18,29,385,432,20.5714
SAN DIEGO,Jun 2014,CACF,2014,Marine Corps Community Services,CHILD_SNACK_PM,21,32,51,681,764,387,617,8226,9230,439.5238
SAN DIEGO,Jun 2014,CACF,2014,Marine Corps Community Services,OSCH_CHILD_BREAKFAST,21,10,10,148,168,130,130,1917,2177,103.6667
SAN DIEGO,Jun 2014,CACF,2014,Marine Corps Community Services,OSCH_CHILD_LUNCH,21,10,10,148,168,159,159,2359,2677,127.4762
SAN DIEGO,Jun 2014,CACF,2014,Marine Corps Community Services,OSCH_CHILD_SNACK_PM,21,10,10,148,168,151,151,2228,2530,120.4762
SAN DIEGO,Jul 2014,CACF,2014,Marine Corps Community Services,CHILD_BREAKFAST,22,32,51,681,764,336,536,7158,8030,365
SAN DIEGO,Jul 2014,CACF,2014,Marine Corps Community Services,CHILD_LUNCH,22,32,51,681,764,393,626,8350,9369,425.8636
SAN DIEGO,Jul 2014,CACF,2014,Marine Corps Community Services,CHILD_SNACK_AM,22,32,51,681,764,12,20,262,294,13.3636
SAN DIEGO,Jul 2014,CACF,2014,Marine Corps Community Services,CHILD_SNACK_PM,22,32,51,681,764,376,600,8006,8982,408.2727
SAN DIEGO,Jul 2014,CACF,2014,Marine Corps Community Services,OSCH_CHILD_BREAKFAST,22,10,10,148,168,124,124,1834,2082,94.6364
SAN DIEGO,Jul 2014,CACF,2014,Marine Corps Community Services,OSCH_CHILD_LUNCH,22,10,10,148,168,155,155,2299,2609,118.5909
SAN DIEGO,Jul 2014,CACF,2014,Marine Corps Community Services,OSCH_CHILD_SNACK_PM,22,10,10,148,168,148,148,2196,2492,113.2727
SAN DIEGO,Aug 2014,CACF,2014,Marine Corps Community Services,CHILD_BREAKFAST,21,32,51,681,764,318,506,6758,7582,361.0476
SAN DIEGO,Aug 2014,CACF,2014,Marine Corps Community Services,CHILD_LUNCH,21,32,51,681,764,386,616,8221,9223,439.1905
SAN DIEGO,Aug 2014,CACF,2014,Marine Corps Community Services,CHILD_SNACK_AM,21,32,51,681,764,11,17,227,255,12.1429
SAN DIEGO,Aug 2014,CACF,2014,Marine Corps Community Services,CHILD_SNACK_PM,21,32,51,681,764,369,588,7848,8805,419.2857
SAN DIEGO,Aug 2014,CACF,2014,Marine Corps Community Services,OSCH_CHILD_BREAKFAST,21,10,10,148,168,72,72,1067,1211,57.6667
SAN DIEGO,Aug 2014,CACF,2014,Marine Corps Community Services,OSCH_CHILD_LUNCH,21,10,10,148,168,52,52,773,877,41.7619
SAN DIEGO,Aug 2014,CACF,2014,Marine Corps Community Services,OSCH_CHILD_SNACK_PM,21,10,10,148,168,160,160,2372,2692,128.1905
SAN DIEGO,Sep 2014,CACF,2014,Marine Corps Community Services,CHILD_BREAKFAST,21,32,51,681,764,340,542,7234,8116,386.4762
SAN DIEGO,Sep 2014,CACF,2014,Marine Corps Community Services,CHILD_LUNCH,21,32,51,681,764,410,653,8716,9779,465.6667
SAN DIEGO,Sep 2014,CACF,2014,Marine Corps Community Services,CHILD_SNACK_AM,21,32,51,681,764,21,33,442,496,23.619
SAN DIEGO,Sep 2014,CACF,2014,Marine Corps Community Services,CHILD_SNACK_PM,21,32,51,681,764,392,625,8346,9363,445.8571
SAN DIEGO,Sep 2014,CACF,2014,Marine Corps Community Services,OSCH_CHILD_BREAKFAST,21,10,10,148,168,70,70,1031,1171,55.7619
SAN DIEGO,Sep 2014,CACF,2014,Marine Corps Community Services,OSCH_CHILD_LUNCH,21,10,10,148,168,15,15,214,244,11.619
SAN DIEGO,Sep 2014,CACF,2014,Marine Corps Community Services,OSCH_CHILD_SNACK_PM,21,10,10,148,168,185,185,2743,3113,148.2381
SAN DIEGO,Oct 2013,CACF,2014,MARTHA'S VILLAGE & KITCHEN INC ,ES_CHILD_BREAKFAST,31,77,0,0,77,1044,0,0,1044,33.6774
SAN DIEGO,Oct 2013,CACF,2014,MARTHA'S VILLAGE & KITCHEN INC ,ES_CHILD_LUNCH,31,77,0,0,77,735,0,0,735,23.7097
SAN DIEGO,Oct 2013,CACF,2014,MARTHA'S VILLAGE & KITCHEN INC ,ES_CHILD_SUPPER,31,77,0,0,77,1198,0,0,1198,38.6452
SAN DIEGO,Nov 2013,CACF,2014,MARTHA'S VILLAGE & KITCHEN INC ,ES_CHILD_BREAKFAST,30,74,0,0,74,957,0,0,957,31.9
SAN DIEGO,Nov 2013,CACF,2014,MARTHA'S VILLAGE & KITCHEN INC ,ES_CHILD_LUNCH,30,74,0,0,74,768,0,0,768,25.6
SAN DIEGO,Nov 2013,CACF,2014,MARTHA'S VILLAGE & KITCHEN INC ,ES_CHILD_SUPPER,30,74,0,0,74,1036,0,0,1036,34.5333
SAN DIEGO,Dec 2013,CACF,2014,MARTHA'S VILLAGE & KITCHEN INC ,ES_CHILD_BREAKFAST,31,74,0,0,74,743,0,0,743,23.9677
SAN DIEGO,Dec 2013,CACF,2014,MARTHA'S VILLAGE & KITCHEN INC ,ES_CHILD_LUNCH,31,74,0,0,74,710,0,0,710,22.9032
SAN DIEGO,Dec 2013,CACF,2014,MARTHA'S VILLAGE & KITCHEN INC ,ES_CHILD_SUPPER,31,74,0,0,74,1014,0,0,1014,32.7097
SAN DIEGO,Jan 2014,CACF,2014,MARTHA'S VILLAGE & KITCHEN INC ,ES_CHILD_BREAKFAST,31,77,0,0,77,523,0,0,523,16.871
SAN DIEGO,Jan 2014,CACF,2014,MARTHA'S VILLAGE & KITCHEN INC ,ES_CHILD_LUNCH,31,77,0,0,77,627,0,0,627,20.2258
SAN DIEGO,Jan 2014,CACF,2014,MARTHA'S VILLAGE & KITCHEN INC ,ES_CHILD_SUPPER,31,77,0,0,77,818,0,0,818,26.3871
SAN DIEGO,Feb 2014,CACF,2014,MARTHA'S VILLAGE & KITCHEN INC ,ES_CHILD_BREAKFAST,28,72,0,0,72,652,0,0,652,23.2857
SAN DIEGO,Feb 2014,CACF,2014,MARTHA'S VILLAGE & KITCHEN INC ,ES_CHILD_LUNCH,28,72,0,0,72,578,0,0,578,20.6429
SAN DIEGO,Feb 2014,CACF,2014,MARTHA'S VILLAGE & KITCHEN INC ,ES_CHILD_SUPPER,28,72,0,0,72,829,0,0,829,29.6071
SAN DIEGO,Mar 2014,CACF,2014,MARTHA'S VILLAGE & KITCHEN INC ,ES_CHILD_BREAKFAST,31,76,0,0,76,772,0,0,772,24.9032
SAN DIEGO,Mar 2014,CACF,2014,MARTHA'S VILLAGE & KITCHEN INC ,ES_CHILD_LUNCH,31,76,0,0,76,876,0,0,876,28.2581
SAN DIEGO,Mar 2014,CACF,2014,MARTHA'S VILLAGE & KITCHEN INC ,ES_CHILD_SUPPER,31,76,0,0,76,1010,0,0,1010,32.5806
SAN DIEGO,Apr 2014,CACF,2014,MARTHA'S VILLAGE & KITCHEN INC ,ES_CHILD_BREAKFAST,30,75,0,0,75,830,0,0,830,27.6667
SAN DIEGO,Apr 2014,CACF,2014,MARTHA'S VILLAGE & KITCHEN INC ,ES_CHILD_LUNCH,30,75,0,0,75,803,0,0,803,26.7667
SAN DIEGO,Apr 2014,CACF,2014,MARTHA'S VILLAGE & KITCHEN INC ,ES_CHILD_SUPPER,30,75,0,0,75,919,0,0,919,30.6333
SAN DIEGO,May 2014,CACF,2014,MARTHA'S VILLAGE & KITCHEN INC ,ES_CHILD_BREAKFAST,31,1643,0,0,1643,1022,0,0,1022,32.9677
SAN DIEGO,May 2014,CACF,2014,MARTHA'S VILLAGE & KITCHEN INC ,ES_CHILD_LUNCH,31,1643,0,0,1643,739,0,0,739,23.8387
SAN DIEGO,May 2014,CACF,2014,MARTHA'S VILLAGE & KITCHEN INC ,ES_CHILD_SUPPER,31,1643,0,0,1643,1077,0,0,1077,34.7419
SAN DIEGO,Jun 2014,CACF,2014,MARTHA'S VILLAGE & KITCHEN INC ,ES_CHILD_BREAKFAST,30,1955,0,0,1955,1060,0,0,1060,35.3333
SAN DIEGO,Jun 2014,CACF,2014,MARTHA'S VILLAGE & KITCHEN INC ,ES_CHILD_LUNCH,30,1955,0,0,1955,1024,0,0,1024,34.1333
SAN DIEGO,Jun 2014,CACF,2014,MARTHA'S VILLAGE & KITCHEN INC ,ES_CHILD_SUPPER,30,1955,0,0,1955,1188,0,0,1188,39.6
SAN DIEGO,Jul 2014,CACF,2014,MARTHA'S VILLAGE & KITCHEN INC ,ES_CHILD_BREAKFAST,31,2042,0,0,2042,981,0,0,981,31.6452
SAN DIEGO,Jul 2014,CACF,2014,MARTHA'S VILLAGE & KITCHEN INC ,ES_CHILD_LUNCH,31,2042,0,0,2042,1295,0,0,1295,41.7742
SAN DIEGO,Jul 2014,CACF,2014,MARTHA'S VILLAGE & KITCHEN INC ,ES_CHILD_SUPPER,31,2042,0,0,2042,1362,0,0,1362,43.9355
SAN DIEGO,Aug 2014,CACF,2014,MARTHA'S VILLAGE & KITCHEN INC ,ES_CHILD_BREAKFAST,31,1756,0,0,1756,874,0,0,874,28.1935
SAN DIEGO,Aug 2014,CACF,2014,MARTHA'S VILLAGE & KITCHEN INC ,ES_CHILD_LUNCH,31,1756,0,0,1756,1102,0,0,1102,35.5484
SAN DIEGO,Aug 2014,CACF,2014,MARTHA'S VILLAGE & KITCHEN INC ,ES_CHILD_SUPPER,31,1756,0,0,1756,1113,0,0,1113,35.9032
SAN DIEGO,Sep 2014,CACF,2014,MARTHA'S VILLAGE & KITCHEN INC ,ES_CHILD_BREAKFAST,30,1624,0,0,1624,1124,0,0,1124,37.4667
SAN DIEGO,Sep 2014,CACF,2014,MARTHA'S VILLAGE & KITCHEN INC ,ES_CHILD_LUNCH,30,1624,0,0,1624,758,0,0,758,25.2667
SAN DIEGO,Sep 2014,CACF,2014,MARTHA'S VILLAGE & KITCHEN INC ,ES_CHILD_SUPPER,30,1624,0,0,1624,818,0,0,818,27.2667
SAN DIEGO,Oct 2013,CACF,2014,METROPOLITAN AREA ADVISORY COMMITTEE-MAAC-PROJ HEADSTART,HS_CHILD_BREAKFAST,21,1808,0,0,1808,7904,0,0,7904,376.381
SAN DIEGO,Oct 2013,CACF,2014,METROPOLITAN AREA ADVISORY COMMITTEE-MAAC-PROJ HEADSTART,HS_CHILD_LUNCH,21,1808,0,0,1808,10121,0,0,10121,481.9524
SAN DIEGO,Oct 2013,CACF,2014,METROPOLITAN AREA ADVISORY COMMITTEE-MAAC-PROJ HEADSTART,HS_CHILD_SNACK_PM,21,1808,0,0,1808,15666,0,0,15666,746
SAN DIEGO,Nov 2013,CACF,2014,METROPOLITAN AREA ADVISORY COMMITTEE-MAAC-PROJ HEADSTART,HS_CHILD_BREAKFAST,16,1813,0,0,1813,10847,0,0,10847,677.9375
SAN DIEGO,Nov 2013,CACF,2014,METROPOLITAN AREA ADVISORY COMMITTEE-MAAC-PROJ HEADSTART,HS_CHILD_LUNCH,16,1813,0,0,1813,15806,0,0,15806,987.875
SAN DIEGO,Nov 2013,CACF,2014,METROPOLITAN AREA ADVISORY COMMITTEE-MAAC-PROJ HEADSTART,HS_CHILD_SNACK_PM,16,1813,0,0,1813,9841,0,0,9841,615.0625
SAN DIEGO,Dec 2013,CACF,2014,METROPOLITAN AREA ADVISORY COMMITTEE-MAAC-PROJ HEADSTART,HS_CHILD_BREAKFAST,13,1827,0,0,1827,10548,0,0,10548,811.3846
SAN DIEGO,Dec 2013,CACF,2014,METROPOLITAN AREA ADVISORY COMMITTEE-MAAC-PROJ HEADSTART,HS_CHILD_LUNCH,13,1827,0,0,1827,15922,0,0,15922,1224.7692
SAN DIEGO,Dec 2013,CACF,2014,METROPOLITAN AREA ADVISORY COMMITTEE-MAAC-PROJ HEADSTART,HS_CHILD_SNACK_PM,13,1827,0,0,1827,9841,0,0,9841,757
SAN DIEGO,Jan 2014,CACF,2014,METROPOLITAN AREA ADVISORY COMMITTEE-MAAC-PROJ HEADSTART,HS_CHILD_BREAKFAST,16,1820,0,0,1820,12264,0,0,12264,766.5
SAN DIEGO,Jan 2014,CACF,2014,METROPOLITAN AREA ADVISORY COMMITTEE-MAAC-PROJ HEADSTART,HS_CHILD_LUNCH,16,1820,0,0,1820,18438,0,0,18438,1152.375
SAN DIEGO,Jan 2014,CACF,2014,METROPOLITAN AREA ADVISORY COMMITTEE-MAAC-PROJ HEADSTART,HS_CHILD_SNACK_PM,16,1820,0,0,1820,11771,0,0,11771,735.6875
SAN DIEGO,Feb 2014,CACF,2014,METROPOLITAN AREA ADVISORY COMMITTEE-MAAC-PROJ HEADSTART,HS_CHILD_BREAKFAST,16,1828,0,0,1828,12839,0,0,12839,802.4375
SAN DIEGO,Feb 2014,CACF,2014,METROPOLITAN AREA ADVISORY COMMITTEE-MAAC-PROJ HEADSTART,HS_CHILD_LUNCH,16,1828,0,0,1828,19377,0,0,19377,1211.0625
SAN DIEGO,Feb 2014,CACF,2014,METROPOLITAN AREA ADVISORY COMMITTEE-MAAC-PROJ HEADSTART,HS_CHILD_SNACK_PM,16,1828,0,0,1828,12244,0,0,12244,765.25
SAN DIEGO,Mar 2014,CACF,2014,METROPOLITAN AREA ADVISORY COMMITTEE-MAAC-PROJ HEADSTART,HS_CHILD_BREAKFAST,18,1812,0,0,1812,13936,0,0,13936,774.2222
SAN DIEGO,Mar 2014,CACF,2014,METROPOLITAN AREA ADVISORY COMMITTEE-MAAC-PROJ HEADSTART,HS_CHILD_LUNCH,18,1812,0,0,1812,20985,0,0,20985,1165.8333
SAN DIEGO,Mar 2014,CACF,2014,METROPOLITAN AREA ADVISORY COMMITTEE-MAAC-PROJ HEADSTART,HS_CHILD_SNACK_PM,18,1812,0,0,1812,13315,0,0,13315,739.7222
SAN DIEGO,Apr 2014,CACF,2014,METROPOLITAN AREA ADVISORY COMMITTEE-MAAC-PROJ HEADSTART,HS_CHILD_BREAKFAST,15,1794,0,0,1794,11932,0,0,11932,795.4667
SAN DIEGO,Apr 2014,CACF,2014,METROPOLITAN AREA ADVISORY COMMITTEE-MAAC-PROJ HEADSTART,HS_CHILD_LUNCH,15,1794,0,0,1794,17993,0,0,17993,1199.5333
SAN DIEGO,Apr 2014,CACF,2014,METROPOLITAN AREA ADVISORY COMMITTEE-MAAC-PROJ HEADSTART,HS_CHILD_SNACK_PM,15,1794,0,0,1794,11060,0,0,11060,737.3333
SAN DIEGO,May 2014,CACF,2014,METROPOLITAN AREA ADVISORY COMMITTEE-MAAC-PROJ HEADSTART,HS_CHILD_BREAKFAST,19,1779,0,0,1779,10297,0,0,10297,541.9474
SAN DIEGO,May 2014,CACF,2014,METROPOLITAN AREA ADVISORY COMMITTEE-MAAC-PROJ HEADSTART,HS_CHILD_LUNCH,19,1779,0,0,1779,14897,0,0,14897,784.0526
SAN DIEGO,May 2014,CACF,2014,METROPOLITAN AREA ADVISORY COMMITTEE-MAAC-PROJ HEADSTART,HS_CHILD_SNACK_PM,19,1779,0,0,1779,9452,0,0,9452,497.4737
SAN DIEGO,Jun 2014,CACF,2014,METROPOLITAN AREA ADVISORY COMMITTEE-MAAC-PROJ HEADSTART,HS_CHILD_BREAKFAST,18,1775,0,0,1775,3391,0,0,3391,188.3889
SAN DIEGO,Jun 2014,CACF,2014,METROPOLITAN AREA ADVISORY COMMITTEE-MAAC-PROJ HEADSTART,HS_CHILD_LUNCH,18,1775,0,0,1775,3583,0,0,3583,199.0556
SAN DIEGO,Jun 2014,CACF,2014,METROPOLITAN AREA ADVISORY COMMITTEE-MAAC-PROJ HEADSTART,HS_CHILD_SNACK_PM,18,1775,0,0,1775,3013,0,0,3013,167.3889
SAN DIEGO,Jul 2014,CACF,2014,METROPOLITAN AREA ADVISORY COMMITTEE-MAAC-PROJ HEADSTART,HS_CHILD_BREAKFAST,13,206,0,0,206,491,0,0,491,37.7692
SAN DIEGO,Jul 2014,CACF,2014,METROPOLITAN AREA ADVISORY COMMITTEE-MAAC-PROJ HEADSTART,HS_CHILD_LUNCH,13,206,0,0,206,531,0,0,531,40.8462
SAN DIEGO,Jul 2014,CACF,2014,METROPOLITAN AREA ADVISORY COMMITTEE-MAAC-PROJ HEADSTART,HS_CHILD_SNACK_PM,13,206,0,0,206,391,0,0,391,30.0769
SAN DIEGO,Aug 2014,CACF,2014,METROPOLITAN AREA ADVISORY COMMITTEE-MAAC-PROJ HEADSTART,HS_CHILD_BREAKFAST,20,277,0,0,277,1635,0,0,1635,81.75
SAN DIEGO,Aug 2014,CACF,2014,METROPOLITAN AREA ADVISORY COMMITTEE-MAAC-PROJ HEADSTART,HS_CHILD_LUNCH,20,277,0,0,277,1687,0,0,1687,84.35
SAN DIEGO,Aug 2014,CACF,2014,METROPOLITAN AREA ADVISORY COMMITTEE-MAAC-PROJ HEADSTART,HS_CHILD_SNACK_PM,20,277,0,0,277,1412,0,0,1412,70.6
SAN DIEGO,Sep 2014,CACF,2014,METROPOLITAN AREA ADVISORY COMMITTEE-MAAC-PROJ HEADSTART,HS_CHILD_BREAKFAST,18,1802,0,0,1802,8896,0,0,8896,494.2222
SAN DIEGO,Sep 2014,CACF,2014,METROPOLITAN AREA ADVISORY COMMITTEE-MAAC-PROJ HEADSTART,HS_CHILD_LUNCH,18,1802,0,0,1802,12859,0,0,12859,714.3889
SAN DIEGO,Sep 2014,CACF,2014,METROPOLITAN AREA ADVISORY COMMITTEE-MAAC-PROJ HEADSTART,HS_CHILD_SNACK_PM,18,1802,0,0,1802,7946,0,0,7946,441.4444
SAN DIEGO,Oct 2013,CACF,2014,"Navy Region Southwest, Child and Youth Programs",ATRISK_CHILD_SNACK,22,627,0,0,627,13369,0,0,13369,607.6818
SAN DIEGO,Oct 2013,CACF,2014,"Navy Region Southwest, Child and Youth Programs",CHILD_BREAKFAST,22,104,202,2184,2490,1686,3270,35370,40326,1833
SAN DIEGO,Oct 2013,CACF,2014,"Navy Region Southwest, Child and Youth Programs",CHILD_LUNCH,22,104,202,2184,2490,1947,3778,40864,46589,2117.6818
SAN DIEGO,Oct 2013,CACF,2014,"Navy Region Southwest, Child and Youth Programs",CHILD_SNACK_PM,22,104,202,2184,2490,1824,3540,38283,43647,1983.9545
SAN DIEGO,Oct 2013,DCH,2014,"Navy Region Southwest, Child and Youth Programs",DCH_BREAKFAST,24,0,0,0,0,5246,0,0,5246,218.5833
SAN DIEGO,Oct 2013,DCH,2014,"Navy Region Southwest, Child and Youth Programs",DCH_BREAKFAST,,0,0,0,0,0,20,423,443,0
SAN DIEGO,Oct 2013,DCH,2014,"Navy Region Southwest, Child and Youth Programs",DCH_BREAKFAST,22,0,0,0,0,0,0,0,0,0
SAN DIEGO,Oct 2013,DCH,2014,"Navy Region Southwest, Child and Youth Programs",DCH_BREAKFAST,22,0,0,0,0,0,0,0,0,0
SAN DIEGO,Oct 2013,DCH,2014,"Navy Region Southwest, Child and Youth Programs",DCH_LUNCH,24,0,0,0,0,5919,0,0,5919,246.625
SAN DIEGO,Oct 2013,DCH,2014,"Navy Region Southwest, Child and Youth Programs",DCH_LUNCH,,0,0,0,0,0,20,512,532,0
SAN DIEGO,Oct 2013,DCH,2014,"Navy Region Southwest, Child and Youth Programs",DCH_LUNCH,22,0,0,0,0,0,0,0,0,0
SAN DIEGO,Oct 2013,DCH,2014,"Navy Region Southwest, Child and Youth Programs",DCH_LUNCH,22,0,0,0,0,0,0,0,0,0
SAN DIEGO,Oct 2013,DCH,2014,"Navy Region Southwest, Child and Youth Programs",DCH_SNACK_AM,24,0,0,0,0,3547,0,0,3547,147.7917
SAN DIEGO,Oct 2013,DCH,2014,"Navy Region Southwest, Child and Youth Programs",DCH_SNACK_AM,,0,0,0,0,0,2,388,390,0
SAN DIEGO,Oct 2013,DCH,2014,"Navy Region Southwest, Child and Youth Programs",DCH_SNACK_AM,22,0,0,0,0,0,0,0,0,0
SAN DIEGO,Oct 2013,DCH,2014,"Navy Region Southwest, Child and Youth Programs",DCH_SNACK_AM,22,0,0,0,0,0,0,0,0,0
SAN DIEGO,Oct 2013,DCH,2014,"Navy Region Southwest, Child and Youth Programs",DCH_SNACK_NT,24,0,0,0,0,4,0,0,4,0.1667
SAN DIEGO,Oct 2013,DCH,2014,"Navy Region Southwest, Child and Youth Programs",DCH_SNACK_NT,22,0,0,0,0,0,0,0,0,0
SAN DIEGO,Oct 2013,DCH,2014,"Navy Region Southwest, Child and Youth Programs",DCH_SNACK_NT,22,0,0,0,0,0,0,0,0,0
SAN DIEGO,Oct 2013,DCH,2014,"Navy Region Southwest, Child and Youth Programs",DCH_SNACK_PM,24,0,0,0,0,3333,0,0,3333,138.875
SAN DIEGO,Oct 2013,DCH,2014,"Navy Region Southwest, Child and Youth Programs",DCH_SNACK_PM,,0,0,0,0,0,21,229,250,0
SAN DIEGO,Oct 2013,DCH,2014,"Navy Region Southwest, Child and Youth Programs",DCH_SNACK_PM,22,0,0,0,0,0,0,0,0,0
SAN DIEGO,Oct 2013,DCH,2014,"Navy Region Southwest, Child and Youth Programs",DCH_SNACK_PM,22,0,0,0,0,0,0,0,0,0
SAN DIEGO,Oct 2013,DCH,2014,"Navy Region Southwest, Child and Youth Programs",DCH_SUPPER,24,0,0,0,0,117,0,0,117,4.875
SAN DIEGO,Oct 2013,DCH,2014,"Navy Region Southwest, Child and Youth Programs",DCH_SUPPER,22,0,0,0,0,0,0,0,0,0
SAN DIEGO,Oct 2013,DCH,2014,"Navy Region Southwest, Child and Youth Programs",DCH_SUPPER,22,0,0,0,0,0,0,0,0,0
SAN DIEGO,Oct 2013,CACF,2014,"Navy Region Southwest, Child and Youth Programs",OSCH_CHILD_BREAKFAST,22,3,11,83,97,2,8,58,68,3.0909
SAN DIEGO,Oct 2013,CACF,2014,"Navy Region Southwest, Child and Youth Programs",OSCH_CHILD_LUNCH,22,3,11,83,97,6,20,154,180,8.1818
SAN DIEGO,Oct 2013,CACF,2014,"Navy Region Southwest, Child and Youth Programs",OSCH_CHILD_SNACK_PM,22,3,11,83,97,55,202,1524,1781,80.9545
SAN DIEGO,Nov 2013,CACF,2014,"Navy Region Southwest, Child and Youth Programs",ATRISK_CHILD_LUNCH,19,512,0,0,512,43,0,0,43,2.2632
SAN DIEGO,Nov 2013,CACF,2014,"Navy Region Southwest, Child and Youth Programs",ATRISK_CHILD_SNACK,19,512,0,0,512,9305,0,0,9305,489.7368
SAN DIEGO,Nov 2013,CACF,2014,"Navy Region Southwest, Child and Youth Programs",CHILD_BREAKFAST,19,104,202,2184,2490,1388,2693,29128,33209,1747.8421
SAN DIEGO,Nov 2013,CACF,2014,"Navy Region Southwest, Child and Youth Programs",CHILD_LUNCH,19,104,202,2184,2490,1577,3060,33093,37730,1985.7895
SAN DIEGO,Nov 2013,CACF,2014,"Navy Region Southwest, Child and Youth Programs",CHILD_SNACK_PM,19,104,202,2184,2490,1438,2790,30178,34406,1810.8421
SAN DIEGO,Nov 2013,DCH,2014,"Navy Region Southwest, Child and Youth Programs",DCH_BREAKFAST,21,0,0,0,0,4385,0,0,4385,208.8095
SAN DIEGO,Nov 2013,DCH,2014,"Navy Region Southwest, Child and Youth Programs",DCH_BREAKFAST,,0,0,0,0,0,18,380,398,0
SAN DIEGO,Nov 2013,DCH,2014,"Navy Region Southwest, Child and Youth Programs",DCH_BREAKFAST,19,0,0,0,0,0,0,0,0,0
SAN DIEGO,Nov 2013,DCH,2014,"Navy Region Southwest, Child and Youth Programs",DCH_BREAKFAST,18,0,0,0,0,0,0,0,0,0
SAN DIEGO,Nov 2013,DCH,2014,"Navy Region Southwest, Child and Youth Programs",DCH_LUNCH,21,0,0,0,0,4916,0,0,4916,234.0952
SAN DIEGO,Nov 2013,DCH,2014,"Navy Region Southwest, Child and Youth Programs",DCH_LUNCH,,0,0,0,0,0,17,427,444,0
SAN DIEGO,Nov 2013,DCH,2014,"Navy Region Southwest, Child and Youth Programs",DCH_LUNCH,19,0,0,0,0,0,0,0,0,0
SAN DIEGO,Nov 2013,DCH,2014,"Navy Region Southwest, Child and Youth Programs",DCH_LUNCH,18,0,0,0,0,0,0,0,0,0
SAN DIEGO,Nov 2013,DCH,2014,"Navy Region Southwest, Child and Youth Programs",DCH_SNACK_AM,21,0,0,0,0,2980,0,0,2980,141.9048
SAN DIEGO,Nov 2013,DCH,2014,"Navy Region Southwest, Child and Youth Programs",DCH_SNACK_AM,,0,0,0,0,0,1,345,346,0
SAN DIEGO,Nov 2013,DCH,2014,"Navy Region Southwest, Child and Youth Programs",DCH_SNACK_AM,19,0,0,0,0,0,0,0,0,0
SAN DIEGO,Nov 2013,DCH,2014,"Navy Region Southwest, Child and Youth Programs",DCH_SNACK_AM,18,0,0,0,0,0,0,0,0,0
SAN DIEGO,Nov 2013,DCH,2014,"Navy Region Southwest, Child and Youth Programs",DCH_SNACK_NT,21,0,0,0,0,4,0,0,4,0.1905
SAN DIEGO,Nov 2013,DCH,2014,"Navy Region Southwest, Child and Youth Programs",DCH_SNACK_NT,19,0,0,0,0,0,0,0,0,0
SAN DIEGO,Nov 2013,DCH,2014,"Navy Region Southwest, Child and Youth Programs",DCH_SNACK_NT,18,0,0,0,0,0,0,0,0,0
SAN DIEGO,Nov 2013,DCH,2014,"Navy Region Southwest, Child and Youth Programs",DCH_SNACK_PM,21,0,0,0,0,2806,0,0,2806,133.619
SAN DIEGO,Nov 2013,DCH,2014,"Navy Region Southwest, Child and Youth Programs",DCH_SNACK_PM,,0,0,0,0,0,18,162,180,0
SAN DIEGO,Nov 2013,DCH,2014,"Navy Region Southwest, Child and Youth Programs",DCH_SNACK_PM,19,0,0,0,0,0,0,0,0,0
SAN DIEGO,Nov 2013,DCH,2014,"Navy Region Southwest, Child and Youth Programs",DCH_SNACK_PM,18,0,0,0,0,0,0,0,0,0
SAN DIEGO,Nov 2013,DCH,2014,"Navy Region Southwest, Child and Youth Programs",DCH_SUPPER,21,0,0,0,0,91,0,0,91,4.3333
SAN DIEGO,Nov 2013,DCH,2014,"Navy Region Southwest, Child and Youth Programs",DCH_SUPPER,19,0,0,0,0,0,0,0,0,0
SAN DIEGO,Nov 2013,DCH,2014,"Navy Region Southwest, Child and Youth Programs",DCH_SUPPER,18,0,0,0,0,0,0,0,0,0
SAN DIEGO,Nov 2013,CACF,2014,"Navy Region Southwest, Child and Youth Programs",OSCH_CHILD_BREAKFAST,19,3,11,83,97,3,11,80,94,4.9474
SAN DIEGO,Nov 2013,CACF,2014,"Navy Region Southwest, Child and Youth Programs",OSCH_CHILD_LUNCH,19,3,11,83,97,5,17,125,147,7.7368
SAN DIEGO,Nov 2013,CACF,2014,"Navy Region Southwest, Child and Youth Programs",OSCH_CHILD_SNACK_PM,19,3,11,83,97,42,154,1164,1360,71.5789
SAN DIEGO,Dec 2013,CACF,2014,"Navy Region Southwest, Child and Youth Programs",ATRISK_CHILD_LUNCH,21,481,0,0,481,73,0,0,73,3.4762
SAN DIEGO,Dec 2013,CACF,2014,"Navy Region Southwest, Child and Youth Programs",ATRISK_CHILD_SNACK,21,481,0,0,481,9584,0,0,9584,456.381
SAN DIEGO,Dec 2013,CACF,2014,"Navy Region Southwest, Child and Youth Programs",CHILD_BREAKFAST,21,104,202,2184,2490,1206,2340,25308,28854,1374
SAN DIEGO,Dec 2013,CACF,2014,"Navy Region Southwest, Child and Youth Programs",CHILD_LUNCH,21,104,202,2184,2490,1401,2719,29402,33522,1596.2857
SAN DIEGO,Dec 2013,CACF,2014,"Navy Region Southwest, Child and Youth Programs",CHILD_SNACK_PM,21,104,202,2184,2490,1282,2487,26902,30671,1460.5238
SAN DIEGO,Dec 2013,DCH,2014,"Navy Region Southwest, Child and Youth Programs",DCH_BREAKFAST,21,0,0,0,0,3851,0,0,3851,183.381
SAN DIEGO,Dec 2013,DCH,2014,"Navy Region Southwest, Child and Youth Programs",DCH_BREAKFAST,,0,0,0,0,0,10,274,284,0
SAN DIEGO,Dec 2013,DCH,2014,"Navy Region Southwest, Child and Youth Programs",DCH_BREAKFAST,21,0,0,0,0,0,0,0,0,0
SAN DIEGO,Dec 2013,DCH,2014,"Navy Region Southwest, Child and Youth Programs",DCH_BREAKFAST,18,0,0,0,0,0,0,0,0,0
SAN DIEGO,Dec 2013,DCH,2014,"Navy Region Southwest, Child and Youth Programs",DCH_LUNCH,21,0,0,0,0,4535,0,0,4535,215.9524
SAN DIEGO,Dec 2013,DCH,2014,"Navy Region Southwest, Child and Youth Programs",DCH_LUNCH,,0,0,0,0,0,10,357,367,0
SAN DIEGO,Dec 2013,DCH,2014,"Navy Region Southwest, Child and Youth Programs",DCH_LUNCH,21,0,0,0,0,0,0,0,0,0
SAN DIEGO,Dec 2013,DCH,2014,"Navy Region Southwest, Child and Youth Programs",DCH_LUNCH,18,0,0,0,0,0,0,0,0,0
SAN DIEGO,Dec 2013,DCH,2014,"Navy Region Southwest, Child and Youth Programs",DCH_SNACK_AM,21,0,0,0,0,2637,0,0,2637,125.5714
SAN DIEGO,Dec 2013,DCH,2014,"Navy Region Southwest, Child and Youth Programs",DCH_SNACK_AM,,0,0,0,0,0,0,258,258,0
SAN DIEGO,Dec 2013,DCH,2014,"Navy Region Southwest, Child and Youth Programs",DCH_SNACK_AM,21,0,0,0,0,0,0,0,0,0
SAN DIEGO,Dec 2013,DCH,2014,"Navy Region Southwest, Child and Youth Programs",DCH_SNACK_AM,18,0,0,0,0,0,0,0,0,0
SAN DIEGO,Dec 2013,DCH,2014,"Navy Region Southwest, Child and Youth Programs",DCH_SNACK_NT,21,0,0,0,0,9,0,0,9,0.4286
SAN DIEGO,Dec 2013,DCH,2014,"Navy Region Southwest, Child and Youth Programs",DCH_SNACK_NT,21,0,0,0,0,0,0,0,0,0
SAN DIEGO,Dec 2013,DCH,2014,"Navy Region Southwest, Child and Youth Programs",DCH_SNACK_NT,18,0,0,0,0,0,0,0,0,0
SAN DIEGO,Dec 2013,DCH,2014,"Navy Region Southwest, Child and Youth Programs",DCH_SNACK_PM,21,0,0,0,0,2689,0,0,2689,128.0476
SAN DIEGO,Dec 2013,DCH,2014,"Navy Region Southwest, Child and Youth Programs",DCH_SNACK_PM,,0,0,0,0,0,10,195,205,0
SAN DIEGO,Dec 2013,DCH,2014,"Navy Region Southwest, Child and Youth Programs",DCH_SNACK_PM,21,0,0,0,0,0,0,0,0,0
SAN DIEGO,Dec 2013,DCH,2014,"Navy Region Southwest, Child and Youth Programs",DCH_SNACK_PM,18,0,0,0,0,0,0,0,0,0
SAN DIEGO,Dec 2013,DCH,2014,"Navy Region Southwest, Child and Youth Programs",DCH_SUPPER,21,0,0,0,0,72,0,0,72,3.4286
SAN DIEGO,Dec 2013,DCH,2014,"Navy Region Southwest, Child and Youth Programs",DCH_SUPPER,21,0,0,0,0,0,0,0,0,0
SAN DIEGO,Dec 2013,DCH,2014,"Navy Region Southwest, Child and Youth Programs",DCH_SUPPER,18,0,0,0,0,0,0,0,0,0
SAN DIEGO,Dec 2013,CACF,2014,"Navy Region Southwest, Child and Youth Programs",OSCH_CHILD_BREAKFAST,21,3,11,83,97,2,7,49,58,2.7619
SAN DIEGO,Dec 2013,CACF,2014,"Navy Region Southwest, Child and Youth Programs",OSCH_CHILD_LUNCH,21,3,11,83,97,3,9,71,83,3.9524
SAN DIEGO,Dec 2013,CACF,2014,"Navy Region Southwest, Child and Youth Programs",OSCH_CHILD_SNACK_PM,21,3,11,83,97,36,133,1007,1176,56
SAN DIEGO,Jan 2014,CACF,2014,"Navy Region Southwest, Child and Youth Programs",ATRISK_CHILD_LUNCH,21,3291,0,0,3291,19,0,0,19,0.9048
SAN DIEGO,Jan 2014,CACF,2014,"Navy Region Southwest, Child and Youth Programs",ATRISK_CHILD_SNACK,21,3291,0,0,3291,10570,0,0,10570,503.3333
SAN DIEGO,Jan 2014,CACF,2014,"Navy Region Southwest, Child and Youth Programs",CHILD_BREAKFAST,21,104,202,2184,2490,1524,2957,31985,36466,1736.4762
SAN DIEGO,Jan 2014,CACF,2014,"Navy Region Southwest, Child and Youth Programs",CHILD_LUNCH,21,104,202,2184,2490,1771,3436,37160,42367,2017.4762
SAN DIEGO,Jan 2014,CACF,2014,"Navy Region Southwest, Child and Youth Programs",CHILD_SNACK_PM,21,104,202,2184,2490,1628,3159,34169,38956,1855.0476
SAN DIEGO,Jan 2014,DCH,2014,"Navy Region Southwest, Child and Youth Programs",DCH_BREAKFAST,23,0,0,0,0,4671,0,0,4671,203.087
SAN DIEGO,Jan 2014,DCH,2014,"Navy Region Southwest, Child and Youth Programs",DCH_BREAKFAST,,0,0,0,0,0,15,380,395,0
SAN DIEGO,Jan 2014,DCH,2014,"Navy Region Southwest, Child and Youth Programs",DCH_BREAKFAST,23,0,0,0,0,0,0,0,0,0
SAN DIEGO,Jan 2014,DCH,2014,"Navy Region Southwest, Child and Youth Programs",DCH_BREAKFAST,19,0,0,0,0,0,0,0,0,0
SAN DIEGO,Jan 2014,DCH,2014,"Navy Region Southwest, Child and Youth Programs",DCH_LUNCH,23,0,0,0,0,5381,0,0,5381,233.9565
SAN DIEGO,Jan 2014,DCH,2014,"Navy Region Southwest, Child and Youth Programs",DCH_LUNCH,,0,0,0,0,0,18,464,482,0
SAN DIEGO,Jan 2014,DCH,2014,"Navy Region Southwest, Child and Youth Programs",DCH_LUNCH,23,0,0,0,0,0,0,0,0,0
SAN DIEGO,Jan 2014,DCH,2014,"Navy Region Southwest, Child and Youth Programs",DCH_LUNCH,19,0,0,0,0,0,0,0,0,0
SAN DIEGO,Jan 2014,DCH,2014,"Navy Region Southwest, Child and Youth Programs",DCH_SNACK_AM,23,0,0,0,0,2938,0,0,2938,127.7391
SAN DIEGO,Jan 2014,DCH,2014,"Navy Region Southwest, Child and Youth Programs",DCH_SNACK_AM,,0,0,0,0,0,3,363,366,0
SAN DIEGO,Jan 2014,DCH,2014,"Navy Region Southwest, Child and Youth Programs",DCH_SNACK_AM,23,0,0,0,0,0,0,0,0,0
SAN DIEGO,Jan 2014,DCH,2014,"Navy Region Southwest, Child and Youth Programs",DCH_SNACK_AM,19,0,0,0,0,0,0,0,0,0
SAN DIEGO,Jan 2014,DCH,2014,"Navy Region Southwest, Child and Youth Programs",DCH_SNACK_NT,23,0,0,0,0,1,0,0,1,0.0435
SAN DIEGO,Jan 2014,DCH,2014,"Navy Region Southwest, Child and Youth Programs",DCH_SNACK_NT,23,0,0,0,0,0,0,0,0,0
SAN DIEGO,Jan 2014,DCH,2014,"Navy Region Southwest, Child and Youth Programs",DCH_SNACK_NT,19,0,0,0,0,0,0,0,0,0
SAN DIEGO,Jan 2014,DCH,2014,"Navy Region Southwest, Child and Youth Programs",DCH_SNACK_PM,23,0,0,0,0,3164,0,0,3164,137.5652
SAN DIEGO,Jan 2014,DCH,2014,"Navy Region Southwest, Child and Youth Programs",DCH_SNACK_PM,,0,0,0,0,0,18,196,214,0
SAN DIEGO,Jan 2014,DCH,2014,"Navy Region Southwest, Child and Youth Programs",DCH_SNACK_PM,23,0,0,0,0,0,0,0,0,0
SAN DIEGO,Jan 2014,DCH,2014,"Navy Region Southwest, Child and Youth Programs",DCH_SNACK_PM,19,0,0,0,0,0,0,0,0,0
SAN DIEGO,Jan 2014,DCH,2014,"Navy Region Southwest, Child and Youth Programs",DCH_SUPPER,23,0,0,0,0,73,0,0,73,3.1739
SAN DIEGO,Jan 2014,DCH,2014,"Navy Region Southwest, Child and Youth Programs",DCH_SUPPER,23,0,0,0,0,0,0,0,0,0
SAN DIEGO,Jan 2014,DCH,2014,"Navy Region Southwest, Child and Youth Programs",DCH_SUPPER,19,0,0,0,0,0,0,0,0,0
SAN DIEGO,Jan 2014,CACF,2014,"Navy Region Southwest, Child and Youth Programs",OSCH_CHILD_BREAKFAST,21,3,11,83,97,1,4,30,35,1.6667
SAN DIEGO,Jan 2014,CACF,2014,"Navy Region Southwest, Child and Youth Programs",OSCH_CHILD_LUNCH,21,3,11,83,97,2,8,59,69,3.2857
SAN DIEGO,Jan 2014,CACF,2014,"Navy Region Southwest, Child and Youth Programs",OSCH_CHILD_SNACK_PM,21,3,11,83,97,51,187,1414,1652,78.6667
SAN DIEGO,Feb 2014,CACF,2014,"Navy Region Southwest, Child and Youth Programs",ATRISK_CHILD_LUNCH,19,610,0,0,610,17,0,0,17,0.8947
SAN DIEGO,Feb 2014,CACF,2014,"Navy Region Southwest, Child and Youth Programs",ATRISK_CHILD_SNACK,19,610,0,0,610,11291,0,0,11291,594.2632
SAN DIEGO,Feb 2014,CACF,2014,"Navy Region Southwest, Child and Youth Programs",CHILD_BREAKFAST,19,104,202,2184,2490,1457,2827,30570,34854,1834.4211
SAN DIEGO,Feb 2014,CACF,2014,"Navy Region Southwest, Child and Youth Programs",CHILD_LUNCH,19,104,202,2184,2490,1698,3295,35631,40624,2138.1053
SAN DIEGO,Feb 2014,CACF,2014,"Navy Region Southwest, Child and Youth Programs",CHILD_SNACK_PM,19,104,202,2184,2490,1550,3007,32526,37083,1951.7368
SAN DIEGO,Feb 2014,DCH,2014,"Navy Region Southwest, Child and Youth Programs",DCH_BREAKFAST,20,0,0,0,0,4502,0,0,4502,225.1
SAN DIEGO,Feb 2014,DCH,2014,"Navy Region Southwest, Child and Youth Programs",DCH_BREAKFAST,,0,0,0,0,0,15,329,344,0
SAN DIEGO,Feb 2014,DCH,2014,"Navy Region Southwest, Child and Youth Programs",DCH_BREAKFAST,19,0,0,0,0,0,0,0,0,0
SAN DIEGO,Feb 2014,DCH,2014,"Navy Region Southwest, Child and Youth Programs",DCH_BREAKFAST,19,0,0,0,0,0,0,0,0,0
SAN DIEGO,Feb 2014,DCH,2014,"Navy Region Southwest, Child and Youth Programs",DCH_LUNCH,20,0,0,0,0,5148,0,0,5148,257.4
SAN DIEGO,Feb 2014,DCH,2014,"Navy Region Southwest, Child and Youth Programs",DCH_LUNCH,,0,0,0,0,0,15,447,462,0
SAN DIEGO,Feb 2014,DCH,2014,"Navy Region Southwest, Child and Youth Programs",DCH_LUNCH,19,0,0,0,0,0,0,0,0,0
SAN DIEGO,Feb 2014,DCH,2014,"Navy Region Southwest, Child and Youth Programs",DCH_LUNCH,19,0,0,0,0,0,0,0,0,0
SAN DIEGO,Feb 2014,DCH,2014,"Navy Region Southwest, Child and Youth Programs",DCH_SNACK_AM,20,0,0,0,0,3008,0,0,3008,150.4
SAN DIEGO,Feb 2014,DCH,2014,"Navy Region Southwest, Child and Youth Programs",DCH_SNACK_AM,,0,0,0,0,0,13,417,430,0
SAN DIEGO,Feb 2014,DCH,2014,"Navy Region Southwest, Child and Youth Programs",DCH_SNACK_AM,19,0,0,0,0,0,0,0,0,0
SAN DIEGO,Feb 2014,DCH,2014,"Navy Region Southwest, Child and Youth Programs",DCH_SNACK_AM,19,0,0,0,0,0,0,0,0,0
SAN DIEGO,Feb 2014,DCH,2014,"Navy Region Southwest, Child and Youth Programs",DCH_SNACK_PM,20,0,0,0,0,3052,0,0,3052,152.6
SAN DIEGO,Feb 2014,DCH,2014,"Navy Region Southwest, Child and Youth Programs",DCH_SNACK_PM,,0,0,0,0,0,2,182,184,0
SAN DIEGO,Feb 2014,DCH,2014,"Navy Region Southwest, Child and Youth Programs",DCH_SNACK_PM,19,0,0,0,0,0,0,0,0,0
SAN DIEGO,Feb 2014,DCH,2014,"Navy Region Southwest, Child and Youth Programs",DCH_SNACK_PM,19,0,0,0,0,0,0,0,0,0
SAN DIEGO,Feb 2014,DCH,2014,"Navy Region Southwest, Child and Youth Programs",DCH_SUPPER,20,0,0,0,0,105,0,0,105,5.25
SAN DIEGO,Feb 2014,DCH,2014,"Navy Region Southwest, Child and Youth Programs",DCH_SUPPER,19,0,0,0,0,0,0,0,0,0
SAN DIEGO,Feb 2014,DCH,2014,"Navy Region Southwest, Child and Youth Programs",DCH_SUPPER,19,0,0,0,0,0,0,0,0,0
SAN DIEGO,Feb 2014,CACF,2014,"Navy Region Southwest, Child and Youth Programs",OSCH_CHILD_BREAKFAST,19,3,11,83,97,1,3,19,23,1.2105
SAN DIEGO,Feb 2014,CACF,2014,"Navy Region Southwest, Child and Youth Programs",OSCH_CHILD_LUNCH,19,3,11,83,97,2,6,42,50,2.6316
SAN DIEGO,Feb 2014,CACF,2014,"Navy Region Southwest, Child and Youth Programs",OSCH_CHILD_SNACK_PM,19,3,11,83,97,44,163,1227,1434,75.4737
SAN DIEGO,Mar 2014,CACF,2014,"Navy Region Southwest, Child and Youth Programs",ATRISK_CHILD_SNACK,21,576,0,0,576,11671,0,0,11671,555.7619
SAN DIEGO,Mar 2014,CACF,2014,"Navy Region Southwest, Child and Youth Programs",CHILD_BREAKFAST,21,104,202,2184,2490,1634,3169,34278,39081,1861
SAN DIEGO,Mar 2014,CACF,2014,"Navy Region Southwest, Child and Youth Programs",CHILD_LUNCH,21,104,202,2184,2490,1918,3721,40237,45876,2184.5714
SAN DIEGO,Mar 2014,CACF,2014,"Navy Region Southwest, Child and Youth Programs",CHILD_SNACK_PM,21,104,202,2184,2490,1785,3463,37458,42706,2033.619
SAN DIEGO,Mar 2014,DCH,2014,"Navy Region Southwest, Child and Youth Programs",DCH_BREAKFAST,21,0,0,0,0,4929,0,0,4929,234.7143
SAN DIEGO,Mar 2014,DCH,2014,"Navy Region Southwest, Child and Youth Programs",DCH_BREAKFAST,,0,0,0,0,0,17,290,307,0
SAN DIEGO,Mar 2014,DCH,2014,"Navy Region Southwest, Child and Youth Programs",DCH_BREAKFAST,21,0,0,0,0,0,0,0,0,0
SAN DIEGO,Mar 2014,DCH,2014,"Navy Region Southwest, Child and Youth Programs",DCH_BREAKFAST,21,0,0,0,0,0,0,0,0,0
SAN DIEGO,Mar 2014,DCH,2014,"Navy Region Southwest, Child and Youth Programs",DCH_LUNCH,21,0,0,0,0,5668,0,0,5668,269.9048
SAN DIEGO,Mar 2014,DCH,2014,"Navy Region Southwest, Child and Youth Programs",DCH_LUNCH,,0,0,0,0,0,19,454,473,0
SAN DIEGO,Mar 2014,DCH,2014,"Navy Region Southwest, Child and Youth Programs",DCH_LUNCH,21,0,0,0,0,0,0,0,0,0
SAN DIEGO,Mar 2014,DCH,2014,"Navy Region Southwest, Child and Youth Programs",DCH_LUNCH,21,0,0,0,0,0,0,0,0,0
SAN DIEGO,Mar 2014,DCH,2014,"Navy Region Southwest, Child and Youth Programs",DCH_SNACK_AM,21,0,0,0,0,3117,0,0,3117,148.4286
SAN DIEGO,Mar 2014,DCH,2014,"Navy Region Southwest, Child and Youth Programs",DCH_SNACK_AM,,0,0,0,0,0,18,419,437,0
SAN DIEGO,Mar 2014,DCH,2014,"Navy Region Southwest, Child and Youth Programs",DCH_SNACK_AM,21,0,0,0,0,0,0,0,0,0
SAN DIEGO,Mar 2014,DCH,2014,"Navy Region Southwest, Child and Youth Programs",DCH_SNACK_AM,21,0,0,0,0,0,0,0,0,0
SAN DIEGO,Mar 2014,DCH,2014,"Navy Region Southwest, Child and Youth Programs",DCH_SNACK_NT,21,0,0,0,0,1,0,0,1,0.0476
SAN DIEGO,Mar 2014,DCH,2014,"Navy Region Southwest, Child and Youth Programs",DCH_SNACK_NT,21,0,0,0,0,0,0,0,0,0
SAN DIEGO,Mar 2014,DCH,2014,"Navy Region Southwest, Child and Youth Programs",DCH_SNACK_NT,21,0,0,0,0,0,0,0,0,0
SAN DIEGO,Mar 2014,DCH,2014,"Navy Region Southwest, Child and Youth Programs",DCH_SNACK_PM,21,0,0,0,0,3630,0,0,3630,172.8571
SAN DIEGO,Mar 2014,DCH,2014,"Navy Region Southwest, Child and Youth Programs",DCH_SNACK_PM,,0,0,0,0,0,2,226,228,0
SAN DIEGO,Mar 2014,DCH,2014,"Navy Region Southwest, Child and Youth Programs",DCH_SNACK_PM,21,0,0,0,0,0,0,0,0,0
SAN DIEGO,Mar 2014,DCH,2014,"Navy Region Southwest, Child and Youth Programs",DCH_SNACK_PM,21,0,0,0,0,0,0,0,0,0
SAN DIEGO,Mar 2014,DCH,2014,"Navy Region Southwest, Child and Youth Programs",DCH_SUPPER,21,0,0,0,0,110,0,0,110,5.2381
SAN DIEGO,Mar 2014,DCH,2014,"Navy Region Southwest, Child and Youth Programs",DCH_SUPPER,21,0,0,0,0,0,0,0,0,0
SAN DIEGO,Mar 2014,DCH,2014,"Navy Region Southwest, Child and Youth Programs",DCH_SUPPER,21,0,0,0,0,0,0,0,0,0
SAN DIEGO,Mar 2014,CACF,2014,"Navy Region Southwest, Child and Youth Programs",OSCH_CHILD_BREAKFAST,21,3,11,83,97,2,6,49,57,2.7143
SAN DIEGO,Mar 2014,CACF,2014,"Navy Region Southwest, Child and Youth Programs",OSCH_CHILD_LUNCH,21,3,11,83,97,6,20,152,178,8.4762
SAN DIEGO,Mar 2014,CACF,2014,"Navy Region Southwest, Child and Youth Programs",OSCH_CHILD_SNACK_PM,21,3,11,83,97,42,153,1157,1352,64.381
SAN DIEGO,Apr 2014,CACF,2014,"Navy Region Southwest, Child and Youth Programs",ATRISK_CHILD_LUNCH,22,501,0,0,501,85,0,0,85,3.8636
SAN DIEGO,Apr 2014,CACF,2014,"Navy Region Southwest, Child and Youth Programs",ATRISK_CHILD_SNACK,22,501,0,0,501,9627,0,0,9627,437.5909
SAN DIEGO,Apr 2014,CACF,2014,"Navy Region Southwest, Child and Youth Programs",CHILD_BREAKFAST,22,104,202,2184,2490,1683,3265,35309,40257,1829.8636
SAN DIEGO,Apr 2014,CACF,2014,"Navy Region Southwest, Child and Youth Programs",CHILD_LUNCH,22,104,202,2184,2490,2005,3889,42065,47959,2179.9545
SAN DIEGO,Apr 2014,CACF,2014,"Navy Region Southwest, Child and Youth Programs",CHILD_SNACK_PM,22,104,202,2184,2490,1847,3584,38763,44194,2008.8182
SAN DIEGO,Apr 2014,DCH,2014,"Navy Region Southwest, Child and Youth Programs",DCH_BREAKFAST,22,0,0,0,0,5157,0,0,5157,234.4091
SAN DIEGO,Apr 2014,DCH,2014,"Navy Region Southwest, Child and Youth Programs",DCH_BREAKFAST,,0,0,0,0,0,20,402,422,0
SAN DIEGO,Apr 2014,DCH,2014,"Navy Region Southwest, Child and Youth Programs",DCH_BREAKFAST,22,0,0,0,0,0,0,0,0,0
SAN DIEGO,Apr 2014,DCH,2014,"Navy Region Southwest, Child and Youth Programs",DCH_BREAKFAST,22,0,0,0,0,0,0,0,0,0
SAN DIEGO,Apr 2014,DCH,2014,"Navy Region Southwest, Child and Youth Programs",DCH_LUNCH,22,0,0,0,0,5811,0,0,5811,264.1364
SAN DIEGO,Apr 2014,DCH,2014,"Navy Region Southwest, Child and Youth Programs",DCH_LUNCH,,0,0,0,0,0,21,513,534,0
SAN DIEGO,Apr 2014,DCH,2014,"Navy Region Southwest, Child and Youth Programs",DCH_LUNCH,22,0,0,0,0,0,0,0,0,0
SAN DIEGO,Apr 2014,DCH,2014,"Navy Region Southwest, Child and Youth Programs",DCH_LUNCH,22,0,0,0,0,0,0,0,0,0
SAN DIEGO,Apr 2014,DCH,2014,"Navy Region Southwest, Child and Youth Programs",DCH_SNACK_AM,22,0,0,0,0,3012,0,0,3012,136.9091
SAN DIEGO,Apr 2014,DCH,2014,"Navy Region Southwest, Child and Youth Programs",DCH_SNACK_AM,,0,0,0,0,0,20,466,486,0
SAN DIEGO,Apr 2014,DCH,2014,"Navy Region Southwest, Child and Youth Programs",DCH_SNACK_AM,22,0,0,0,0,0,0,0,0,0
SAN DIEGO,Apr 2014,DCH,2014,"Navy Region Southwest, Child and Youth Programs",DCH_SNACK_AM,22,0,0,0,0,0,0,0,0,0
SAN DIEGO,Apr 2014,DCH,2014,"Navy Region Southwest, Child and Youth Programs",DCH_SNACK_NT,22,0,0,0,0,4,0,0,4,0.1818
SAN DIEGO,Apr 2014,DCH,2014,"Navy Region Southwest, Child and Youth Programs",DCH_SNACK_NT,22,0,0,0,0,0,0,0,0,0
SAN DIEGO,Apr 2014,DCH,2014,"Navy Region Southwest, Child and Youth Programs",DCH_SNACK_NT,22,0,0,0,0,0,0,0,0,0
SAN DIEGO,Apr 2014,DCH,2014,"Navy Region Southwest, Child and Youth Programs",DCH_SNACK_PM,22,0,0,0,0,3574,0,0,3574,162.4545
SAN DIEGO,Apr 2014,DCH,2014,"Navy Region Southwest, Child and Youth Programs",DCH_SNACK_PM,,0,0,0,0,0,0,210,210,0
SAN DIEGO,Apr 2014,DCH,2014,"Navy Region Southwest, Child and Youth Programs",DCH_SNACK_PM,22,0,0,0,0,0,0,0,0,0
SAN DIEGO,Apr 2014,DCH,2014,"Navy Region Southwest, Child and Youth Programs",DCH_SNACK_PM,22,0,0,0,0,0,0,0,0,0
SAN DIEGO,Apr 2014,DCH,2014,"Navy Region Southwest, Child and Youth Programs",DCH_SUPPER,22,0,0,0,0,146,0,0,146,6.6364
SAN DIEGO,Apr 2014,DCH,2014,"Navy Region Southwest, Child and Youth Programs",DCH_SUPPER,22,0,0,0,0,0,0,0,0,0
SAN DIEGO,Apr 2014,DCH,2014,"Navy Region Southwest, Child and Youth Programs",DCH_SUPPER,22,0,0,0,0,0,0,0,0,0
SAN DIEGO,Apr 2014,CACF,2014,"Navy Region Southwest, Child and Youth Programs",OSCH_CHILD_BREAKFAST,22,3,11,83,97,3,12,87,102,4.6364
SAN DIEGO,Apr 2014,CACF,2014,"Navy Region Southwest, Child and Youth Programs",OSCH_CHILD_LUNCH,22,3,11,83,97,5,20,150,175,7.9545
SAN DIEGO,Apr 2014,CACF,2014,"Navy Region Southwest, Child and Youth Programs",OSCH_CHILD_SNACK_PM,22,3,11,83,97,37,135,1020,1192,54.1818
SAN DIEGO,May 2014,CACF,2014,"Navy Region Southwest, Child and Youth Programs",ATRISK_CHILD_SNACK,21,545,0,0,545,10421,0,0,10421,496.2381
SAN DIEGO,May 2014,CACF,2014,"Navy Region Southwest, Child and Youth Programs",CHILD_BREAKFAST,21,104,202,2184,2490,1628,3158,34151,38937,1854.1429
SAN DIEGO,May 2014,CACF,2014,"Navy Region Southwest, Child and Youth Programs",CHILD_LUNCH,21,104,202,2184,2490,1909,3703,40048,45660,2174.2857
SAN DIEGO,May 2014,CACF,2014,"Navy Region Southwest, Child and Youth Programs",CHILD_SNACK_PM,21,104,202,2184,2490,1763,3420,36985,42168,2008
SAN DIEGO,May 2014,DCH,2014,"Navy Region Southwest, Child and Youth Programs",DCH_BREAKFAST,22,0,0,0,0,5187,0,0,5187,235.7727
SAN DIEGO,May 2014,DCH,2014,"Navy Region Southwest, Child and Youth Programs",DCH_BREAKFAST,,0,0,0,0,0,15,263,278,0
SAN DIEGO,May 2014,DCH,2014,"Navy Region Southwest, Child and Youth Programs",DCH_BREAKFAST,21,0,0,0,0,0,0,0,0,0
SAN DIEGO,May 2014,DCH,2014,"Navy Region Southwest, Child and Youth Programs",DCH_BREAKFAST,21,0,0,0,0,0,0,0,0,0
SAN DIEGO,May 2014,DCH,2014,"Navy Region Southwest, Child and Youth Programs",DCH_LUNCH,22,0,0,0,0,5667,0,0,5667,257.5909
SAN DIEGO,May 2014,DCH,2014,"Navy Region Southwest, Child and Youth Programs",DCH_LUNCH,,0,0,0,0,0,17,406,423,0
SAN DIEGO,May 2014,DCH,2014,"Navy Region Southwest, Child and Youth Programs",DCH_LUNCH,21,0,0,0,0,0,0,0,0,0
SAN DIEGO,May 2014,DCH,2014,"Navy Region Southwest, Child and Youth Programs",DCH_LUNCH,21,0,0,0,0,0,0,0,0,0
SAN DIEGO,May 2014,DCH,2014,"Navy Region Southwest, Child and Youth Programs",DCH_SNACK_AM,22,0,0,0,0,3016,0,0,3016,137.0909
SAN DIEGO,May 2014,DCH,2014,"Navy Region Southwest, Child and Youth Programs",DCH_SNACK_AM,,0,0,0,0,0,15,382,397,0
SAN DIEGO,May 2014,DCH,2014,"Navy Region Southwest, Child and Youth Programs",DCH_SNACK_AM,21,0,0,0,0,0,0,0,0,0
SAN DIEGO,May 2014,DCH,2014,"Navy Region Southwest, Child and Youth Programs",DCH_SNACK_AM,21,0,0,0,0,0,0,0,0,0
SAN DIEGO,May 2014,DCH,2014,"Navy Region Southwest, Child and Youth Programs",DCH_SNACK_NT,22,0,0,0,0,7,0,0,7,0.3182
SAN DIEGO,May 2014,DCH,2014,"Navy Region Southwest, Child and Youth Programs",DCH_SNACK_NT,21,0,0,0,0,0,0,0,0,0
SAN DIEGO,May 2014,DCH,2014,"Navy Region Southwest, Child and Youth Programs",DCH_SNACK_NT,21,0,0,0,0,0,0,0,0,0
SAN DIEGO,May 2014,DCH,2014,"Navy Region Southwest, Child and Youth Programs",DCH_SNACK_PM,22,0,0,0,0,3421,0,0,3421,155.5
SAN DIEGO,May 2014,DCH,2014,"Navy Region Southwest, Child and Youth Programs",DCH_SNACK_PM,,0,0,0,0,0,2,244,246,0
SAN DIEGO,May 2014,DCH,2014,"Navy Region Southwest, Child and Youth Programs",DCH_SNACK_PM,21,0,0,0,0,0,0,0,0,0
SAN DIEGO,May 2014,DCH,2014,"Navy Region Southwest, Child and Youth Programs",DCH_SNACK_PM,21,0,0,0,0,0,0,0,0,0
SAN DIEGO,May 2014,DCH,2014,"Navy Region Southwest, Child and Youth Programs",DCH_SUPPER,22,0,0,0,0,142,0,0,142,6.4545
SAN DIEGO,May 2014,DCH,2014,"Navy Region Southwest, Child and Youth Programs",DCH_SUPPER,,0,0,0,0,0,0,1,1,0
SAN DIEGO,May 2014,DCH,2014,"Navy Region Southwest, Child and Youth Programs",DCH_SUPPER,21,0,0,0,0,0,0,0,0,0
SAN DIEGO,May 2014,DCH,2014,"Navy Region Southwest, Child and Youth Programs",DCH_SUPPER,21,0,0,0,0,0,0,0,0,0
SAN DIEGO,May 2014,CACF,2014,"Navy Region Southwest, Child and Youth Programs",OSCH_CHILD_SNACK_PM,21,3,11,83,97,40,148,1114,1302,62
SAN DIEGO,Jun 2014,CACF,2014,"Navy Region Southwest, Child and Youth Programs",ATRISK_CHILD_SNACK,21,300,0,0,300,5581,0,0,5581,265.7619
SAN DIEGO,Jun 2014,CACF,2014,"Navy Region Southwest, Child and Youth Programs",CHILD_BREAKFAST,21,104,202,2184,2490,1514,2937,31760,36211,1724.3333
SAN DIEGO,Jun 2014,CACF,2014,"Navy Region Southwest, Child and Youth Programs",CHILD_LUNCH,21,104,202,2184,2490,1829,3549,38382,43760,2083.8095
SAN DIEGO,Jun 2014,CACF,2014,"Navy Region Southwest, Child and Youth Programs",CHILD_SNACK_PM,21,104,202,2184,2490,1615,3133,33887,38635,1839.7619
SAN DIEGO,Jun 2014,DCH,2014,"Navy Region Southwest, Child and Youth Programs",DCH_BREAKFAST,23,0,0,0,0,5209,0,0,5209,226.4783
SAN DIEGO,Jun 2014,DCH,2014,"Navy Region Southwest, Child and Youth Programs",DCH_BREAKFAST,,0,0,0,0,0,19,292,311,0
SAN DIEGO,Jun 2014,DCH,2014,"Navy Region Southwest, Child and Youth Programs",DCH_BREAKFAST,21,0,0,0,0,0,0,0,0,0
SAN DIEGO,Jun 2014,DCH,2014,"Navy Region Southwest, Child and Youth Programs",DCH_BREAKFAST,21,0,0,0,0,0,0,0,0,0
SAN DIEGO,Jun 2014,DCH,2014,"Navy Region Southwest, Child and Youth Programs",DCH_LUNCH,23,0,0,0,0,5806,0,0,5806,252.4348
SAN DIEGO,Jun 2014,DCH,2014,"Navy Region Southwest, Child and Youth Programs",DCH_LUNCH,,0,0,0,0,0,19,404,423,0
SAN DIEGO,Jun 2014,DCH,2014,"Navy Region Southwest, Child and Youth Programs",DCH_LUNCH,21,0,0,0,0,0,0,0,0,0
SAN DIEGO,Jun 2014,DCH,2014,"Navy Region Southwest, Child and Youth Programs",DCH_LUNCH,21,0,0,0,0,0,0,0,0,0
SAN DIEGO,Jun 2014,DCH,2014,"Navy Region Southwest, Child and Youth Programs",DCH_SNACK_AM,23,0,0,0,0,2780,0,0,2780,120.8696
SAN DIEGO,Jun 2014,DCH,2014,"Navy Region Southwest, Child and Youth Programs",DCH_SNACK_AM,,0,0,0,0,0,19,378,397,0
SAN DIEGO,Jun 2014,DCH,2014,"Navy Region Southwest, Child and Youth Programs",DCH_SNACK_AM,21,0,0,0,0,0,0,0,0,0
SAN DIEGO,Jun 2014,DCH,2014,"Navy Region Southwest, Child and Youth Programs",DCH_SNACK_AM,21,0,0,0,0,0,0,0,0,0
SAN DIEGO,Jun 2014,DCH,2014,"Navy Region Southwest, Child and Youth Programs",DCH_SNACK_NT,23,0,0,0,0,2,0,0,2,0.087
SAN DIEGO,Jun 2014,DCH,2014,"Navy Region Southwest, Child and Youth Programs",DCH_SNACK_NT,21,0,0,0,0,0,0,0,0,0
SAN DIEGO,Jun 2014,DCH,2014,"Navy Region Southwest, Child and Youth Programs",DCH_SNACK_NT,21,0,0,0,0,0,0,0,0,0
SAN DIEGO,Jun 2014,DCH,2014,"Navy Region Southwest, Child and Youth Programs",DCH_SNACK_PM,23,0,0,0,0,3671,0,0,3671,159.6087
SAN DIEGO,Jun 2014,DCH,2014,"Navy Region Southwest, Child and Youth Programs",DCH_SNACK_PM,,0,0,0,0,0,1,214,215,0
SAN DIEGO,Jun 2014,DCH,2014,"Navy Region Southwest, Child and Youth Programs",DCH_SNACK_PM,21,0,0,0,0,0,0,0,0,0
SAN DIEGO,Jun 2014,DCH,2014,"Navy Region Southwest, Child and Youth Programs",DCH_SNACK_PM,21,0,0,0,0,0,0,0,0,0
SAN DIEGO,Jun 2014,DCH,2014,"Navy Region Southwest, Child and Youth Programs",DCH_SUPPER,23,0,0,0,0,168,0,0,168,7.3043
SAN DIEGO,Jun 2014,DCH,2014,"Navy Region Southwest, Child and Youth Programs",DCH_SUPPER,21,0,0,0,0,0,0,0,0,0
SAN DIEGO,Jun 2014,DCH,2014,"Navy Region Southwest, Child and Youth Programs",DCH_SUPPER,21,0,0,0,0,0,0,0,0,0
SAN DIEGO,Jun 2014,CACF,2014,"Navy Region Southwest, Child and Youth Programs",OSCH_CHILD_BREAKFAST,21,3,11,83,97,5,20,148,173,8.2381
SAN DIEGO,Jun 2014,CACF,2014,"Navy Region Southwest, Child and Youth Programs",OSCH_CHILD_LUNCH,21,3,11,83,97,14,52,390,456,21.7143
SAN DIEGO,Jun 2014,CACF,2014,"Navy Region Southwest, Child and Youth Programs",OSCH_CHILD_SNACK_PM,21,3,11,83,97,17,63,476,556,26.4762
SAN DIEGO,Jul 2014,CACF,2014,"Navy Region Southwest, Child and Youth Programs",CHILD_BREAKFAST,22,104,202,2184,2490,1531,2971,32134,36636,1665.2727
SAN DIEGO,Jul 2014,CACF,2014,"Navy Region Southwest, Child and Youth Programs",CHILD_LUNCH,22,104,202,2184,2490,1840,3570,38604,44014,2000.6364
SAN DIEGO,Jul 2014,CACF,2014,"Navy Region Southwest, Child and Youth Programs",CHILD_SNACK_PM,22,104,202,2184,2490,1685,3269,35351,40305,1832.0455
SAN DIEGO,Jul 2014,DCH,2014,"Navy Region Southwest, Child and Youth Programs",DCH_BREAKFAST,23,0,0,0,0,4818,0,0,4818,209.4783
SAN DIEGO,Jul 2014,DCH,2014,"Navy Region Southwest, Child and Youth Programs",DCH_BREAKFAST,,0,0,0,0,0,2,225,227,0
SAN DIEGO,Jul 2014,DCH,2014,"Navy Region Southwest, Child and Youth Programs",DCH_BREAKFAST,22,0,0,0,0,0,0,0,0,0
SAN DIEGO,Jul 2014,DCH,2014,"Navy Region Southwest, Child and Youth Programs",DCH_BREAKFAST,21,0,0,0,0,0,0,0,0,0
SAN DIEGO,Jul 2014,DCH,2014,"Navy Region Southwest, Child and Youth Programs",DCH_LUNCH,23,0,0,0,0,5546,0,0,5546,241.1304
SAN DIEGO,Jul 2014,DCH,2014,"Navy Region Southwest, Child and Youth Programs",DCH_LUNCH,,0,0,0,0,0,21,336,357,0
SAN DIEGO,Jul 2014,DCH,2014,"Navy Region Southwest, Child and Youth Programs",DCH_LUNCH,22,0,0,0,0,0,0,0,0,0
SAN DIEGO,Jul 2014,DCH,2014,"Navy Region Southwest, Child and Youth Programs",DCH_LUNCH,21,0,0,0,0,0,0,0,0,0
SAN DIEGO,Jul 2014,DCH,2014,"Navy Region Southwest, Child and Youth Programs",DCH_SNACK_AM,23,0,0,0,0,2869,0,0,2869,124.7391
SAN DIEGO,Jul 2014,DCH,2014,"Navy Region Southwest, Child and Youth Programs",DCH_SNACK_AM,,0,0,0,0,0,21,322,343,0
SAN DIEGO,Jul 2014,DCH,2014,"Navy Region Southwest, Child and Youth Programs",DCH_SNACK_AM,22,0,0,0,0,0,0,0,0,0
SAN DIEGO,Jul 2014,DCH,2014,"Navy Region Southwest, Child and Youth Programs",DCH_SNACK_AM,21,0,0,0,0,0,0,0,0,0
SAN DIEGO,Jul 2014,DCH,2014,"Navy Region Southwest, Child and Youth Programs",DCH_SNACK_PM,23,0,0,0,0,3046,0,0,3046,132.4348
SAN DIEGO,Jul 2014,DCH,2014,"Navy Region Southwest, Child and Youth Programs",DCH_SNACK_PM,,0,0,0,0,0,19,197,216,0
SAN DIEGO,Jul 2014,DCH,2014,"Navy Region Southwest, Child and Youth Programs",DCH_SNACK_PM,22,0,0,0,0,0,0,0,0,0
SAN DIEGO,Jul 2014,DCH,2014,"Navy Region Southwest, Child and Youth Programs",DCH_SNACK_PM,21,0,0,0,0,0,0,0,0,0
SAN DIEGO,Jul 2014,DCH,2014,"Navy Region Southwest, Child and Youth Programs",DCH_SUPPER,23,0,0,0,0,161,0,0,161,7
SAN DIEGO,Jul 2014,DCH,2014,"Navy Region Southwest, Child and Youth Programs",DCH_SUPPER,22,0,0,0,0,0,0,0,0,0
SAN DIEGO,Jul 2014,DCH,2014,"Navy Region Southwest, Child and Youth Programs",DCH_SUPPER,21,0,0,0,0,0,0,0,0,0
SAN DIEGO,Jul 2014,CACF,2014,"Navy Region Southwest, Child and Youth Programs",OSCH_CHILD_BREAKFAST,22,3,11,83,97,11,41,307,359,16.3182
SAN DIEGO,Jul 2014,CACF,2014,"Navy Region Southwest, Child and Youth Programs",OSCH_CHILD_LUNCH,22,3,11,83,97,32,116,879,1027,46.6818
SAN DIEGO,Jul 2014,CACF,2014,"Navy Region Southwest, Child and Youth Programs",OSCH_CHILD_SNACK_PM,22,3,11,83,97,28,104,781,913,41.5
SAN DIEGO,Aug 2014,CACF,2014,"Navy Region Southwest, Child and Youth Programs",ATRISK_CHILD_SNACK,21,189,0,0,189,3034,0,0,3034,144.4762
SAN DIEGO,Aug 2014,CACF,2014,"Navy Region Southwest, Child and Youth Programs",CHILD_BREAKFAST,21,104,202,2184,2490,1526,2961,32029,36516,1738.8571
SAN DIEGO,Aug 2014,CACF,2014,"Navy Region Southwest, Child and Youth Programs",CHILD_LUNCH,21,104,202,2184,2490,1795,3483,37666,42944,2044.9524
SAN DIEGO,Aug 2014,CACF,2014,"Navy Region Southwest, Child and Youth Programs",CHILD_SNACK_PM,21,104,202,2184,2490,1611,3125,33797,38533,1834.9048
SAN DIEGO,Aug 2014,DCH,2014,"Navy Region Southwest, Child and Youth Programs",DCH_BREAKFAST,21,0,0,0,0,4411,0,0,4411,210.0476
SAN DIEGO,Aug 2014,DCH,2014,"Navy Region Southwest, Child and Youth Programs",DCH_BREAKFAST,,0,0,0,0,0,2,202,204,0
SAN DIEGO,Aug 2014,DCH,2014,"Navy Region Southwest, Child and Youth Programs",DCH_BREAKFAST,21,0,0,0,0,0,0,0,0,0
SAN DIEGO,Aug 2014,DCH,2014,"Navy Region Southwest, Child and Youth Programs",DCH_BREAKFAST,19,0,0,0,0,0,0,0,0,0
SAN DIEGO,Aug 2014,DCH,2014,"Navy Region Southwest, Child and Youth Programs",DCH_LUNCH,19,0,0,0,0,0,0,0,0,0
SAN DIEGO,Aug 2014,DCH,2014,"Navy Region Southwest, Child and Youth Programs",DCH_LUNCH,21,0,0,0,0,0,0,0,0,0
SAN DIEGO,Aug 2014,DCH,2014,"Navy Region Southwest, Child and Youth Programs",DCH_LUNCH,,0,0,0,0,0,14,384,398,0
SAN DIEGO,Aug 2014,DCH,2014,"Navy Region Southwest, Child and Youth Programs",DCH_LUNCH,21,0,0,0,0,5110,0,0,5110,243.3333
SAN DIEGO,Aug 2014,DCH,2014,"Navy Region Southwest, Child and Youth Programs",DCH_SNACK_AM,21,0,0,0,0,2611,0,0,2611,124.3333
SAN DIEGO,Aug 2014,DCH,2014,"Navy Region Southwest, Child and Youth Programs",DCH_SNACK_AM,,0,0,0,0,0,15,345,360,0
SAN DIEGO,Aug 2014,DCH,2014,"Navy Region Southwest, Child and Youth Programs",DCH_SNACK_AM,21,0,0,0,0,0,0,0,0,0
SAN DIEGO,Aug 2014,DCH,2014,"Navy Region Southwest, Child and Youth Programs",DCH_SNACK_AM,19,0,0,0,0,0,0,0,0,0
SAN DIEGO,Aug 2014,DCH,2014,"Navy Region Southwest, Child and Youth Programs",DCH_SNACK_NT,19,0,0,0,0,0,0,0,0,0
SAN DIEGO,Aug 2014,DCH,2014,"Navy Region Southwest, Child and Youth Programs",DCH_SNACK_NT,21,0,0,0,0,0,0,0,0,0
SAN DIEGO,Aug 2014,DCH,2014,"Navy Region Southwest, Child and Youth Programs",DCH_SNACK_NT,21,0,0,0,0,7,0,0,7,0.3333
SAN DIEGO,Aug 2014,DCH,2014,"Navy Region Southwest, Child and Youth Programs",DCH_SNACK_PM,21,0,0,0,0,3105,0,0,3105,147.8571
SAN DIEGO,Aug 2014,DCH,2014,"Navy Region Southwest, Child and Youth Programs",DCH_SNACK_PM,,0,0,0,0,0,14,266,280,0
SAN DIEGO,Aug 2014,DCH,2014,"Navy Region Southwest, Child and Youth Programs",DCH_SNACK_PM,21,0,0,0,0,0,0,0,0,0
SAN DIEGO,Aug 2014,DCH,2014,"Navy Region Southwest, Child and Youth Programs",DCH_SNACK_PM,19,0,0,0,0,0,0,0,0,0
SAN DIEGO,Aug 2014,DCH,2014,"Navy Region Southwest, Child and Youth Programs",DCH_SUPPER,19,0,0,0,0,0,0,0,0,0
SAN DIEGO,Aug 2014,DCH,2014,"Navy Region Southwest, Child and Youth Programs",DCH_SUPPER,21,0,0,0,0,0,0,0,0,0
SAN DIEGO,Aug 2014,DCH,2014,"Navy Region Southwest, Child and Youth Programs",DCH_SUPPER,21,0,0,0,0,192,0,0,192,9.1429
SAN DIEGO,Aug 2014,CACF,2014,"Navy Region Southwest, Child and Youth Programs",OSCH_CHILD_BREAKFAST,21,3,11,83,97,1,3,22,26,1.2381
SAN DIEGO,Aug 2014,CACF,2014,"Navy Region Southwest, Child and Youth Programs",OSCH_CHILD_LUNCH,21,3,11,83,97,3,12,91,106,5.0476
SAN DIEGO,Aug 2014,CACF,2014,"Navy Region Southwest, Child and Youth Programs",OSCH_CHILD_SNACK_PM,21,3,11,83,97,18,66,499,583,27.7619
SAN DIEGO,Sep 2014,CACF,2014,"Navy Region Southwest, Child and Youth Programs",ATRISK_CHILD_SNACK,21,394,0,0,394,7934,0,0,7934,377.8095
SAN DIEGO,Sep 2014,CACF,2014,"Navy Region Southwest, Child and Youth Programs",CHILD_BREAKFAST,21,104,202,2184,2490,1599,3103,33562,38264,1822.0952
SAN DIEGO,Sep 2014,CACF,2014,"Navy Region Southwest, Child and Youth Programs",CHILD_LUNCH,21,104,202,2184,2490,1859,3608,39017,44484,2118.2857
SAN DIEGO,Sep 2014,CACF,2014,"Navy Region Southwest, Child and Youth Programs",CHILD_SNACK_PM,21,104,202,2184,2490,1655,3211,34723,39589,1885.1905
SAN DIEGO,Sep 2014,DCH,2014,"Navy Region Southwest, Child and Youth Programs",DCH_BREAKFAST,22,0,0,0,0,4853,0,0,4853,220.5909
SAN DIEGO,Sep 2014,DCH,2014,"Navy Region Southwest, Child and Youth Programs",DCH_BREAKFAST,,0,0,0,0,0,14,320,334,0
SAN DIEGO,Sep 2014,DCH,2014,"Navy Region Southwest, Child and Youth Programs",DCH_BREAKFAST,21,0,0,0,0,0,0,0,0,0
SAN DIEGO,Sep 2014,DCH,2014,"Navy Region Southwest, Child and Youth Programs",DCH_BREAKFAST,19,0,0,0,0,0,0,0,0,0
SAN DIEGO,Sep 2014,DCH,2014,"Navy Region Southwest, Child and Youth Programs",DCH_LUNCH,19,0,0,0,0,0,0,0,0,0
SAN DIEGO,Sep 2014,DCH,2014,"Navy Region Southwest, Child and Youth Programs",DCH_LUNCH,21,0,0,0,0,0,0,0,0,0
SAN DIEGO,Sep 2014,DCH,2014,"Navy Region Southwest, Child and Youth Programs",DCH_LUNCH,,0,0,0,0,0,17,399,416,0
SAN DIEGO,Sep 2014,DCH,2014,"Navy Region Southwest, Child and Youth Programs",DCH_LUNCH,22,0,0,0,0,5193,0,0,5193,236.0455
SAN DIEGO,Sep 2014,DCH,2014,"Navy Region Southwest, Child and Youth Programs",DCH_SNACK_AM,22,0,0,0,0,2566,0,0,2566,116.6364
SAN DIEGO,Sep 2014,DCH,2014,"Navy Region Southwest, Child and Youth Programs",DCH_SNACK_AM,,0,0,0,0,0,18,255,273,0
SAN DIEGO,Sep 2014,DCH,2014,"Navy Region Southwest, Child and Youth Programs",DCH_SNACK_AM,21,0,0,0,0,0,0,0,0,0
SAN DIEGO,Sep 2014,DCH,2014,"Navy Region Southwest, Child and Youth Programs",DCH_SNACK_AM,19,0,0,0,0,0,0,0,0,0
SAN DIEGO,Sep 2014,DCH,2014,"Navy Region Southwest, Child and Youth Programs",DCH_SNACK_PM,22,0,0,0,0,3436,0,0,3436,156.1818
SAN DIEGO,Sep 2014,DCH,2014,"Navy Region Southwest, Child and Youth Programs",DCH_SNACK_PM,,0,0,0,0,0,4,227,231,0
SAN DIEGO,Sep 2014,DCH,2014,"Navy Region Southwest, Child and Youth Programs",DCH_SNACK_PM,21,0,0,0,0,0,0,0,0,0
SAN DIEGO,Sep 2014,DCH,2014,"Navy Region Southwest, Child and Youth Programs",DCH_SNACK_PM,19,0,0,0,0,0,0,0,0,0
SAN DIEGO,Sep 2014,DCH,2014,"Navy Region Southwest, Child and Youth Programs",DCH_SUPPER,19,0,0,0,0,0,0,0,0,0
SAN DIEGO,Sep 2014,DCH,2014,"Navy Region Southwest, Child and Youth Programs",DCH_SUPPER,21,0,0,0,0,0,0,0,0,0
SAN DIEGO,Sep 2014,DCH,2014,"Navy Region Southwest, Child and Youth Programs",DCH_SUPPER,22,0,0,0,0,215,0,0,215,9.7727
SAN DIEGO,Sep 2014,CACF,2014,"Navy Region Southwest, Child and Youth Programs",OSCH_CHILD_SNACK_PM,21,3,11,83,97,39,141,1066,1246,59.3333
SAN DIEGO,Oct 2013,CACF,2014,NEIGHBORHOOD HOUSE ASSOCIATION ,ADULT_LUNCH,23,61,1,12,74,718,12,141,871,37.8696
SAN DIEGO,Oct 2013,CACF,2014,NEIGHBORHOOD HOUSE ASSOCIATION ,ADULT_SNACK_AM,23,61,1,12,74,699,11,138,848,36.8696
SAN DIEGO,Oct 2013,CACF,2014,NEIGHBORHOOD HOUSE ASSOCIATION ,ADULT_SNACK_PM,23,61,1,12,74,696,11,137,844,36.6957
SAN DIEGO,Oct 2013,CACF,2014,NEIGHBORHOOD HOUSE ASSOCIATION ,HS_CHILD_BREAKFAST,23,2208,0,0,2208,25061,0,0,25061,1089.6087
SAN DIEGO,Oct 2013,CACF,2014,NEIGHBORHOOD HOUSE ASSOCIATION ,HS_CHILD_LUNCH,23,2208,0,0,2208,33283,0,0,33283,1447.087
SAN DIEGO,Oct 2013,CACF,2014,NEIGHBORHOOD HOUSE ASSOCIATION ,HS_CHILD_SNACK_AM,23,2208,0,0,2208,97,0,0,97,4.2174
SAN DIEGO,Oct 2013,CACF,2014,NEIGHBORHOOD HOUSE ASSOCIATION ,HS_CHILD_SNACK_PM,23,2208,0,0,2208,19649,0,0,19649,854.3043
SAN DIEGO,Nov 2013,CACF,2014,NEIGHBORHOOD HOUSE ASSOCIATION ,ADULT_LUNCH,19,61,1,12,74,715,12,140,867,45.6316
SAN DIEGO,Nov 2013,CACF,2014,NEIGHBORHOOD HOUSE ASSOCIATION ,ADULT_SNACK_AM,19,61,1,12,74,697,11,137,845,44.4737
SAN DIEGO,Nov 2013,CACF,2014,NEIGHBORHOOD HOUSE ASSOCIATION ,ADULT_SNACK_PM,19,61,1,12,74,693,11,137,841,44.2632
SAN DIEGO,Nov 2013,CACF,2014,NEIGHBORHOOD HOUSE ASSOCIATION ,HS_CHILD_BREAKFAST,18,2208,0,0,2208,18090,0,0,18090,1005
SAN DIEGO,Nov 2013,CACF,2014,NEIGHBORHOOD HOUSE ASSOCIATION ,HS_CHILD_LUNCH,18,2208,0,0,2208,23264,0,0,23264,1292.4444
SAN DIEGO,Nov 2013,CACF,2014,NEIGHBORHOOD HOUSE ASSOCIATION ,HS_CHILD_SNACK_AM,18,2208,0,0,2208,62,0,0,62,3.4444
SAN DIEGO,Nov 2013,CACF,2014,NEIGHBORHOOD HOUSE ASSOCIATION ,HS_CHILD_SNACK_PM,18,2208,0,0,2208,13561,0,0,13561,753.3889
SAN DIEGO,Dec 2013,CACF,2014,NEIGHBORHOOD HOUSE ASSOCIATION ,ADULT_LUNCH,20,61,1,12,74,718,12,141,871,43.55
SAN DIEGO,Dec 2013,CACF,2014,NEIGHBORHOOD HOUSE ASSOCIATION ,ADULT_SNACK_AM,20,61,1,12,74,703,12,138,853,42.65
SAN DIEGO,Dec 2013,CACF,2014,NEIGHBORHOOD HOUSE ASSOCIATION ,ADULT_SNACK_PM,20,61,1,12,74,697,11,137,845,42.25
SAN DIEGO,Dec 2013,CACF,2014,NEIGHBORHOOD HOUSE ASSOCIATION ,HS_CHILD_BREAKFAST,16,2208,0,0,2208,17248,0,0,17248,1078
SAN DIEGO,Dec 2013,CACF,2014,NEIGHBORHOOD HOUSE ASSOCIATION ,HS_CHILD_LUNCH,16,2208,0,0,2208,22612,0,0,22612,1413.25
SAN DIEGO,Dec 2013,CACF,2014,NEIGHBORHOOD HOUSE ASSOCIATION ,HS_CHILD_SNACK_AM,16,2208,0,0,2208,54,0,0,54,3.375
SAN DIEGO,Dec 2013,CACF,2014,NEIGHBORHOOD HOUSE ASSOCIATION ,HS_CHILD_SNACK_PM,16,2208,0,0,2208,13069,0,0,13069,816.8125
SAN DIEGO,Jan 2014,CACF,2014,NEIGHBORHOOD HOUSE ASSOCIATION ,ADULT_LUNCH,22,61,1,12,74,785,13,154,952,43.2727
SAN DIEGO,Jan 2014,CACF,2014,NEIGHBORHOOD HOUSE ASSOCIATION ,ADULT_SNACK_AM,22,61,1,12,74,742,12,146,900,40.9091
SAN DIEGO,Jan 2014,CACF,2014,NEIGHBORHOOD HOUSE ASSOCIATION ,ADULT_SNACK_PM,22,61,1,12,74,762,12,150,924,42
SAN DIEGO,Jan 2014,CACF,2014,NEIGHBORHOOD HOUSE ASSOCIATION ,HS_CHILD_BREAKFAST,21,2208,0,0,2208,21164,0,0,21164,1007.8095
SAN DIEGO,Jan 2014,CACF,2014,NEIGHBORHOOD HOUSE ASSOCIATION ,HS_CHILD_LUNCH,21,2208,0,0,2208,27986,0,0,27986,1332.6667
SAN DIEGO,Jan 2014,CACF,2014,NEIGHBORHOOD HOUSE ASSOCIATION ,HS_CHILD_SNACK_AM,21,2208,0,0,2208,67,0,0,67,3.1905
SAN DIEGO,Jan 2014,CACF,2014,NEIGHBORHOOD HOUSE ASSOCIATION ,HS_CHILD_SNACK_PM,21,2208,0,0,2208,16989,0,0,16989,809
SAN DIEGO,Feb 2014,CACF,2014,NEIGHBORHOOD HOUSE ASSOCIATION ,ADULT_LUNCH,20,61,1,12,74,768,13,151,932,46.6
SAN DIEGO,Feb 2014,CACF,2014,NEIGHBORHOOD HOUSE ASSOCIATION ,ADULT_SNACK_AM,20,61,1,12,74,734,12,144,890,44.5
SAN DIEGO,Feb 2014,CACF,2014,NEIGHBORHOOD HOUSE ASSOCIATION ,ADULT_SNACK_PM,20,61,1,12,74,748,12,148,908,45.4
SAN DIEGO,Feb 2014,CACF,2014,NEIGHBORHOOD HOUSE ASSOCIATION ,HS_CHILD_BREAKFAST,18,2208,0,0,2208,20225,0,0,20225,1123.6111
SAN DIEGO,Feb 2014,CACF,2014,NEIGHBORHOOD HOUSE ASSOCIATION ,HS_CHILD_LUNCH,18,2208,0,0,2208,27007,0,0,27007,1500.3889
SAN DIEGO,Feb 2014,CACF,2014,NEIGHBORHOOD HOUSE ASSOCIATION ,HS_CHILD_SNACK_AM,18,2208,0,0,2208,71,0,0,71,3.9444
SAN DIEGO,Feb 2014,CACF,2014,NEIGHBORHOOD HOUSE ASSOCIATION ,HS_CHILD_SNACK_PM,18,2208,0,0,2208,16297,0,0,16297,905.3889
SAN DIEGO,Mar 2014,CACF,2014,NEIGHBORHOOD HOUSE ASSOCIATION ,ADULT_LUNCH,21,61,1,12,74,834,14,164,1012,48.1905
SAN DIEGO,Mar 2014,CACF,2014,NEIGHBORHOOD HOUSE ASSOCIATION ,ADULT_SNACK_AM,21,61,1,12,74,799,13,157,969,46.1429
SAN DIEGO,Mar 2014,CACF,2014,NEIGHBORHOOD HOUSE ASSOCIATION ,ADULT_SNACK_PM,21,61,1,12,74,820,13,162,995,47.381
SAN DIEGO,Mar 2014,CACF,2014,NEIGHBORHOOD HOUSE ASSOCIATION ,HS_CHILD_BREAKFAST,20,2208,0,0,2208,22161,0,0,22161,1108.05
SAN DIEGO,Mar 2014,CACF,2014,NEIGHBORHOOD HOUSE ASSOCIATION ,HS_CHILD_LUNCH,20,2208,0,0,2208,29640,0,0,29640,1482
SAN DIEGO,Mar 2014,CACF,2014,NEIGHBORHOOD HOUSE ASSOCIATION ,HS_CHILD_SNACK_AM,20,2208,0,0,2208,73,0,0,73,3.65
SAN DIEGO,Mar 2014,CACF,2014,NEIGHBORHOOD HOUSE ASSOCIATION ,HS_CHILD_SNACK_PM,20,2208,0,0,2208,17855,0,0,17855,892.75
SAN DIEGO,Apr 2014,CACF,2014,NEIGHBORHOOD HOUSE ASSOCIATION ,ADULT_LUNCH,22,61,1,12,74,849,14,167,1030,46.8182
SAN DIEGO,Apr 2014,CACF,2014,NEIGHBORHOOD HOUSE ASSOCIATION ,ADULT_SNACK_AM,22,61,1,12,74,806,13,159,978,44.4545
SAN DIEGO,Apr 2014,CACF,2014,NEIGHBORHOOD HOUSE ASSOCIATION ,ADULT_SNACK_PM,22,61,1,12,74,841,14,165,1020,46.3636
SAN DIEGO,Apr 2014,CACF,2014,NEIGHBORHOOD HOUSE ASSOCIATION ,HS_CHILD_BREAKFAST,22,2208,0,0,2208,19574,0,0,19574,889.7273
SAN DIEGO,Apr 2014,CACF,2014,NEIGHBORHOOD HOUSE ASSOCIATION ,HS_CHILD_LUNCH,22,2208,0,0,2208,26534,0,0,26534,1206.0909
SAN DIEGO,Apr 2014,CACF,2014,NEIGHBORHOOD HOUSE ASSOCIATION ,HS_CHILD_SNACK_AM,22,2208,0,0,2208,71,0,0,71,3.2273
SAN DIEGO,Apr 2014,CACF,2014,NEIGHBORHOOD HOUSE ASSOCIATION ,HS_CHILD_SNACK_PM,22,2208,0,0,2208,15437,0,0,15437,701.6818
SAN DIEGO,May 2014,CACF,2014,NEIGHBORHOOD HOUSE ASSOCIATION ,ADULT_LUNCH,21,61,1,12,74,818,13,161,992,47.2381
SAN DIEGO,May 2014,CACF,2014,NEIGHBORHOOD HOUSE ASSOCIATION ,ADULT_SNACK_AM,21,61,1,12,74,763,13,150,926,44.0952
SAN DIEGO,May 2014,CACF,2014,NEIGHBORHOOD HOUSE ASSOCIATION ,ADULT_SNACK_PM,21,61,1,12,74,812,13,160,985,46.9048
SAN DIEGO,May 2014,CACF,2014,NEIGHBORHOOD HOUSE ASSOCIATION ,HS_CHILD_BREAKFAST,19,2208,0,0,2208,22316,0,0,22316,1174.5263
SAN DIEGO,May 2014,CACF,2014,NEIGHBORHOOD HOUSE ASSOCIATION ,HS_CHILD_LUNCH,19,2208,0,0,2208,29201,0,0,29201,1536.8947
SAN DIEGO,May 2014,CACF,2014,NEIGHBORHOOD HOUSE ASSOCIATION ,HS_CHILD_SNACK_AM,19,2208,0,0,2208,84,0,0,84,4.4211
SAN DIEGO,May 2014,CACF,2014,NEIGHBORHOOD HOUSE ASSOCIATION ,HS_CHILD_SNACK_PM,19,2208,0,0,2208,17106,0,0,17106,900.3158
SAN DIEGO,Jun 2014,CACF,2014,NEIGHBORHOOD HOUSE ASSOCIATION ,ADULT_LUNCH,21,61,1,12,74,807,13,159,979,46.619
SAN DIEGO,Jun 2014,CACF,2014,NEIGHBORHOOD HOUSE ASSOCIATION ,ADULT_SNACK_AM,21,61,1,12,74,729,12,143,884,42.0952
SAN DIEGO,Jun 2014,CACF,2014,NEIGHBORHOOD HOUSE ASSOCIATION ,ADULT_SNACK_PM,21,61,1,12,74,794,13,156,963,45.8571
SAN DIEGO,Jun 2014,CACF,2014,NEIGHBORHOOD HOUSE ASSOCIATION ,HS_CHILD_BREAKFAST,20,2208,0,0,2208,10914,0,0,10914,545.7
SAN DIEGO,Jun 2014,CACF,2014,NEIGHBORHOOD HOUSE ASSOCIATION ,HS_CHILD_LUNCH,20,2208,0,0,2208,14251,0,0,14251,712.55
SAN DIEGO,Jun 2014,CACF,2014,NEIGHBORHOOD HOUSE ASSOCIATION ,HS_CHILD_SNACK_AM,20,2208,0,0,2208,47,0,0,47,2.35
SAN DIEGO,Jun 2014,CACF,2014,NEIGHBORHOOD HOUSE ASSOCIATION ,HS_CHILD_SNACK_PM,20,2208,0,0,2208,7460,0,0,7460,373
SAN DIEGO,Jul 2014,CACF,2014,NEIGHBORHOOD HOUSE ASSOCIATION ,ADULT_LUNCH,22,61,1,12,74,877,14,173,1064,48.3636
SAN DIEGO,Jul 2014,CACF,2014,NEIGHBORHOOD HOUSE ASSOCIATION ,ADULT_SNACK_AM,22,61,1,12,74,665,11,131,807,36.6818
SAN DIEGO,Jul 2014,CACF,2014,NEIGHBORHOOD HOUSE ASSOCIATION ,ADULT_SNACK_PM,22,61,1,12,74,858,14,169,1041,47.3182
SAN DIEGO,Jul 2014,CACF,2014,NEIGHBORHOOD HOUSE ASSOCIATION ,HS_CHILD_BREAKFAST,22,2208,0,0,2208,1426,0,0,1426,64.8182
SAN DIEGO,Jul 2014,CACF,2014,NEIGHBORHOOD HOUSE ASSOCIATION ,HS_CHILD_LUNCH,22,2208,0,0,2208,1701,0,0,1701,77.3182
SAN DIEGO,Jul 2014,CACF,2014,NEIGHBORHOOD HOUSE ASSOCIATION ,HS_CHILD_SNACK_AM,22,2208,0,0,2208,127,0,0,127,5.7727
SAN DIEGO,Jul 2014,CACF,2014,NEIGHBORHOOD HOUSE ASSOCIATION ,HS_CHILD_SNACK_PM,22,2208,0,0,2208,1101,0,0,1101,50.0455
SAN DIEGO,Aug 2014,CACF,2014,NEIGHBORHOOD HOUSE ASSOCIATION ,ADULT_LUNCH,21,61,1,12,74,795,13,157,965,45.9524
SAN DIEGO,Aug 2014,CACF,2014,NEIGHBORHOOD HOUSE ASSOCIATION ,ADULT_SNACK_AM,21,61,1,12,74,669,11,131,811,38.619
SAN DIEGO,Aug 2014,CACF,2014,NEIGHBORHOOD HOUSE ASSOCIATION ,ADULT_SNACK_PM,21,61,1,12,74,774,13,152,939,44.7143
SAN DIEGO,Aug 2014,CACF,2014,NEIGHBORHOOD HOUSE ASSOCIATION ,HS_CHILD_BREAKFAST,21,2208,0,0,2208,1414,0,0,1414,67.3333
SAN DIEGO,Aug 2014,CACF,2014,NEIGHBORHOOD HOUSE ASSOCIATION ,HS_CHILD_LUNCH,21,2208,0,0,2208,1919,0,0,1919,91.381
SAN DIEGO,Aug 2014,CACF,2014,NEIGHBORHOOD HOUSE ASSOCIATION ,HS_CHILD_SNACK_AM,21,2208,0,0,2208,243,0,0,243,11.5714
SAN DIEGO,Aug 2014,CACF,2014,NEIGHBORHOOD HOUSE ASSOCIATION ,HS_CHILD_SNACK_PM,21,2208,0,0,2208,1291,0,0,1291,61.4762
SAN DIEGO,Sep 2014,CACF,2014,NEIGHBORHOOD HOUSE ASSOCIATION ,ADULT_LUNCH,21,61,1,12,74,824,14,162,1000,47.619
SAN DIEGO,Sep 2014,CACF,2014,NEIGHBORHOOD HOUSE ASSOCIATION ,ADULT_SNACK_AM,21,61,1,12,74,679,11,134,824,39.2381
SAN DIEGO,Sep 2014,CACF,2014,NEIGHBORHOOD HOUSE ASSOCIATION ,ADULT_SNACK_PM,21,61,1,12,74,779,13,153,945,45
SAN DIEGO,Sep 2014,CACF,2014,NEIGHBORHOOD HOUSE ASSOCIATION ,HS_CHILD_BREAKFAST,21,2208,0,0,2208,14329,0,0,14329,682.3333
SAN DIEGO,Sep 2014,CACF,2014,NEIGHBORHOOD HOUSE ASSOCIATION ,HS_CHILD_LUNCH,21,2208,0,0,2208,19046,0,0,19046,906.9524
SAN DIEGO,Sep 2014,CACF,2014,NEIGHBORHOOD HOUSE ASSOCIATION ,HS_CHILD_SNACK_AM,21,2208,0,0,2208,325,0,0,325,15.4762
SAN DIEGO,Sep 2014,CACF,2014,NEIGHBORHOOD HOUSE ASSOCIATION ,HS_CHILD_SNACK_PM,21,2208,0,0,2208,11315,0,0,11315,538.8095
SAN DIEGO,Oct 2013,CACF,2014,NEXT GENERATION EDUC CTR INC,CHILD_BREAKFAST,22,27,3,78,108,222,25,641,888,40.3636
SAN DIEGO,Oct 2013,CACF,2014,NEXT GENERATION EDUC CTR INC,CHILD_LUNCH,22,27,3,78,108,410,46,1184,1640,74.5455
SAN DIEGO,Oct 2013,CACF,2014,NEXT GENERATION EDUC CTR INC,CHILD_SNACK_AM,22,27,3,78,108,132,15,382,529,24.0455
SAN DIEGO,Oct 2013,CACF,2014,NEXT GENERATION EDUC CTR INC,CHILD_SNACK_PM,22,27,3,78,108,58,6,167,231,10.5
SAN DIEGO,Oct 2013,CACF,2014,NEXT GENERATION EDUC CTR INC,OSCH_CHILD_BREAKFAST,22,10,0,7,17,78,0,54,132,6
SAN DIEGO,Oct 2013,CACF,2014,NEXT GENERATION EDUC CTR INC,OSCH_CHILD_SNACK_PM,22,10,0,7,17,104,0,73,177,8.0455
SAN DIEGO,Nov 2013,CACF,2014,NEXT GENERATION EDUC CTR INC,CHILD_BREAKFAST,19,34,2,63,99,237,14,440,691,36.3684
SAN DIEGO,Nov 2013,CACF,2014,NEXT GENERATION EDUC CTR INC,CHILD_LUNCH,19,34,2,63,99,466,27,863,1356,71.3684
SAN DIEGO,Nov 2013,CACF,2014,NEXT GENERATION EDUC CTR INC,CHILD_SNACK_AM,19,34,2,63,99,403,24,746,1173,61.7368
SAN DIEGO,Nov 2013,CACF,2014,NEXT GENERATION EDUC CTR INC,CHILD_SNACK_PM,19,34,2,63,99,209,12,389,610,32.1053
SAN DIEGO,Nov 2013,CACF,2014,NEXT GENERATION EDUC CTR INC,OSCH_CHILD_BREAKFAST,19,8,0,9,17,62,0,70,132,6.9474
SAN DIEGO,Nov 2013,CACF,2014,NEXT GENERATION EDUC CTR INC,OSCH_CHILD_LUNCH,19,8,0,9,17,17,0,20,37,1.9474
SAN DIEGO,Nov 2013,CACF,2014,NEXT GENERATION EDUC CTR INC,OSCH_CHILD_SNACK_AM,19,8,0,9,17,9,0,10,19,1
SAN DIEGO,Nov 2013,CACF,2014,NEXT GENERATION EDUC CTR INC,OSCH_CHILD_SNACK_PM,19,8,0,9,17,95,0,107,202,10.6316
SAN DIEGO,Dec 2013,CACF,2014,NEXT GENERATION EDUC CTR INC,CHILD_BREAKFAST,21,34,2,63,99,266,16,492,774,36.8571
SAN DIEGO,Dec 2013,CACF,2014,NEXT GENERATION EDUC CTR INC,CHILD_LUNCH,21,34,2,63,99,455,27,842,1324,63.0476
SAN DIEGO,Dec 2013,CACF,2014,NEXT GENERATION EDUC CTR INC,CHILD_SNACK_AM,21,34,2,63,99,390,23,724,1137,54.1429
SAN DIEGO,Dec 2013,CACF,2014,NEXT GENERATION EDUC CTR INC,CHILD_SNACK_PM,21,34,2,63,99,282,17,523,822,39.1429
SAN DIEGO,Dec 2013,CACF,2014,NEXT GENERATION EDUC CTR INC,OSCH_CHILD_BREAKFAST,21,16,0,11,27,86,0,59,145,6.9048
SAN DIEGO,Dec 2013,CACF,2014,NEXT GENERATION EDUC CTR INC,OSCH_CHILD_LUNCH,21,16,0,11,27,69,0,47,116,5.5238
SAN DIEGO,Dec 2013,CACF,2014,NEXT GENERATION EDUC CTR INC,OSCH_CHILD_SNACK_AM,21,16,0,11,27,37,0,25,62,2.9524
SAN DIEGO,Dec 2013,CACF,2014,NEXT GENERATION EDUC CTR INC,OSCH_CHILD_SNACK_PM,21,16,0,11,27,126,0,87,213,10.1429
SAN DIEGO,Jan 2014,CACF,2014,NEXT GENERATION EDUC CTR INC,CHILD_BREAKFAST,22,34,2,63,99,310,18,576,904,41.0909
SAN DIEGO,Jan 2014,CACF,2014,NEXT GENERATION EDUC CTR INC,CHILD_LUNCH,22,34,2,63,99,606,36,1122,1764,80.1818
SAN DIEGO,Jan 2014,CACF,2014,NEXT GENERATION EDUC CTR INC,CHILD_SNACK_AM,22,34,2,63,99,447,26,828,1301,59.1364
SAN DIEGO,Jan 2014,CACF,2014,NEXT GENERATION EDUC CTR INC,CHILD_SNACK_PM,22,34,2,63,99,307,18,568,893,40.5909
SAN DIEGO,Jan 2014,CACF,2014,NEXT GENERATION EDUC CTR INC,OSCH_CHILD_BREAKFAST,22,16,0,11,27,117,0,81,198,9
SAN DIEGO,Jan 2014,CACF,2014,NEXT GENERATION EDUC CTR INC,OSCH_CHILD_LUNCH,22,16,0,11,27,60,0,41,101,4.5909
SAN DIEGO,Jan 2014,CACF,2014,NEXT GENERATION EDUC CTR INC,OSCH_CHILD_SNACK_AM,22,16,0,11,27,56,0,39,95,4.3182
SAN DIEGO,Jan 2014,CACF,2014,NEXT GENERATION EDUC CTR INC,OSCH_CHILD_SNACK_PM,22,16,0,11,27,140,0,97,237,10.7727
SAN DIEGO,Feb 2014,CACF,2014,NEXT GENERATION EDUC CTR INC,CHILD_BREAKFAST,19,34,2,63,99,337,20,623,980,51.5789
SAN DIEGO,Feb 2014,CACF,2014,NEXT GENERATION EDUC CTR INC,CHILD_LUNCH,19,34,2,63,99,576,34,1067,1677,88.2632
SAN DIEGO,Feb 2014,CACF,2014,NEXT GENERATION EDUC CTR INC,CHILD_SNACK_AM,19,34,2,63,99,482,28,895,1405,73.9474
SAN DIEGO,Feb 2014,CACF,2014,NEXT GENERATION EDUC CTR INC,CHILD_SNACK_PM,19,34,2,63,99,245,14,453,712,37.4737
SAN DIEGO,Feb 2014,CACF,2014,NEXT GENERATION EDUC CTR INC,OSCH_CHILD_BREAKFAST,19,16,0,9,25,60,0,33,93,4.8947
SAN DIEGO,Feb 2014,CACF,2014,NEXT GENERATION EDUC CTR INC,OSCH_CHILD_LUNCH,19,16,0,9,25,7,0,4,11,0.5789
SAN DIEGO,Feb 2014,CACF,2014,NEXT GENERATION EDUC CTR INC,OSCH_CHILD_SNACK_AM,19,16,0,9,25,6,0,4,10,0.5263
SAN DIEGO,Feb 2014,CACF,2014,NEXT GENERATION EDUC CTR INC,OSCH_CHILD_SNACK_PM,19,16,0,9,25,179,0,101,280,14.7368
SAN DIEGO,Mar 2014,CACF,2014,NEXT GENERATION EDUC CTR INC,CHILD_BREAKFAST,21,34,2,63,99,320,19,592,931,44.3333
SAN DIEGO,Mar 2014,CACF,2014,NEXT GENERATION EDUC CTR INC,CHILD_LUNCH,21,34,2,63,99,599,35,1111,1745,83.0952
SAN DIEGO,Mar 2014,CACF,2014,NEXT GENERATION EDUC CTR INC,CHILD_SNACK_AM,21,34,2,63,99,491,29,911,1431,68.1429
SAN DIEGO,Mar 2014,CACF,2014,NEXT GENERATION EDUC CTR INC,CHILD_SNACK_PM,21,34,2,63,99,268,16,496,780,37.1429
SAN DIEGO,Mar 2014,CACF,2014,NEXT GENERATION EDUC CTR INC,OSCH_CHILD_BREAKFAST,21,16,0,9,25,130,0,73,203,9.6667
SAN DIEGO,Mar 2014,CACF,2014,NEXT GENERATION EDUC CTR INC,OSCH_CHILD_SNACK_PM,21,16,0,9,25,167,0,94,261,12.4286
SAN DIEGO,Apr 2014,CACF,2014,NEXT GENERATION EDUC CTR INC,CHILD_BREAKFAST,22,34,2,63,99,318,19,588,925,42.0455
SAN DIEGO,Apr 2014,CACF,2014,NEXT GENERATION EDUC CTR INC,CHILD_LUNCH,22,34,2,63,99,620,36,1150,1806,82.0909
SAN DIEGO,Apr 2014,CACF,2014,NEXT GENERATION EDUC CTR INC,CHILD_SNACK_AM,22,34,2,63,99,444,26,823,1293,58.7727
SAN DIEGO,Apr 2014,CACF,2014,NEXT GENERATION EDUC CTR INC,CHILD_SNACK_PM,22,34,2,63,99,329,19,610,958,43.5455
SAN DIEGO,Apr 2014,CACF,2014,NEXT GENERATION EDUC CTR INC,OSCH_CHILD_BREAKFAST,22,16,0,9,25,132,0,74,206,9.3636
SAN DIEGO,Apr 2014,CACF,2014,NEXT GENERATION EDUC CTR INC,OSCH_CHILD_LUNCH,22,16,0,9,25,103,0,58,161,7.3182
SAN DIEGO,Apr 2014,CACF,2014,NEXT GENERATION EDUC CTR INC,OSCH_CHILD_SNACK_AM,22,16,0,9,25,93,0,52,145,6.5909
SAN DIEGO,Apr 2014,CACF,2014,NEXT GENERATION EDUC CTR INC,OSCH_CHILD_SNACK_PM,22,16,0,9,25,147,0,82,229,10.4091
SAN DIEGO,May 2014,CACF,2014,NEXT GENERATION EDUC CTR INC,CHILD_BREAKFAST,21,30,0,52,82,347,0,602,949,45.1905
SAN DIEGO,May 2014,CACF,2014,NEXT GENERATION EDUC CTR INC,CHILD_LUNCH,21,30,0,52,82,611,0,1060,1671,79.5714
SAN DIEGO,May 2014,CACF,2014,NEXT GENERATION EDUC CTR INC,CHILD_SNACK_AM,21,30,0,52,82,502,0,869,1371,65.2857
SAN DIEGO,May 2014,CACF,2014,NEXT GENERATION EDUC CTR INC,CHILD_SNACK_PM,21,30,0,52,82,340,0,588,928,44.1905
SAN DIEGO,May 2014,CACF,2014,NEXT GENERATION EDUC CTR INC,OSCH_CHILD_BREAKFAST,21,16,0,9,25,88,0,50,138,6.5714
SAN DIEGO,May 2014,CACF,2014,NEXT GENERATION EDUC CTR INC,OSCH_CHILD_LUNCH,21,16,0,9,25,8,0,5,13,0.619
SAN DIEGO,May 2014,CACF,2014,NEXT GENERATION EDUC CTR INC,OSCH_CHILD_SNACK_AM,21,16,0,9,25,7,0,4,11,0.5238
SAN DIEGO,May 2014,CACF,2014,NEXT GENERATION EDUC CTR INC,OSCH_CHILD_SNACK_PM,21,16,0,9,25,143,0,80,223,10.619
SAN DIEGO,Jun 2014,CACF,2014,NEXT GENERATION EDUC CTR INC,CHILD_BREAKFAST,21,30,0,52,82,302,0,522,824,39.2381
SAN DIEGO,Jun 2014,CACF,2014,NEXT GENERATION EDUC CTR INC,CHILD_LUNCH,21,30,0,52,82,623,0,1079,1702,81.0476
SAN DIEGO,Jun 2014,CACF,2014,NEXT GENERATION EDUC CTR INC,CHILD_SNACK_AM,21,30,0,52,82,487,0,843,1330,63.3333
SAN DIEGO,Jun 2014,CACF,2014,NEXT GENERATION EDUC CTR INC,CHILD_SNACK_PM,21,30,0,52,82,333,0,578,911,43.381
SAN DIEGO,Jun 2014,CACF,2014,NEXT GENERATION EDUC CTR INC,OSCH_CHILD_BREAKFAST,21,16,0,9,25,36,0,20,56,2.6667
SAN DIEGO,Jun 2014,CACF,2014,NEXT GENERATION EDUC CTR INC,OSCH_CHILD_LUNCH,21,16,0,9,25,75,0,42,117,5.5714
SAN DIEGO,Jun 2014,CACF,2014,NEXT GENERATION EDUC CTR INC,OSCH_CHILD_SNACK_AM,21,16,0,9,25,63,0,35,98,4.6667
SAN DIEGO,Jun 2014,CACF,2014,NEXT GENERATION EDUC CTR INC,OSCH_CHILD_SNACK_PM,21,16,0,9,25,141,0,79,220,10.4762
SAN DIEGO,Jul 2014,CACF,2014,NEXT GENERATION EDUC CTR INC,CHILD_BREAKFAST,22,30,0,52,82,259,0,449,708,32.1818
SAN DIEGO,Jul 2014,CACF,2014,NEXT GENERATION EDUC CTR INC,CHILD_LUNCH,22,30,0,52,82,617,0,1068,1685,76.5909
SAN DIEGO,Jul 2014,CACF,2014,NEXT GENERATION EDUC CTR INC,CHILD_SNACK_AM,22,30,0,52,82,454,0,786,1240,56.3636
SAN DIEGO,Jul 2014,CACF,2014,NEXT GENERATION EDUC CTR INC,CHILD_SNACK_PM,22,30,0,52,82,351,0,609,960,43.6364
SAN DIEGO,Jul 2014,CACF,2014,NEXT GENERATION EDUC CTR INC,OSCH_CHILD_BREAKFAST,22,16,0,9,25,89,0,50,139,6.3182
SAN DIEGO,Jul 2014,CACF,2014,NEXT GENERATION EDUC CTR INC,OSCH_CHILD_LUNCH,22,16,0,9,25,220,0,124,344,15.6364
SAN DIEGO,Jul 2014,CACF,2014,NEXT GENERATION EDUC CTR INC,OSCH_CHILD_SNACK_AM,22,16,0,9,25,205,0,116,321,14.5909
SAN DIEGO,Jul 2014,CACF,2014,NEXT GENERATION EDUC CTR INC,OSCH_CHILD_SNACK_PM,22,16,0,9,25,128,0,72,200,9.0909
SAN DIEGO,Aug 2014,CACF,2014,NEXT GENERATION EDUC CTR INC,CHILD_BREAKFAST,21,30,0,52,82,267,0,464,731,34.8095
SAN DIEGO,Aug 2014,CACF,2014,NEXT GENERATION EDUC CTR INC,CHILD_LUNCH,21,30,0,52,82,604,0,1048,1652,78.6667
SAN DIEGO,Aug 2014,CACF,2014,NEXT GENERATION EDUC CTR INC,CHILD_SNACK_AM,21,30,0,52,82,456,0,790,1246,59.3333
SAN DIEGO,Aug 2014,CACF,2014,NEXT GENERATION EDUC CTR INC,CHILD_SNACK_PM,21,30,0,52,82,336,0,582,918,43.7143
SAN DIEGO,Aug 2014,CACF,2014,NEXT GENERATION EDUC CTR INC,OSCH_CHILD_BREAKFAST,21,16,0,9,25,52,0,30,82,3.9048
SAN DIEGO,Aug 2014,CACF,2014,NEXT GENERATION EDUC CTR INC,OSCH_CHILD_LUNCH,21,16,0,9,25,120,0,67,187,8.9048
SAN DIEGO,Aug 2014,CACF,2014,NEXT GENERATION EDUC CTR INC,OSCH_CHILD_SNACK_AM,21,16,0,9,25,119,0,67,186,8.8571
SAN DIEGO,Aug 2014,CACF,2014,NEXT GENERATION EDUC CTR INC,OSCH_CHILD_SNACK_PM,21,16,0,9,25,140,0,79,219,10.4286
SAN DIEGO,Sep 2014,CACF,2014,NEXT GENERATION EDUC CTR INC,CHILD_BREAKFAST,21,30,0,52,82,292,0,507,799,38.0476
SAN DIEGO,Sep 2014,CACF,2014,NEXT GENERATION EDUC CTR INC,CHILD_LUNCH,21,30,0,52,82,605,0,1049,1654,78.7619
SAN DIEGO,Sep 2014,CACF,2014,NEXT GENERATION EDUC CTR INC,CHILD_SNACK_AM,21,30,0,52,82,488,0,846,1334,63.5238
SAN DIEGO,Sep 2014,CACF,2014,NEXT GENERATION EDUC CTR INC,CHILD_SNACK_PM,21,30,0,52,82,305,0,528,833,39.6667
SAN DIEGO,Sep 2014,CACF,2014,NEXT GENERATION EDUC CTR INC,OSCH_CHILD_BREAKFAST,21,12,0,5,17,58,0,24,82,3.9048
SAN DIEGO,Sep 2014,CACF,2014,NEXT GENERATION EDUC CTR INC,OSCH_CHILD_SNACK_PM,21,12,0,5,17,184,0,76,260,12.381
SAN DIEGO,Oct 2013,CACF,2014,NORTH COUNTY COMMUNITY SERVICE ,CHILD_BREAKFAST,23,332,75,24,431,4666,1054,337,6057,263.3478
SAN DIEGO,Oct 2013,CACF,2014,NORTH COUNTY COMMUNITY SERVICE ,CHILD_LUNCH,23,332,75,24,431,4827,1090,349,6266,272.4348
SAN DIEGO,Oct 2013,CACF,2014,NORTH COUNTY COMMUNITY SERVICE ,CHILD_SNACK_PM,23,332,75,24,431,3232,730,234,4196,182.4348
SAN DIEGO,Nov 2013,CACF,2014,NORTH COUNTY COMMUNITY SERVICE ,CHILD_BREAKFAST,19,332,75,24,431,3593,812,260,4665,245.5263
SAN DIEGO,Nov 2013,CACF,2014,NORTH COUNTY COMMUNITY SERVICE ,CHILD_LUNCH,19,332,75,24,431,3792,857,274,4923,259.1053
SAN DIEGO,Nov 2013,CACF,2014,NORTH COUNTY COMMUNITY SERVICE ,CHILD_SNACK_PM,19,332,75,24,431,2477,560,179,3216,169.2632
SAN DIEGO,Dec 2013,CACF,2014,NORTH COUNTY COMMUNITY SERVICE ,CHILD_BREAKFAST,15,332,75,24,431,3228,729,234,4191,279.4
SAN DIEGO,Dec 2013,CACF,2014,NORTH COUNTY COMMUNITY SERVICE ,CHILD_LUNCH,15,332,75,24,431,3492,789,252,4533,302.2
SAN DIEGO,Dec 2013,CACF,2014,NORTH COUNTY COMMUNITY SERVICE ,CHILD_SNACK_PM,15,332,75,24,431,2208,499,160,2867,191.1333
SAN DIEGO,Jan 2014,CACF,2014,NORTH COUNTY COMMUNITY SERVICE ,CHILD_BREAKFAST,21,332,75,24,431,3924,886,284,5094,242.5714
SAN DIEGO,Jan 2014,CACF,2014,NORTH COUNTY COMMUNITY SERVICE ,CHILD_LUNCH,21,332,75,24,431,4205,950,304,5459,259.9524
SAN DIEGO,Jan 2014,CACF,2014,NORTH COUNTY COMMUNITY SERVICE ,CHILD_SNACK_PM,21,332,75,24,431,2743,620,198,3561,169.5714
SAN DIEGO,Feb 2014,CACF,2014,NORTH COUNTY COMMUNITY SERVICE ,CHILD_BREAKFAST,19,326,82,26,434,3622,911,288,4821,253.7368
SAN DIEGO,Feb 2014,CACF,2014,NORTH COUNTY COMMUNITY SERVICE ,CHILD_LUNCH,19,326,82,26,434,3911,984,312,5207,274.0526
SAN DIEGO,Feb 2014,CACF,2014,NORTH COUNTY COMMUNITY SERVICE ,CHILD_SNACK_PM,19,326,82,26,434,2509,631,200,3340,175.7895
SAN DIEGO,Mar 2014,CACF,2014,NORTH COUNTY COMMUNITY SERVICE ,CHILD_BREAKFAST,21,326,82,26,434,3878,975,309,5162,245.8095
SAN DIEGO,Mar 2014,CACF,2014,NORTH COUNTY COMMUNITY SERVICE ,CHILD_LUNCH,21,326,82,26,434,4237,1065,338,5640,268.5714
SAN DIEGO,Mar 2014,CACF,2014,NORTH COUNTY COMMUNITY SERVICE ,CHILD_SNACK_PM,21,326,82,26,434,2758,693,220,3671,174.8095
SAN DIEGO,Apr 2014,CACF,2014,NORTH COUNTY COMMUNITY SERVICE ,CHILD_BREAKFAST,22,326,82,26,434,4386,1103,350,5839,265.4091
SAN DIEGO,Apr 2014,CACF,2014,NORTH COUNTY COMMUNITY SERVICE ,CHILD_LUNCH,22,326,82,26,434,4647,1169,370,6186,281.1818
SAN DIEGO,Apr 2014,CACF,2014,NORTH COUNTY COMMUNITY SERVICE ,CHILD_SNACK_PM,22,326,82,26,434,3234,813,258,4305,195.6818
SAN DIEGO,May 2014,CACF,2014,NORTH COUNTY COMMUNITY SERVICE ,CHILD_BREAKFAST,21,326,82,26,434,3826,962,305,5093,242.5238
SAN DIEGO,May 2014,CACF,2014,NORTH COUNTY COMMUNITY SERVICE ,CHILD_LUNCH,21,326,82,26,434,4000,1006,319,5325,253.5714
SAN DIEGO,May 2014,CACF,2014,NORTH COUNTY COMMUNITY SERVICE ,CHILD_SNACK_PM,21,326,82,26,434,2730,686,218,3634,173.0476
SAN DIEGO,Jun 2014,CACF,2014,NORTH COUNTY COMMUNITY SERVICE ,CHILD_BREAKFAST,21,326,82,26,434,3475,874,277,4626,220.2857
SAN DIEGO,Jun 2014,CACF,2014,NORTH COUNTY COMMUNITY SERVICE ,CHILD_LUNCH,21,326,82,26,434,3647,917,291,4855,231.1905
SAN DIEGO,Jun 2014,CACF,2014,NORTH COUNTY COMMUNITY SERVICE ,CHILD_SNACK_PM,21,326,82,26,434,2424,610,193,3227,153.6667
SAN DIEGO,Jul 2014,CACF,2014,NORTH COUNTY COMMUNITY SERVICE ,CHILD_BREAKFAST,22,326,82,26,434,3029,762,241,4032,183.2727
SAN DIEGO,Jul 2014,CACF,2014,NORTH COUNTY COMMUNITY SERVICE ,CHILD_LUNCH,22,326,82,26,434,3480,875,278,4633,210.5909
SAN DIEGO,Jul 2014,CACF,2014,NORTH COUNTY COMMUNITY SERVICE ,CHILD_SNACK_PM,22,326,82,26,434,2864,720,229,3813,173.3182
SAN DIEGO,Aug 2014,CACF,2014,NORTH COUNTY COMMUNITY SERVICE ,CHILD_BREAKFAST,21,326,82,26,434,2891,727,231,3849,183.2857
SAN DIEGO,Aug 2014,CACF,2014,NORTH COUNTY COMMUNITY SERVICE ,CHILD_LUNCH,21,326,82,26,434,3229,812,257,4298,204.6667
SAN DIEGO,Aug 2014,CACF,2014,NORTH COUNTY COMMUNITY SERVICE ,CHILD_SNACK_PM,21,326,82,26,434,2505,630,199,3334,158.7619
SAN DIEGO,Sep 2014,CACF,2014,NORTH COUNTY COMMUNITY SERVICE ,CHILD_BREAKFAST,22,326,82,26,434,3812,959,304,5075,230.6818
SAN DIEGO,Sep 2014,CACF,2014,NORTH COUNTY COMMUNITY SERVICE ,CHILD_LUNCH,22,326,82,26,434,3998,1005,319,5322,241.9091
SAN DIEGO,Sep 2014,CACF,2014,NORTH COUNTY COMMUNITY SERVICE ,CHILD_SNACK_PM,22,326,82,26,434,2637,663,211,3511,159.5909
SAN DIEGO,Oct 2013,CACF,2014,NORTH COUNTY SERENITY HOUSE INC ,CHILD_BREAKFAST,23,45,15,2,62,579,193,26,798,34.6957
SAN DIEGO,Oct 2013,CACF,2014,NORTH COUNTY SERENITY HOUSE INC ,CHILD_LUNCH,23,45,15,2,62,852,284,38,1174,51.0435
SAN DIEGO,Oct 2013,CACF,2014,NORTH COUNTY SERENITY HOUSE INC ,CHILD_SNACK_PM,23,45,15,2,62,647,216,29,892,38.7826
SAN DIEGO,Nov 2013,CACF,2014,NORTH COUNTY SERENITY HOUSE INC ,CHILD_BREAKFAST,18,53,16,3,72,503,152,28,683,37.9444
SAN DIEGO,Nov 2013,CACF,2014,NORTH COUNTY SERENITY HOUSE INC ,CHILD_LUNCH,18,53,16,3,72,541,163,31,735,40.8333
SAN DIEGO,Nov 2013,CACF,2014,NORTH COUNTY SERENITY HOUSE INC ,CHILD_SNACK_AM,18,53,16,3,72,721,218,41,980,54.4444
SAN DIEGO,Dec 2013,CACF,2014,NORTH COUNTY SERENITY HOUSE INC ,CHILD_BREAKFAST,17,53,16,3,72,521,157,30,708,41.6471
SAN DIEGO,Dec 2013,CACF,2014,NORTH COUNTY SERENITY HOUSE INC ,CHILD_LUNCH,17,53,16,3,72,704,212,40,956,56.2353
SAN DIEGO,Dec 2013,CACF,2014,NORTH COUNTY SERENITY HOUSE INC ,CHILD_SNACK_PM,17,53,16,3,72,498,150,28,676,39.7647
SAN DIEGO,Jan 2014,CACF,2014,NORTH COUNTY SERENITY HOUSE INC ,CHILD_BREAKFAST,21,53,16,3,72,623,188,35,846,40.2857
SAN DIEGO,Jan 2014,CACF,2014,NORTH COUNTY SERENITY HOUSE INC ,CHILD_LUNCH,21,53,16,3,72,842,254,48,1144,54.4762
SAN DIEGO,Jan 2014,CACF,2014,NORTH COUNTY SERENITY HOUSE INC ,CHILD_SNACK_PM,21,53,16,3,72,628,190,35,853,40.619
SAN DIEGO,Feb 2014,CACF,2014,NORTH COUNTY SERENITY HOUSE INC ,CHILD_BREAKFAST,19,53,16,3,72,582,176,33,791,41.6316
SAN DIEGO,Feb 2014,CACF,2014,NORTH COUNTY SERENITY HOUSE INC ,CHILD_LUNCH,19,53,16,3,72,815,246,46,1107,58.2632
SAN DIEGO,Feb 2014,CACF,2014,NORTH COUNTY SERENITY HOUSE INC ,CHILD_SNACK_PM,19,53,16,3,72,632,191,35,858,45.1579
SAN DIEGO,Mar 2014,CACF,2014,NORTH COUNTY SERENITY HOUSE INC ,CHILD_BREAKFAST,21,53,16,3,72,604,182,34,820,39.0476
SAN DIEGO,Mar 2014,CACF,2014,NORTH COUNTY SERENITY HOUSE INC ,CHILD_LUNCH,21,53,16,3,72,844,255,47,1146,54.5714
SAN DIEGO,Mar 2014,CACF,2014,NORTH COUNTY SERENITY HOUSE INC ,CHILD_SNACK_PM,21,53,16,3,72,657,198,37,892,42.4762
SAN DIEGO,Apr 2014,CACF,2014,NORTH COUNTY SERENITY HOUSE INC ,CHILD_BREAKFAST,22,53,16,3,72,565,170,32,767,34.8636
SAN DIEGO,Apr 2014,CACF,2014,NORTH COUNTY SERENITY HOUSE INC ,CHILD_LUNCH,22,53,16,3,72,850,257,48,1155,52.5
SAN DIEGO,Apr 2014,CACF,2014,NORTH COUNTY SERENITY HOUSE INC ,CHILD_SNACK_PM,22,53,16,3,72,646,195,36,877,39.8636
SAN DIEGO,May 2014,CACF,2014,NORTH COUNTY SERENITY HOUSE INC ,CHILD_BREAKFAST,19,53,16,3,72,487,147,28,662,34.8421
SAN DIEGO,May 2014,CACF,2014,NORTH COUNTY SERENITY HOUSE INC ,CHILD_LUNCH,19,53,16,3,72,760,230,43,1033,54.3684
SAN DIEGO,May 2014,CACF,2014,NORTH COUNTY SERENITY HOUSE INC ,CHILD_SNACK_PM,19,53,16,3,72,606,183,34,823,43.3158
SAN DIEGO,Jun 2014,CACF,2014,NORTH COUNTY SERENITY HOUSE INC ,CHILD_BREAKFAST,21,53,16,3,72,509,154,29,692,32.9524
SAN DIEGO,Jun 2014,CACF,2014,NORTH COUNTY SERENITY HOUSE INC ,CHILD_LUNCH,21,53,16,3,72,761,230,43,1034,49.2381
SAN DIEGO,Jun 2014,CACF,2014,NORTH COUNTY SERENITY HOUSE INC ,CHILD_SNACK_PM,21,53,16,3,72,612,185,34,831,39.5714
SAN DIEGO,Jul 2014,CACF,2014,NORTH COUNTY SERENITY HOUSE INC ,CHILD_BREAKFAST,22,53,16,3,72,566,171,32,769,34.9545
SAN DIEGO,Jul 2014,CACF,2014,NORTH COUNTY SERENITY HOUSE INC ,CHILD_LUNCH,22,53,16,3,72,833,252,47,1132,51.4545
SAN DIEGO,Jul 2014,CACF,2014,NORTH COUNTY SERENITY HOUSE INC ,CHILD_SNACK_PM,22,53,16,3,72,665,201,38,904,41.0909
SAN DIEGO,Aug 2014,CACF,2014,NORTH COUNTY SERENITY HOUSE INC ,CHILD_BREAKFAST,21,53,16,3,72,556,168,31,755,35.9524
SAN DIEGO,Aug 2014,CACF,2014,NORTH COUNTY SERENITY HOUSE INC ,CHILD_LUNCH,21,53,16,3,72,787,238,44,1069,50.9048
SAN DIEGO,Aug 2014,CACF,2014,NORTH COUNTY SERENITY HOUSE INC ,CHILD_SNACK_PM,21,53,16,3,72,601,181,34,816,38.8571
SAN DIEGO,Sep 2014,CACF,2014,NORTH COUNTY SERENITY HOUSE INC ,CHILD_BREAKFAST,21,53,16,3,72,578,174,33,785,37.381
SAN DIEGO,Sep 2014,CACF,2014,NORTH COUNTY SERENITY HOUSE INC ,CHILD_LUNCH,21,53,16,3,72,837,253,47,1137,54.1429
SAN DIEGO,Sep 2014,CACF,2014,NORTH COUNTY SERENITY HOUSE INC ,CHILD_SNACK_PM,21,53,16,3,72,640,193,36,869,41.381
SAN DIEGO,Jan 2014,CACF,2014,OAK TREE ACADEMY LLC,CHILD_BREAKFAST,9,28,8,27,63,164,47,158,369,41
SAN DIEGO,Jan 2014,CACF,2014,OAK TREE ACADEMY LLC,CHILD_LUNCH,9,28,8,27,63,189,54,182,425,47.2222
SAN DIEGO,Jan 2014,CACF,2014,OAK TREE ACADEMY LLC,CHILD_SNACK_PM,9,28,8,27,63,164,47,159,370,41.1111
SAN DIEGO,Feb 2014,CACF,2014,OAK TREE ACADEMY LLC,CHILD_BREAKFAST,19,28,8,27,63,308,88,298,694,36.5263
SAN DIEGO,Feb 2014,CACF,2014,OAK TREE ACADEMY LLC,CHILD_LUNCH,19,28,8,27,63,387,111,373,871,45.8421
SAN DIEGO,Feb 2014,CACF,2014,OAK TREE ACADEMY LLC,CHILD_SNACK_PM,19,28,8,27,63,318,91,307,716,37.6842
SAN DIEGO,Mar 2014,CACF,2014,OAK TREE ACADEMY LLC,CHILD_BREAKFAST,21,29,9,27,65,352,109,327,788,37.5238
SAN DIEGO,Mar 2014,CACF,2014,OAK TREE ACADEMY LLC,CHILD_LUNCH,21,29,9,27,65,422,131,393,946,45.0476
SAN DIEGO,Mar 2014,CACF,2014,OAK TREE ACADEMY LLC,CHILD_SNACK_PM,21,29,9,27,65,374,116,349,839,39.9524
SAN DIEGO,Apr 2014,CACF,2014,OAK TREE ACADEMY LLC,CHILD_BREAKFAST,22,31,8,26,65,329,85,275,689,31.3182
SAN DIEGO,Apr 2014,CACF,2014,OAK TREE ACADEMY LLC,CHILD_LUNCH,22,31,8,26,65,404,104,340,848,38.5455
SAN DIEGO,Apr 2014,CACF,2014,OAK TREE ACADEMY LLC,CHILD_SNACK_PM,22,31,8,26,65,359,93,301,753,34.2273
SAN DIEGO,May 2014,CACF,2014,OAK TREE ACADEMY LLC,CHILD_BREAKFAST,21,35,7,28,70,479,96,383,958,45.619
SAN DIEGO,May 2014,CACF,2014,OAK TREE ACADEMY LLC,CHILD_LUNCH,21,35,7,28,70,566,113,452,1131,53.8571
SAN DIEGO,May 2014,CACF,2014,OAK TREE ACADEMY LLC,CHILD_SNACK_PM,21,35,7,28,70,493,99,393,985,46.9048
SAN DIEGO,Jun 2014,CACF,2014,OAK TREE ACADEMY LLC,CHILD_BREAKFAST,21,32,8,31,71,427,107,413,947,45.0952
SAN DIEGO,Jun 2014,CACF,2014,OAK TREE ACADEMY LLC,CHILD_LUNCH,21,32,8,31,71,495,124,480,1099,52.3333
SAN DIEGO,Jun 2014,CACF,2014,OAK TREE ACADEMY LLC,CHILD_SNACK_PM,21,32,8,31,71,443,111,430,984,46.8571
SAN DIEGO,Jul 2014,CACF,2014,OAK TREE ACADEMY LLC,CHILD_BREAKFAST,22,32,8,31,71,363,91,352,806,36.6364
SAN DIEGO,Jul 2014,CACF,2014,OAK TREE ACADEMY LLC,CHILD_LUNCH,22,32,8,31,71,440,110,427,977,44.4091
SAN DIEGO,Jul 2014,CACF,2014,OAK TREE ACADEMY LLC,CHILD_SNACK_PM,22,32,8,31,71,408,102,395,905,41.1364
SAN DIEGO,Aug 2014,CACF,2014,OAK TREE ACADEMY LLC,CHILD_BREAKFAST,21,22,6,26,54,289,79,342,710,33.8095
SAN DIEGO,Aug 2014,CACF,2014,OAK TREE ACADEMY LLC,CHILD_LUNCH,21,22,6,26,54,344,94,406,844,40.1905
SAN DIEGO,Aug 2014,CACF,2014,OAK TREE ACADEMY LLC,CHILD_SNACK_PM,21,22,6,26,54,297,81,350,728,34.6667
SAN DIEGO,Sep 2014,CACF,2014,OAK TREE ACADEMY LLC,CHILD_BREAKFAST,21,22,6,26,54,375,102,443,920,43.8095
SAN DIEGO,Sep 2014,CACF,2014,OAK TREE ACADEMY LLC,CHILD_LUNCH,21,22,6,26,54,417,114,492,1023,48.7143
SAN DIEGO,Sep 2014,CACF,2014,OAK TREE ACADEMY LLC,CHILD_SNACK_PM,21,22,6,26,54,347,95,410,852,40.5714
SAN DIEGO,Oct 2013,CACF,2014,OCEAN BEACH CHILD CARE PROJECT CHILDRENS CIRCLE,CHILD_BREAKFAST,23,29,10,1,40,463,160,16,639,27.7826
SAN DIEGO,Oct 2013,CACF,2014,OCEAN BEACH CHILD CARE PROJECT CHILDRENS CIRCLE,CHILD_LUNCH,23,29,10,1,40,537,185,19,741,32.2174
SAN DIEGO,Oct 2013,CACF,2014,OCEAN BEACH CHILD CARE PROJECT CHILDRENS CIRCLE,CHILD_SNACK_PM,23,29,10,1,40,442,153,15,610,26.5217
SAN DIEGO,Nov 2013,CACF,2014,OCEAN BEACH CHILD CARE PROJECT CHILDRENS CIRCLE,CHILD_BREAKFAST,18,29,10,1,40,346,119,12,477,26.5
SAN DIEGO,Nov 2013,CACF,2014,OCEAN BEACH CHILD CARE PROJECT CHILDRENS CIRCLE,CHILD_LUNCH,18,29,10,1,40,431,149,15,595,33.0556
SAN DIEGO,Nov 2013,CACF,2014,OCEAN BEACH CHILD CARE PROJECT CHILDRENS CIRCLE,CHILD_SNACK_PM,18,29,10,1,40,347,120,12,479,26.6111
SAN DIEGO,Dec 2013,CACF,2014,OCEAN BEACH CHILD CARE PROJECT CHILDRENS CIRCLE,CHILD_BREAKFAST,15,29,10,1,40,290,100,10,400,26.6667
SAN DIEGO,Dec 2013,CACF,2014,OCEAN BEACH CHILD CARE PROJECT CHILDRENS CIRCLE,CHILD_LUNCH,15,29,10,1,40,374,129,13,516,34.4
SAN DIEGO,Dec 2013,CACF,2014,OCEAN BEACH CHILD CARE PROJECT CHILDRENS CIRCLE,CHILD_SNACK_PM,15,29,10,1,40,308,106,11,425,28.3333
SAN DIEGO,Jan 2014,CACF,2014,OCEAN BEACH CHILD CARE PROJECT CHILDRENS CIRCLE,CHILD_BREAKFAST,22,29,10,1,40,374,129,13,516,23.4545
SAN DIEGO,Jan 2014,CACF,2014,OCEAN BEACH CHILD CARE PROJECT CHILDRENS CIRCLE,CHILD_LUNCH,22,29,10,1,40,507,175,17,699,31.7727
SAN DIEGO,Jan 2014,CACF,2014,OCEAN BEACH CHILD CARE PROJECT CHILDRENS CIRCLE,CHILD_SNACK_PM,22,29,10,1,40,391,135,13,539,24.5
SAN DIEGO,Feb 2014,CACF,2014,OCEAN BEACH CHILD CARE PROJECT CHILDRENS CIRCLE,CHILD_BREAKFAST,20,29,10,1,40,386,133,13,532,26.6
SAN DIEGO,Feb 2014,CACF,2014,OCEAN BEACH CHILD CARE PROJECT CHILDRENS CIRCLE,CHILD_LUNCH,20,29,10,1,40,486,168,16,670,33.5
SAN DIEGO,Feb 2014,CACF,2014,OCEAN BEACH CHILD CARE PROJECT CHILDRENS CIRCLE,CHILD_SNACK_PM,20,29,10,1,40,402,139,13,554,27.7
SAN DIEGO,Mar 2014,CACF,2014,OCEAN BEACH CHILD CARE PROJECT CHILDRENS CIRCLE,CHILD_BREAKFAST,21,29,10,1,40,413,142,14,569,27.0952
SAN DIEGO,Mar 2014,CACF,2014,OCEAN BEACH CHILD CARE PROJECT CHILDRENS CIRCLE,CHILD_LUNCH,21,29,10,1,40,530,183,18,731,34.8095
SAN DIEGO,Mar 2014,CACF,2014,OCEAN BEACH CHILD CARE PROJECT CHILDRENS CIRCLE,CHILD_SNACK_PM,21,29,10,1,40,421,145,14,580,27.619
SAN DIEGO,Apr 2014,CACF,2014,OCEAN BEACH CHILD CARE PROJECT CHILDRENS CIRCLE,CHILD_BREAKFAST,22,29,10,1,40,407,140,14,561,25.5
SAN DIEGO,Apr 2014,CACF,2014,OCEAN BEACH CHILD CARE PROJECT CHILDRENS CIRCLE,CHILD_LUNCH,22,29,10,1,40,497,171,17,685,31.1364
SAN DIEGO,Apr 2014,CACF,2014,OCEAN BEACH CHILD CARE PROJECT CHILDRENS CIRCLE,CHILD_SNACK_PM,22,29,10,1,40,424,146,15,585,26.5909
SAN DIEGO,May 2014,CACF,2014,OCEAN BEACH CHILD CARE PROJECT CHILDRENS CIRCLE,CHILD_BREAKFAST,20,29,10,1,40,360,124,13,497,24.85
SAN DIEGO,May 2014,CACF,2014,OCEAN BEACH CHILD CARE PROJECT CHILDRENS CIRCLE,CHILD_LUNCH,20,29,10,1,40,452,156,16,624,31.2
SAN DIEGO,May 2014,CACF,2014,OCEAN BEACH CHILD CARE PROJECT CHILDRENS CIRCLE,CHILD_SNACK_PM,20,29,10,1,40,397,137,14,548,27.4
SAN DIEGO,Jun 2014,CACF,2014,OCEAN BEACH CHILD CARE PROJECT CHILDRENS CIRCLE,CHILD_BREAKFAST,21,29,10,1,40,341,118,12,471,22.4286
SAN DIEGO,Jun 2014,CACF,2014,OCEAN BEACH CHILD CARE PROJECT CHILDRENS CIRCLE,CHILD_LUNCH,21,29,10,1,40,457,158,16,631,30.0476
SAN DIEGO,Jun 2014,CACF,2014,OCEAN BEACH CHILD CARE PROJECT CHILDRENS CIRCLE,CHILD_SNACK_PM,21,29,10,1,40,386,133,14,533,25.381
SAN DIEGO,Jul 2014,CACF,2014,OCEAN BEACH CHILD CARE PROJECT CHILDRENS CIRCLE,CHILD_BREAKFAST,22,29,10,1,40,368,127,13,508,23.0909
SAN DIEGO,Jul 2014,CACF,2014,OCEAN BEACH CHILD CARE PROJECT CHILDRENS CIRCLE,CHILD_LUNCH,22,29,10,1,40,541,187,18,746,33.9091
SAN DIEGO,Jul 2014,CACF,2014,OCEAN BEACH CHILD CARE PROJECT CHILDRENS CIRCLE,CHILD_SNACK_PM,22,29,10,1,40,455,157,16,628,28.5455
SAN DIEGO,Aug 2014,CACF,2014,OCEAN BEACH CHILD CARE PROJECT CHILDRENS CIRCLE,CHILD_BREAKFAST,21,29,10,1,40,404,139,14,557,26.5238
SAN DIEGO,Aug 2014,CACF,2014,OCEAN BEACH CHILD CARE PROJECT CHILDRENS CIRCLE,CHILD_LUNCH,21,29,10,1,40,550,190,19,759,36.1429
SAN DIEGO,Aug 2014,CACF,2014,OCEAN BEACH CHILD CARE PROJECT CHILDRENS CIRCLE,CHILD_SNACK_PM,21,29,10,1,40,468,161,16,645,30.7143
SAN DIEGO,Sep 2014,CACF,2014,OCEAN BEACH CHILD CARE PROJECT CHILDRENS CIRCLE,CHILD_BREAKFAST,21,29,10,1,40,420,145,14,579,27.5714
SAN DIEGO,Sep 2014,CACF,2014,OCEAN BEACH CHILD CARE PROJECT CHILDRENS CIRCLE,CHILD_LUNCH,21,29,10,1,40,514,177,18,709,33.7619
SAN DIEGO,Sep 2014,CACF,2014,OCEAN BEACH CHILD CARE PROJECT CHILDRENS CIRCLE,CHILD_SNACK_PM,21,29,10,1,40,456,157,16,629,29.9524
SAN DIEGO,Nov 2013,CACF,2014,Oceanside Unified School District,ATRISK_CHILD_SUPPER,11,112,0,0,112,1179,0,0,1179,107.1818
SAN DIEGO,Dec 2013,CACF,2014,Oceanside Unified School District,ATRISK_CHILD_SUPPER,14,112,0,0,112,1457,0,0,1457,104.0714
SAN DIEGO,Jan 2014,CACF,2014,Oceanside Unified School District,ATRISK_CHILD_SUPPER,19,109,0,0,109,1889,0,0,1889,99.4211
SAN DIEGO,Feb 2014,CACF,2014,Oceanside Unified School District,ATRISK_CHILD_SUPPER,15,298,0,0,298,3865,0,0,3865,257.6667
SAN DIEGO,Mar 2014,CACF,2014,Oceanside Unified School District,ATRISK_CHILD_SUPPER,20,317,0,0,317,5201,0,0,5201,260.05
SAN DIEGO,Apr 2014,CACF,2014,Oceanside Unified School District,ATRISK_CHILD_SUPPER,18,820,0,0,820,11484,0,0,11484,638
SAN DIEGO,May 2014,CACF,2014,Oceanside Unified School District,ATRISK_CHILD_SUPPER,19,880,0,0,880,11917,0,0,11917,627.2105
SAN DIEGO,Jun 2014,CACF,2014,Oceanside Unified School District,ATRISK_CHILD_SUPPER,3,598,0,0,598,1379,0,0,1379,459.6667
SAN DIEGO,Aug 2014,CACF,2014,Oceanside Unified School District,ATRISK_CHILD_SUPPER,10,892,0,0,892,6240,0,0,6240,624
SAN DIEGO,Sep 2014,CACF,2014,Oceanside Unified School District,ATRISK_CHILD_SUPPER,21,1022,0,0,1022,18641,0,0,18641,887.6667
SAN DIEGO,Oct 2013,CACF,2014,OPEN ARMS ADHC INC,ADULT_BREAKFAST,23,154,0,0,154,962,0,0,962,41.8261
SAN DIEGO,Oct 2013,CACF,2014,OPEN ARMS ADHC INC,ADULT_LUNCH,23,154,0,0,154,1458,0,0,1458,63.3913
SAN DIEGO,Oct 2013,CACF,2014,OPEN ARMS ADHC INC,ADULT_SNACK_AM,23,154,0,0,154,495,0,0,495,21.5217
SAN DIEGO,Oct 2013,CACF,2014,OPEN ARMS ADHC INC,ADULT_SNACK_PM,23,154,0,0,154,508,0,0,508,22.087
SAN DIEGO,Nov 2013,CACF,2014,OPEN ARMS ADHC INC,ADULT_BREAKFAST,19,129,0,0,129,783,0,0,783,41.2105
SAN DIEGO,Nov 2013,CACF,2014,OPEN ARMS ADHC INC,ADULT_LUNCH,19,129,0,0,129,1162,0,0,1162,61.1579
SAN DIEGO,Nov 2013,CACF,2014,OPEN ARMS ADHC INC,ADULT_SNACK_AM,19,129,0,0,129,361,0,0,361,19
SAN DIEGO,Nov 2013,CACF,2014,OPEN ARMS ADHC INC,ADULT_SNACK_PM,19,129,0,0,129,391,0,0,391,20.5789
SAN DIEGO,Dec 2013,CACF,2014,OPEN ARMS ADHC INC,ADULT_BREAKFAST,20,156,0,0,156,814,0,0,814,40.7
SAN DIEGO,Dec 2013,CACF,2014,OPEN ARMS ADHC INC,ADULT_LUNCH,20,156,0,0,156,1148,0,0,1148,57.4
SAN DIEGO,Dec 2013,CACF,2014,OPEN ARMS ADHC INC,ADULT_SNACK_AM,20,156,0,0,156,334,0,0,334,16.7
SAN DIEGO,Dec 2013,CACF,2014,OPEN ARMS ADHC INC,ADULT_SNACK_PM,20,156,0,0,156,354,0,0,354,17.7
SAN DIEGO,Jan 2014,CACF,2014,OPEN ARMS ADHC INC,ADULT_BREAKFAST,14,158,0,0,158,168,0,0,168,12
SAN DIEGO,Jan 2014,CACF,2014,OPEN ARMS ADHC INC,ADULT_LUNCH,14,158,0,0,158,854,0,0,854,61
SAN DIEGO,Jan 2014,CACF,2014,OPEN ARMS ADHC INC,ADULT_SNACK_AM,14,158,0,0,158,297,0,0,297,21.2143
SAN DIEGO,Jan 2014,CACF,2014,OPEN ARMS ADHC INC,ADULT_SNACK_PM,14,158,0,0,158,297,0,0,297,21.2143
SAN DIEGO,Feb 2014,CACF,2014,OPEN ARMS ADHC INC,ADULT_BREAKFAST,20,143,0,0,143,795,0,0,795,39.75
SAN DIEGO,Feb 2014,CACF,2014,OPEN ARMS ADHC INC,ADULT_LUNCH,20,143,0,0,143,1189,0,0,1189,59.45
SAN DIEGO,Feb 2014,CACF,2014,OPEN ARMS ADHC INC,ADULT_SNACK_AM,20,143,0,0,143,378,0,0,378,18.9
SAN DIEGO,Feb 2014,CACF,2014,OPEN ARMS ADHC INC,ADULT_SNACK_PM,20,143,0,0,143,378,0,0,378,18.9
SAN DIEGO,Mar 2014,CACF,2014,OPEN ARMS ADHC INC,ADULT_BREAKFAST,21,143,0,0,143,816,0,0,816,38.8571
SAN DIEGO,Mar 2014,CACF,2014,OPEN ARMS ADHC INC,ADULT_LUNCH,21,143,0,0,143,1211,0,0,1211,57.6667
SAN DIEGO,Mar 2014,CACF,2014,OPEN ARMS ADHC INC,ADULT_SNACK_AM,21,143,0,0,143,395,0,0,395,18.8095
SAN DIEGO,Mar 2014,CACF,2014,OPEN ARMS ADHC INC,ADULT_SNACK_PM,21,143,0,0,143,404,0,0,404,19.2381
SAN DIEGO,Apr 2014,CACF,2014,OPEN ARMS ADHC INC,ADULT_BREAKFAST,22,143,0,0,143,894,0,0,894,40.6364
SAN DIEGO,Apr 2014,CACF,2014,OPEN ARMS ADHC INC,ADULT_LUNCH,22,143,0,0,143,1292,0,0,1292,58.7273
SAN DIEGO,Apr 2014,CACF,2014,OPEN ARMS ADHC INC,ADULT_SNACK_AM,22,143,0,0,143,398,0,0,398,18.0909
SAN DIEGO,Apr 2014,CACF,2014,OPEN ARMS ADHC INC,ADULT_SNACK_PM,22,143,0,0,143,398,0,0,398,18.0909
SAN DIEGO,May 2014,CACF,2014,OPEN ARMS ADHC INC,ADULT_BREAKFAST,22,145,0,0,145,930,0,0,930,42.2727
SAN DIEGO,May 2014,CACF,2014,OPEN ARMS ADHC INC,ADULT_LUNCH,22,145,0,0,145,1320,0,0,1320,60
SAN DIEGO,May 2014,CACF,2014,OPEN ARMS ADHC INC,ADULT_SNACK_AM,22,145,0,0,145,391,0,0,391,17.7727
SAN DIEGO,May 2014,CACF,2014,OPEN ARMS ADHC INC,ADULT_SNACK_PM,22,145,0,0,145,397,0,0,397,18.0455
SAN DIEGO,Jun 2014,CACF,2014,OPEN ARMS ADHC INC,ADULT_BREAKFAST,21,145,0,0,145,890,0,0,890,42.381
SAN DIEGO,Jun 2014,CACF,2014,OPEN ARMS ADHC INC,ADULT_LUNCH,21,145,0,0,145,1242,0,0,1242,59.1429
SAN DIEGO,Jun 2014,CACF,2014,OPEN ARMS ADHC INC,ADULT_SNACK_AM,21,145,0,0,145,352,0,0,352,16.7619
SAN DIEGO,Jun 2014,CACF,2014,OPEN ARMS ADHC INC,ADULT_SNACK_PM,21,145,0,0,145,365,0,0,365,17.381
SAN DIEGO,Jul 2014,CACF,2014,OPEN ARMS ADHC INC,ADULT_BREAKFAST,22,145,0,0,145,974,0,0,974,44.2727
SAN DIEGO,Jul 2014,CACF,2014,OPEN ARMS ADHC INC,ADULT_LUNCH,22,145,0,0,145,1386,0,0,1386,63
SAN DIEGO,Jul 2014,CACF,2014,OPEN ARMS ADHC INC,ADULT_SNACK_AM,22,145,0,0,145,413,0,0,413,18.7727
SAN DIEGO,Jul 2014,CACF,2014,OPEN ARMS ADHC INC,ADULT_SNACK_PM,22,145,0,0,145,433,0,0,433,19.6818
SAN DIEGO,Aug 2014,CACF,2014,OPEN ARMS ADHC INC,ADULT_BREAKFAST,21,145,0,0,145,901,0,0,901,42.9048
SAN DIEGO,Aug 2014,CACF,2014,OPEN ARMS ADHC INC,ADULT_LUNCH,21,145,0,0,145,1348,0,0,1348,64.1905
SAN DIEGO,Aug 2014,CACF,2014,OPEN ARMS ADHC INC,ADULT_SNACK_AM,21,145,0,0,145,425,0,0,425,20.2381
SAN DIEGO,Aug 2014,CACF,2014,OPEN ARMS ADHC INC,ADULT_SNACK_PM,21,145,0,0,145,450,0,0,450,21.4286
SAN DIEGO,Sep 2014,CACF,2014,OPEN ARMS ADHC INC,ADULT_BREAKFAST,22,145,0,0,145,929,0,0,929,42.2273
SAN DIEGO,Sep 2014,CACF,2014,OPEN ARMS ADHC INC,ADULT_LUNCH,22,145,0,0,145,1420,0,0,1420,64.5455
SAN DIEGO,Sep 2014,CACF,2014,OPEN ARMS ADHC INC,ADULT_SNACK_AM,22,145,0,0,145,456,0,0,456,20.7273
SAN DIEGO,Sep 2014,CACF,2014,OPEN ARMS ADHC INC,ADULT_SNACK_PM,22,145,0,0,145,514,0,0,514,23.3636
SAN DIEGO,Oct 2013,CACF,2014,PALOMAR COMMUNITY COLLEGE DISTRICT CDC,CHILD_BREAKFAST,23,60,18,77,155,694,208,890,1792,77.913
SAN DIEGO,Oct 2013,CACF,2014,PALOMAR COMMUNITY COLLEGE DISTRICT CDC,CHILD_LUNCH,23,60,18,77,155,435,130,558,1123,48.8261
SAN DIEGO,Oct 2013,CACF,2014,PALOMAR COMMUNITY COLLEGE DISTRICT CDC,CHILD_SNACK_PM,23,60,18,77,155,508,152,653,1313,57.087
SAN DIEGO,Nov 2013,CACF,2014,PALOMAR COMMUNITY COLLEGE DISTRICT CDC,CHILD_BREAKFAST,18,60,18,77,155,530,159,681,1370,76.1111
SAN DIEGO,Nov 2013,CACF,2014,PALOMAR COMMUNITY COLLEGE DISTRICT CDC,CHILD_LUNCH,18,60,18,77,155,324,97,415,836,46.4444
SAN DIEGO,Nov 2013,CACF,2014,PALOMAR COMMUNITY COLLEGE DISTRICT CDC,CHILD_SNACK_PM,18,60,18,77,155,354,106,454,914,50.7778
SAN DIEGO,Dec 2013,CACF,2014,PALOMAR COMMUNITY COLLEGE DISTRICT CDC,CHILD_BREAKFAST,10,60,18,77,155,302,90,387,779,77.9
SAN DIEGO,Dec 2013,CACF,2014,PALOMAR COMMUNITY COLLEGE DISTRICT CDC,CHILD_LUNCH,10,60,18,77,155,187,56,240,483,48.3
SAN DIEGO,Dec 2013,CACF,2014,PALOMAR COMMUNITY COLLEGE DISTRICT CDC,CHILD_SNACK_PM,10,60,18,77,155,228,68,294,590,59
SAN DIEGO,Jan 2014,CACF,2014,PALOMAR COMMUNITY COLLEGE DISTRICT CDC,CHILD_BREAKFAST,21,62,20,73,155,608,196,717,1521,72.4286
SAN DIEGO,Jan 2014,CACF,2014,PALOMAR COMMUNITY COLLEGE DISTRICT CDC,CHILD_LUNCH,21,62,20,73,155,400,129,471,1000,47.619
SAN DIEGO,Jan 2014,CACF,2014,PALOMAR COMMUNITY COLLEGE DISTRICT CDC,CHILD_SNACK_PM,21,62,20,73,155,507,164,597,1268,60.381
SAN DIEGO,Feb 2014,CACF,2014,PALOMAR COMMUNITY COLLEGE DISTRICT CDC,CHILD_BREAKFAST,18,62,20,73,155,579,187,681,1447,80.3889
SAN DIEGO,Feb 2014,CACF,2014,PALOMAR COMMUNITY COLLEGE DISTRICT CDC,CHILD_LUNCH,18,62,20,73,155,396,128,465,989,54.9444
SAN DIEGO,Feb 2014,CACF,2014,PALOMAR COMMUNITY COLLEGE DISTRICT CDC,CHILD_SNACK_PM,18,62,20,73,155,454,146,535,1135,63.0556
SAN DIEGO,Mar 2014,CACF,2014,PALOMAR COMMUNITY COLLEGE DISTRICT CDC,CHILD_BREAKFAST,16,66,21,74,161,714,227,801,1742,108.875
SAN DIEGO,Mar 2014,CACF,2014,PALOMAR COMMUNITY COLLEGE DISTRICT CDC,CHILD_LUNCH,16,66,21,74,161,340,108,382,830,51.875
SAN DIEGO,Mar 2014,CACF,2014,PALOMAR COMMUNITY COLLEGE DISTRICT CDC,CHILD_SNACK_PM,16,66,21,74,161,409,130,460,999,62.4375
SAN DIEGO,Apr 2014,CACF,2014,PALOMAR COMMUNITY COLLEGE DISTRICT CDC,CHILD_BREAKFAST,22,70,19,76,165,725,197,788,1710,77.7273
SAN DIEGO,Apr 2014,CACF,2014,PALOMAR COMMUNITY COLLEGE DISTRICT CDC,CHILD_LUNCH,22,70,19,76,165,529,144,574,1247,56.6818
SAN DIEGO,Apr 2014,CACF,2014,PALOMAR COMMUNITY COLLEGE DISTRICT CDC,CHILD_SNACK_PM,22,70,19,76,165,628,170,682,1480,67.2727
SAN DIEGO,May 2014,CACF,2014,PALOMAR COMMUNITY COLLEGE DISTRICT CDC,CHILD_BREAKFAST,19,70,19,76,165,730,198,794,1722,90.6316
SAN DIEGO,May 2014,CACF,2014,PALOMAR COMMUNITY COLLEGE DISTRICT CDC,CHILD_LUNCH,19,70,19,76,165,437,119,474,1030,54.2105
SAN DIEGO,May 2014,CACF,2014,PALOMAR COMMUNITY COLLEGE DISTRICT CDC,CHILD_SNACK_PM,19,70,19,76,165,520,141,565,1226,64.5263
SAN DIEGO,Jun 2014,CACF,2014,PALOMAR COMMUNITY COLLEGE DISTRICT CDC,CHILD_BREAKFAST,20,70,19,76,165,555,151,603,1309,65.45
SAN DIEGO,Jun 2014,CACF,2014,PALOMAR COMMUNITY COLLEGE DISTRICT CDC,CHILD_LUNCH,20,70,19,76,165,419,114,454,987,49.35
SAN DIEGO,Jun 2014,CACF,2014,PALOMAR COMMUNITY COLLEGE DISTRICT CDC,CHILD_SNACK_PM,20,70,19,76,165,490,133,533,1156,57.8
SAN DIEGO,Jul 2014,CACF,2014,PALOMAR COMMUNITY COLLEGE DISTRICT CDC,CHILD_BREAKFAST,22,70,19,76,165,585,159,636,1380,62.7273
SAN DIEGO,Jul 2014,CACF,2014,PALOMAR COMMUNITY COLLEGE DISTRICT CDC,CHILD_LUNCH,22,70,19,76,165,453,123,493,1069,48.5909
SAN DIEGO,Jul 2014,CACF,2014,PALOMAR COMMUNITY COLLEGE DISTRICT CDC,CHILD_SNACK_PM,22,70,19,76,165,487,132,530,1149,52.2273
SAN DIEGO,Aug 2014,CACF,2014,PALOMAR COMMUNITY COLLEGE DISTRICT CDC,CHILD_BREAKFAST,20,70,19,76,165,522,142,566,1230,61.5
SAN DIEGO,Aug 2014,CACF,2014,PALOMAR COMMUNITY COLLEGE DISTRICT CDC,CHILD_LUNCH,20,70,19,76,165,357,97,388,842,42.1
SAN DIEGO,Aug 2014,CACF,2014,PALOMAR COMMUNITY COLLEGE DISTRICT CDC,CHILD_SNACK_PM,20,70,19,76,165,485,132,527,1144,57.2
SAN DIEGO,Sep 2014,CACF,2014,PALOMAR COMMUNITY COLLEGE DISTRICT CDC,CHILD_BREAKFAST,21,70,19,76,165,641,174,697,1512,72
SAN DIEGO,Sep 2014,CACF,2014,PALOMAR COMMUNITY COLLEGE DISTRICT CDC,CHILD_LUNCH,21,70,19,76,165,452,123,490,1065,50.7143
SAN DIEGO,Sep 2014,CACF,2014,PALOMAR COMMUNITY COLLEGE DISTRICT CDC,CHILD_SNACK_PM,21,70,19,76,165,592,161,643,1396,66.4762
SAN DIEGO,Oct 2013,CACF,2014,PEPPERTREE MONTESSORI INC ,CHILD_BREAKFAST,9,15,11,76,102,86,63,437,586,65.1111
SAN DIEGO,Oct 2013,CACF,2014,PEPPERTREE MONTESSORI INC ,CHILD_LUNCH,9,15,11,76,102,108,79,548,735,81.6667
SAN DIEGO,Oct 2013,CACF,2014,PEPPERTREE MONTESSORI INC ,CHILD_SNACK_PM,9,15,11,76,102,91,67,459,617,68.5556
SAN DIEGO,Oct 2013,CACF,2014,POWAY ADHC CENTER ,ADULT_BREAKFAST,23,134,0,33,167,1236,0,304,1540,66.9565
SAN DIEGO,Oct 2013,CACF,2014,POWAY ADHC CENTER ,ADULT_LUNCH,23,134,0,33,167,1320,0,325,1645,71.5217
SAN DIEGO,Oct 2013,CACF,2014,POWAY ADHC CENTER ,ADULT_SNACK_PM,23,134,0,33,167,163,0,40,203,8.8261
SAN DIEGO,Dec 2013,CACF,2014,POWAY ADHC CENTER ,ADULT_BREAKFAST,18,134,0,33,167,1090,0,269,1359,75.5
SAN DIEGO,Dec 2013,CACF,2014,POWAY ADHC CENTER ,ADULT_LUNCH,18,134,0,33,167,1150,0,283,1433,79.6111
SAN DIEGO,Dec 2013,CACF,2014,POWAY ADHC CENTER ,ADULT_SNACK_PM,18,134,0,33,167,134,0,33,167,9.2778
SAN DIEGO,Jan 2014,CACF,2014,POWAY ADHC CENTER ,ADULT_BREAKFAST,22,134,0,33,167,1193,0,294,1487,67.5909
SAN DIEGO,Jan 2014,CACF,2014,POWAY ADHC CENTER ,ADULT_LUNCH,22,134,0,33,167,1286,0,317,1603,72.8636
SAN DIEGO,Jan 2014,CACF,2014,POWAY ADHC CENTER ,ADULT_SNACK_PM,22,134,0,33,167,177,0,43,220,10
SAN DIEGO,Feb 2014,CACF,2014,POWAY ADHC CENTER ,ADULT_BREAKFAST,20,134,0,33,167,1110,0,273,1383,69.15
SAN DIEGO,Feb 2014,CACF,2014,POWAY ADHC CENTER ,ADULT_LUNCH,20,134,0,33,167,1206,0,297,1503,75.15
SAN DIEGO,Feb 2014,CACF,2014,POWAY ADHC CENTER ,ADULT_SNACK_PM,20,134,0,33,167,161,0,40,201,10.05
SAN DIEGO,Mar 2014,CACF,2014,POWAY ADHC CENTER ,ADULT_BREAKFAST,21,134,0,33,167,1186,0,292,1478,70.381
SAN DIEGO,Mar 2014,CACF,2014,POWAY ADHC CENTER ,ADULT_LUNCH,21,134,0,33,167,1254,0,309,1563,74.4286
SAN DIEGO,Mar 2014,CACF,2014,POWAY ADHC CENTER ,ADULT_SNACK_PM,21,134,0,33,167,151,0,37,188,8.9524
SAN DIEGO,Apr 2014,CACF,2014,POWAY ADHC CENTER ,ADULT_BREAKFAST,22,134,0,33,167,1110,0,273,1383,62.8636
SAN DIEGO,Apr 2014,CACF,2014,POWAY ADHC CENTER ,ADULT_LUNCH,22,134,0,33,167,1206,0,297,1503,68.3182
SAN DIEGO,Apr 2014,CACF,2014,POWAY ADHC CENTER ,ADULT_SNACK_PM,22,134,0,33,167,161,0,40,201,9.1364
SAN DIEGO,May 2014,CACF,2014,POWAY ADHC CENTER ,ADULT_BREAKFAST,20,134,0,33,167,1056,0,260,1316,65.8
SAN DIEGO,May 2014,CACF,2014,POWAY ADHC CENTER ,ADULT_LUNCH,20,134,0,33,167,1151,0,284,1435,71.75
SAN DIEGO,May 2014,CACF,2014,POWAY ADHC CENTER ,ADULT_SNACK_PM,20,134,0,33,167,139,0,34,173,8.65
SAN DIEGO,Jun 2014,CACF,2014,POWAY ADHC CENTER ,ADULT_BREAKFAST,21,134,0,33,167,1066,0,262,1328,63.2381
SAN DIEGO,Jun 2014,CACF,2014,POWAY ADHC CENTER ,ADULT_LUNCH,21,134,0,33,167,1240,0,305,1545,73.5714
SAN DIEGO,Jun 2014,CACF,2014,POWAY ADHC CENTER ,ADULT_SNACK_PM,21,134,0,33,167,126,0,31,157,7.4762
SAN DIEGO,Jul 2014,CACF,2014,POWAY ADHC CENTER ,ADULT_BREAKFAST,22,134,0,33,167,1171,0,288,1459,66.3182
SAN DIEGO,Jul 2014,CACF,2014,POWAY ADHC CENTER ,ADULT_LUNCH,22,134,0,33,167,1327,0,327,1654,75.1818
SAN DIEGO,Jul 2014,CACF,2014,POWAY ADHC CENTER ,ADULT_SNACK_PM,22,134,0,33,167,130,0,32,162,7.3636
SAN DIEGO,Aug 2014,CACF,2014,POWAY ADHC CENTER ,ADULT_BREAKFAST,21,134,0,33,167,1015,0,250,1265,60.2381
SAN DIEGO,Aug 2014,CACF,2014,POWAY ADHC CENTER ,ADULT_LUNCH,21,134,0,33,167,1180,0,290,1470,70
SAN DIEGO,Aug 2014,CACF,2014,POWAY ADHC CENTER ,ADULT_SNACK_PM,21,134,0,33,167,118,0,29,147,7
SAN DIEGO,Sep 2014,CACF,2014,POWAY ADHC CENTER ,ADULT_BREAKFAST,21,134,0,33,167,1082,0,267,1349,64.2381
SAN DIEGO,Sep 2014,CACF,2014,POWAY ADHC CENTER ,ADULT_LUNCH,21,134,0,33,167,1255,0,309,1564,74.4762
SAN DIEGO,Sep 2014,CACF,2014,POWAY ADHC CENTER ,ADULT_SNACK_PM,21,134,0,33,167,155,0,38,193,9.1905
SAN DIEGO,Oct 2013,CACF,2014,QUALITY CHILDREN'S SERVICES ,CHILD_BREAKFAST,23,919,168,85,1172,10490,1917,971,13378,581.6522
SAN DIEGO,Oct 2013,CACF,2014,QUALITY CHILDREN'S SERVICES ,CHILD_LUNCH,23,919,168,85,1172,10872,1987,1007,13866,602.8696
SAN DIEGO,Oct 2013,CACF,2014,QUALITY CHILDREN'S SERVICES ,CHILD_SNACK_AM,23,919,168,85,1172,11306,2066,1047,14419,626.913
SAN DIEGO,Oct 2013,CACF,2014,QUALITY CHILDREN'S SERVICES ,CHILD_SNACK_PM,23,919,168,85,1172,6031,1102,558,7691,334.3913
SAN DIEGO,Nov 2013,CACF,2014,QUALITY CHILDREN'S SERVICES ,CHILD_BREAKFAST,19,919,168,85,1172,8471,1548,784,10803,568.5789
SAN DIEGO,Nov 2013,CACF,2014,QUALITY CHILDREN'S SERVICES ,CHILD_LUNCH,19,919,168,85,1172,8939,1634,827,11400,600
SAN DIEGO,Nov 2013,CACF,2014,QUALITY CHILDREN'S SERVICES ,CHILD_SNACK_AM,19,919,168,85,1172,9179,1677,850,11706,616.1053
SAN DIEGO,Nov 2013,CACF,2014,QUALITY CHILDREN'S SERVICES ,CHILD_SNACK_PM,19,919,168,85,1172,5090,930,471,6491,341.6316
SAN DIEGO,Dec 2013,CACF,2014,QUALITY CHILDREN'S SERVICES ,CHILD_BREAKFAST,20,919,168,85,1172,6474,1183,600,8257,412.85
SAN DIEGO,Dec 2013,CACF,2014,QUALITY CHILDREN'S SERVICES ,CHILD_LUNCH,20,919,168,85,1172,6960,1272,645,8877,443.85
SAN DIEGO,Dec 2013,CACF,2014,QUALITY CHILDREN'S SERVICES ,CHILD_SNACK_AM,20,919,168,85,1172,6797,1242,629,8668,433.4
SAN DIEGO,Dec 2013,CACF,2014,QUALITY CHILDREN'S SERVICES ,CHILD_SNACK_PM,20,919,168,85,1172,3636,664,337,4637,231.85
SAN DIEGO,Jan 2014,CACF,2014,QUALITY CHILDREN'S SERVICES ,CHILD_BREAKFAST,22,919,168,85,1172,8522,1558,789,10869,494.0455
SAN DIEGO,Jan 2014,CACF,2014,QUALITY CHILDREN'S SERVICES ,CHILD_LUNCH,22,919,168,85,1172,9720,1776,901,12397,563.5
SAN DIEGO,Jan 2014,CACF,2014,QUALITY CHILDREN'S SERVICES ,CHILD_SNACK_AM,22,919,168,85,1172,9572,1749,887,12208,554.9091
SAN DIEGO,Jan 2014,CACF,2014,QUALITY CHILDREN'S SERVICES ,CHILD_SNACK_PM,22,919,168,85,1172,5532,1011,512,7055,320.6818
SAN DIEGO,Feb 2014,CACF,2014,QUALITY CHILDREN'S SERVICES ,CHILD_BREAKFAST,19,919,168,85,1172,8434,1541,781,10756,566.1053
SAN DIEGO,Feb 2014,CACF,2014,QUALITY CHILDREN'S SERVICES ,CHILD_LUNCH,19,919,168,85,1172,9253,1691,857,11801,621.1053
SAN DIEGO,Feb 2014,CACF,2014,QUALITY CHILDREN'S SERVICES ,CHILD_SNACK_AM,19,919,168,85,1172,9331,1705,864,11900,626.3158
SAN DIEGO,Feb 2014,CACF,2014,QUALITY CHILDREN'S SERVICES ,CHILD_SNACK_PM,19,919,168,85,1172,5351,978,496,6825,359.2105
SAN DIEGO,Mar 2014,CACF,2014,QUALITY CHILDREN'S SERVICES ,CHILD_BREAKFAST,21,919,168,85,1172,9524,1741,882,12147,578.4286
SAN DIEGO,Mar 2014,CACF,2014,QUALITY CHILDREN'S SERVICES ,CHILD_LUNCH,21,919,168,85,1172,10515,1922,973,13410,638.5714
SAN DIEGO,Mar 2014,CACF,2014,QUALITY CHILDREN'S SERVICES ,CHILD_SNACK_AM,21,919,168,85,1172,10599,1937,982,13518,643.7143
SAN DIEGO,Mar 2014,CACF,2014,QUALITY CHILDREN'S SERVICES ,CHILD_SNACK_PM,21,919,168,85,1172,5976,1092,554,7622,362.9524
SAN DIEGO,Apr 2014,CACF,2014,QUALITY CHILDREN'S SERVICES ,CHILD_BREAKFAST,22,919,168,85,1172,9607,1756,889,12252,556.9091
SAN DIEGO,Apr 2014,CACF,2014,QUALITY CHILDREN'S SERVICES ,CHILD_LUNCH,22,919,168,85,1172,10925,1997,1011,13933,633.3182
SAN DIEGO,Apr 2014,CACF,2014,QUALITY CHILDREN'S SERVICES ,CHILD_SNACK_AM,22,919,168,85,1172,10997,2010,1018,14025,637.5
SAN DIEGO,Apr 2014,CACF,2014,QUALITY CHILDREN'S SERVICES ,CHILD_SNACK_PM,22,919,168,85,1172,6303,1152,584,8039,365.4091
SAN DIEGO,May 2014,CACF,2014,QUALITY CHILDREN'S SERVICES ,CHILD_BREAKFAST,21,919,168,85,1172,9468,1730,877,12075,575
SAN DIEGO,May 2014,CACF,2014,QUALITY CHILDREN'S SERVICES ,CHILD_LUNCH,21,919,168,85,1172,10416,1904,964,13284,632.5714
SAN DIEGO,May 2014,CACF,2014,QUALITY CHILDREN'S SERVICES ,CHILD_SNACK_AM,21,919,168,85,1172,10541,1927,976,13444,640.1905
SAN DIEGO,May 2014,CACF,2014,QUALITY CHILDREN'S SERVICES ,CHILD_SNACK_PM,21,919,168,85,1172,6052,1106,561,7719,367.5714
SAN DIEGO,Jun 2014,CACF,2014,QUALITY CHILDREN'S SERVICES ,CHILD_BREAKFAST,21,919,168,85,1172,8281,1513,767,10561,502.9048
SAN DIEGO,Jun 2014,CACF,2014,QUALITY CHILDREN'S SERVICES ,CHILD_LUNCH,21,919,168,85,1172,9667,1767,895,12329,587.0952
SAN DIEGO,Jun 2014,CACF,2014,QUALITY CHILDREN'S SERVICES ,CHILD_SNACK_AM,21,919,168,85,1172,9524,1741,882,12147,578.4286
SAN DIEGO,Jun 2014,CACF,2014,QUALITY CHILDREN'S SERVICES ,CHILD_SNACK_PM,21,919,168,85,1172,5604,1024,519,7147,340.3333
SAN DIEGO,Jul 2014,CACF,2014,QUALITY CHILDREN'S SERVICES ,CHILD_BREAKFAST,22,919,168,85,1172,3550,649,329,4528,205.8182
SAN DIEGO,Jul 2014,CACF,2014,QUALITY CHILDREN'S SERVICES ,CHILD_LUNCH,22,919,168,85,1172,4300,786,398,5484,249.2727
SAN DIEGO,Jul 2014,CACF,2014,QUALITY CHILDREN'S SERVICES ,CHILD_SNACK_AM,22,919,168,85,1172,4269,780,395,5444,247.4545
SAN DIEGO,Aug 2014,CACF,2014,QUALITY CHILDREN'S SERVICES ,CHILD_BREAKFAST,21,919,168,85,1172,3196,584,296,4076,194.0952
SAN DIEGO,Aug 2014,CACF,2014,QUALITY CHILDREN'S SERVICES ,CHILD_LUNCH,21,919,168,85,1172,3757,687,347,4791,228.1429
SAN DIEGO,Aug 2014,CACF,2014,QUALITY CHILDREN'S SERVICES ,CHILD_SNACK_AM,21,919,168,85,1172,3676,672,340,4688,223.2381
SAN DIEGO,Sep 2014,CACF,2014,QUALITY CHILDREN'S SERVICES ,CHILD_BREAKFAST,21,919,168,85,1172,9147,1672,846,11665,555.4762
SAN DIEGO,Sep 2014,CACF,2014,QUALITY CHILDREN'S SERVICES ,CHILD_LUNCH,21,919,168,85,1172,9497,1736,879,12112,576.7619
SAN DIEGO,Sep 2014,CACF,2014,QUALITY CHILDREN'S SERVICES ,CHILD_SNACK_AM,21,919,168,85,1172,9931,1815,919,12665,603.0952
SAN DIEGO,Sep 2014,CACF,2014,QUALITY CHILDREN'S SERVICES ,CHILD_SNACK_PM,21,919,168,85,1172,4985,911,462,6358,302.7619
SAN DIEGO,Oct 2013,CACF,2014,RAMONA SENIOR CARE INC ,ADULT_BREAKFAST,23,21,0,7,28,360,0,120,480,20.8696
SAN DIEGO,Oct 2013,CACF,2014,RAMONA SENIOR CARE INC ,ADULT_LUNCH,23,21,0,7,28,360,0,120,480,20.8696
SAN DIEGO,Oct 2013,CACF,2014,RAMONA SENIOR CARE INC ,ADULT_SNACK_PM,23,21,0,7,28,254,0,84,338,14.6957
SAN DIEGO,Nov 2013,CACF,2014,RAMONA SENIOR CARE INC ,ADULT_BREAKFAST,18,21,0,7,28,296,0,99,395,21.9444
SAN DIEGO,Nov 2013,CACF,2014,RAMONA SENIOR CARE INC ,ADULT_LUNCH,18,21,0,7,28,299,0,100,399,22.1667
SAN DIEGO,Nov 2013,CACF,2014,RAMONA SENIOR CARE INC ,ADULT_SNACK_PM,18,21,0,7,28,208,0,69,277,15.3889
SAN DIEGO,Dec 2013,CACF,2014,RAMONA SENIOR CARE INC ,ADULT_BREAKFAST,19,21,0,7,28,318,0,106,424,22.3158
SAN DIEGO,Dec 2013,CACF,2014,RAMONA SENIOR CARE INC ,ADULT_LUNCH,19,21,0,7,28,318,0,106,424,22.3158
SAN DIEGO,Dec 2013,CACF,2014,RAMONA SENIOR CARE INC ,ADULT_SNACK_PM,19,21,0,7,28,221,0,74,295,15.5263
SAN DIEGO,Jan 2014,CACF,2014,RAMONA SENIOR CARE INC ,ADULT_BREAKFAST,22,21,0,7,28,372,0,124,496,22.5455
SAN DIEGO,Jan 2014,CACF,2014,RAMONA SENIOR CARE INC ,ADULT_LUNCH,22,21,0,7,28,372,0,124,496,22.5455
SAN DIEGO,Jan 2014,CACF,2014,RAMONA SENIOR CARE INC ,ADULT_SNACK_PM,22,21,0,7,28,259,0,86,345,15.6818
SAN DIEGO,Feb 2014,CACF,2014,RAMONA SENIOR CARE INC ,ADULT_BREAKFAST,20,21,0,7,28,342,0,114,456,22.8
SAN DIEGO,Feb 2014,CACF,2014,RAMONA SENIOR CARE INC ,ADULT_LUNCH,20,21,0,7,28,342,0,114,456,22.8
SAN DIEGO,Feb 2014,CACF,2014,RAMONA SENIOR CARE INC ,ADULT_SNACK_PM,20,21,0,7,28,263,0,87,350,17.5
SAN DIEGO,Mar 2014,CACF,2014,RAMONA SENIOR CARE INC ,ADULT_BREAKFAST,21,21,0,7,28,296,0,98,394,18.7619
SAN DIEGO,Mar 2014,CACF,2014,RAMONA SENIOR CARE INC ,ADULT_LUNCH,21,21,0,7,28,296,0,98,394,18.7619
SAN DIEGO,Mar 2014,CACF,2014,RAMONA SENIOR CARE INC ,ADULT_SNACK_PM,21,21,0,7,28,197,0,65,262,12.4762
SAN DIEGO,Apr 2014,CACF,2014,RAMONA SENIOR CARE INC ,ADULT_BREAKFAST,22,21,0,7,28,304,0,101,405,18.4091
SAN DIEGO,Apr 2014,CACF,2014,RAMONA SENIOR CARE INC ,ADULT_LUNCH,22,21,0,7,28,304,0,101,405,18.4091
SAN DIEGO,Apr 2014,CACF,2014,RAMONA SENIOR CARE INC ,ADULT_SNACK_PM,22,21,0,7,28,232,0,77,309,14.0455
SAN DIEGO,Oct 2013,CACF,2014,READY SET GROW,CHILD_BREAKFAST,23,17,13,40,70,196,150,462,808,35.1304
SAN DIEGO,Oct 2013,CACF,2014,READY SET GROW,CHILD_LUNCH,23,17,13,40,70,204,156,479,839,36.4783
SAN DIEGO,Oct 2013,CACF,2014,READY SET GROW,CHILD_SNACK_PM,23,17,13,40,70,249,190,586,1025,44.5652
SAN DIEGO,Nov 2013,CACF,2014,READY SET GROW,CHILD_BREAKFAST,19,17,13,40,70,149,114,352,615,32.3684
SAN DIEGO,Nov 2013,CACF,2014,READY SET GROW,CHILD_LUNCH,19,17,13,40,70,149,114,352,615,32.3684
SAN DIEGO,Nov 2013,CACF,2014,READY SET GROW,CHILD_SNACK_PM,19,17,13,40,70,191,146,449,786,41.3684
SAN DIEGO,Dec 2013,CACF,2014,READY SET GROW,CHILD_BREAKFAST,20,17,13,40,70,152,116,358,626,31.3
SAN DIEGO,Dec 2013,CACF,2014,READY SET GROW,CHILD_LUNCH,20,17,13,40,70,156,119,366,641,32.05
SAN DIEGO,Dec 2013,CACF,2014,READY SET GROW,CHILD_SNACK_PM,20,17,13,40,70,196,149,460,805,40.25
SAN DIEGO,Jan 2014,CACF,2014,READY SET GROW,CHILD_BREAKFAST,22,18,9,43,70,188,94,450,732,33.2727
SAN DIEGO,Jan 2014,CACF,2014,READY SET GROW,CHILD_LUNCH,22,18,9,43,70,192,96,458,746,33.9091
SAN DIEGO,Jan 2014,CACF,2014,READY SET GROW,CHILD_SNACK_PM,22,18,9,43,70,242,121,579,942,42.8182
SAN DIEGO,Feb 2014,CACF,2014,READY SET GROW,CHILD_BREAKFAST,19,18,9,43,70,199,100,475,774,40.7368
SAN DIEGO,Feb 2014,CACF,2014,READY SET GROW,CHILD_LUNCH,19,18,9,43,70,207,104,495,806,42.4211
SAN DIEGO,Feb 2014,CACF,2014,READY SET GROW,CHILD_SNACK_PM,19,18,9,43,70,247,124,590,961,50.5789
SAN DIEGO,Mar 2014,CACF,2014,READY SET GROW,CHILD_BREAKFAST,21,19,10,45,74,176,93,417,686,32.6667
SAN DIEGO,Mar 2014,CACF,2014,READY SET GROW,CHILD_LUNCH,21,19,10,45,74,233,123,553,909,43.2857
SAN DIEGO,Mar 2014,CACF,2014,READY SET GROW,CHILD_SNACK_PM,21,19,10,45,74,281,148,667,1096,52.1905
SAN DIEGO,Apr 2014,CACF,2014,READY SET GROW,CHILD_BREAKFAST,22,21,12,47,80,221,126,496,843,38.3182
SAN DIEGO,Apr 2014,CACF,2014,READY SET GROW,CHILD_LUNCH,22,21,12,47,80,283,162,632,1077,48.9545
SAN DIEGO,Apr 2014,CACF,2014,READY SET GROW,CHILD_SNACK_PM,22,21,12,47,80,307,176,688,1171,53.2273
SAN DIEGO,May 2014,CACF,2014,READY SET GROW,CHILD_BREAKFAST,21,21,12,47,80,201,115,450,766,36.4762
SAN DIEGO,May 2014,CACF,2014,READY SET GROW,CHILD_LUNCH,21,21,12,47,80,261,149,584,994,47.3333
SAN DIEGO,May 2014,CACF,2014,READY SET GROW,CHILD_SNACK_PM,21,21,12,47,80,304,174,681,1159,55.1905
SAN DIEGO,Jun 2014,CACF,2014,READY SET GROW,CHILD_BREAKFAST,21,17,12,55,84,172,121,556,849,40.4286
SAN DIEGO,Jun 2014,CACF,2014,READY SET GROW,CHILD_LUNCH,21,17,12,55,84,208,147,673,1028,48.9524
SAN DIEGO,Jun 2014,CACF,2014,READY SET GROW,CHILD_SNACK_PM,21,17,12,55,84,220,155,712,1087,51.7619
SAN DIEGO,Jul 2014,CACF,2014,READY SET GROW,CHILD_BREAKFAST,22,17,12,55,84,164,116,531,811,36.8636
SAN DIEGO,Jul 2014,CACF,2014,READY SET GROW,CHILD_LUNCH,22,17,12,55,84,233,164,753,1150,52.2727
SAN DIEGO,Jul 2014,CACF,2014,READY SET GROW,CHILD_SNACK_PM,22,17,12,55,84,205,144,662,1011,45.9545
SAN DIEGO,Aug 2014,CACF,2014,READY SET GROW,CHILD_BREAKFAST,21,17,12,55,84,137,96,442,675,32.1429
SAN DIEGO,Aug 2014,CACF,2014,READY SET GROW,CHILD_LUNCH,21,17,12,55,84,186,132,603,921,43.8571
SAN DIEGO,Aug 2014,CACF,2014,READY SET GROW,CHILD_SNACK_PM,21,17,12,55,84,163,115,525,803,38.2381
SAN DIEGO,Sep 2014,CACF,2014,READY SET GROW,CHILD_BREAKFAST,21,17,12,55,84,144,102,466,712,33.9048
SAN DIEGO,Sep 2014,CACF,2014,READY SET GROW,CHILD_LUNCH,21,17,12,55,84,153,108,495,756,36
SAN DIEGO,Sep 2014,CACF,2014,READY SET GROW,CHILD_SNACK_PM,21,17,12,55,84,195,138,631,964,45.9048
SAN DIEGO,Oct 2013,CACF,2014,RISING STAR ACAD CHILDCARE CTR,CHILD_BREAKFAST,23,47,1,0,48,860,18,0,878,38.1739
SAN DIEGO,Oct 2013,CACF,2014,RISING STAR ACAD CHILDCARE CTR,CHILD_LUNCH,23,47,1,0,48,726,15,0,741,32.2174
SAN DIEGO,Oct 2013,CACF,2014,RISING STAR ACAD CHILDCARE CTR,CHILD_SNACK_PM,23,47,1,0,48,898,19,0,917,39.8696
SAN DIEGO,Nov 2013,CACF,2014,RISING STAR ACAD CHILDCARE CTR,CHILD_BREAKFAST,19,47,1,0,48,658,14,0,672,35.3684
SAN DIEGO,Nov 2013,CACF,2014,RISING STAR ACAD CHILDCARE CTR,CHILD_LUNCH,19,47,1,0,48,576,12,0,588,30.9474
SAN DIEGO,Nov 2013,CACF,2014,RISING STAR ACAD CHILDCARE CTR,CHILD_SNACK_PM,19,47,1,0,48,732,16,0,748,39.3684
SAN DIEGO,Dec 2013,CACF,2014,RISING STAR ACAD CHILDCARE CTR,CHILD_BREAKFAST,21,47,1,0,48,790,17,0,807,38.4286
SAN DIEGO,Dec 2013,CACF,2014,RISING STAR ACAD CHILDCARE CTR,CHILD_LUNCH,21,47,1,0,48,727,15,0,742,35.3333
SAN DIEGO,Dec 2013,CACF,2014,RISING STAR ACAD CHILDCARE CTR,CHILD_SNACK_PM,21,47,1,0,48,808,17,0,825,39.2857
SAN DIEGO,Jan 2014,CACF,2014,RISING STAR ACAD CHILDCARE CTR,CHILD_BREAKFAST,22,47,1,0,48,811,17,0,828,37.6364
SAN DIEGO,Jan 2014,CACF,2014,RISING STAR ACAD CHILDCARE CTR,CHILD_LUNCH,22,47,1,0,48,693,15,0,708,32.1818
SAN DIEGO,Jan 2014,CACF,2014,RISING STAR ACAD CHILDCARE CTR,CHILD_SNACK_PM,22,47,1,0,48,837,18,0,855,38.8636
SAN DIEGO,Feb 2014,CACF,2014,RISING STAR ACAD CHILDCARE CTR,CHILD_BREAKFAST,20,47,1,0,48,754,16,0,770,38.5
SAN DIEGO,Feb 2014,CACF,2014,RISING STAR ACAD CHILDCARE CTR,CHILD_LUNCH,20,47,1,0,48,660,14,0,674,33.7
SAN DIEGO,Feb 2014,CACF,2014,RISING STAR ACAD CHILDCARE CTR,CHILD_SNACK_PM,20,47,1,0,48,773,16,0,789,39.45
SAN DIEGO,Mar 2014,CACF,2014,RISING STAR ACAD CHILDCARE CTR,CHILD_BREAKFAST,21,47,1,0,48,793,17,0,810,38.5714
SAN DIEGO,Mar 2014,CACF,2014,RISING STAR ACAD CHILDCARE CTR,CHILD_LUNCH,21,47,1,0,48,634,13,0,647,30.8095
SAN DIEGO,Mar 2014,CACF,2014,RISING STAR ACAD CHILDCARE CTR,CHILD_SNACK_PM,21,47,1,0,48,786,17,0,803,38.2381
SAN DIEGO,Apr 2014,CACF,2014,RISING STAR ACAD CHILDCARE CTR,CHILD_BREAKFAST,22,47,1,0,48,866,18,0,884,40.1818
SAN DIEGO,Apr 2014,CACF,2014,RISING STAR ACAD CHILDCARE CTR,CHILD_LUNCH,22,47,1,0,48,735,16,0,751,34.1364
SAN DIEGO,Apr 2014,CACF,2014,RISING STAR ACAD CHILDCARE CTR,CHILD_SNACK_PM,22,47,1,0,48,886,19,0,905,41.1364
SAN DIEGO,May 2014,CACF,2014,RISING STAR ACAD CHILDCARE CTR,CHILD_BREAKFAST,21,47,1,0,48,828,18,0,846,40.2857
SAN DIEGO,May 2014,CACF,2014,RISING STAR ACAD CHILDCARE CTR,CHILD_LUNCH,21,47,1,0,48,669,14,0,683,32.5238
SAN DIEGO,May 2014,CACF,2014,RISING STAR ACAD CHILDCARE CTR,CHILD_SNACK_PM,21,47,1,0,48,844,18,0,862,41.0476
SAN DIEGO,Jun 2014,CACF,2014,RISING STAR ACAD CHILDCARE CTR,CHILD_BREAKFAST,21,47,1,0,48,808,17,0,825,39.2857
SAN DIEGO,Jun 2014,CACF,2014,RISING STAR ACAD CHILDCARE CTR,CHILD_LUNCH,21,47,1,0,48,811,17,0,828,39.4286
SAN DIEGO,Jun 2014,CACF,2014,RISING STAR ACAD CHILDCARE CTR,CHILD_SNACK_PM,21,47,1,0,48,777,16,0,793,37.7619
SAN DIEGO,Jul 2014,CACF,2014,RISING STAR ACAD CHILDCARE CTR,CHILD_BREAKFAST,22,47,1,0,48,792,17,0,809,36.7727
SAN DIEGO,Jul 2014,CACF,2014,RISING STAR ACAD CHILDCARE CTR,CHILD_LUNCH,22,47,1,0,48,827,18,0,845,38.4091
SAN DIEGO,Jul 2014,CACF,2014,RISING STAR ACAD CHILDCARE CTR,CHILD_SNACK_PM,22,47,1,0,48,766,16,0,782,35.5455
SAN DIEGO,Aug 2014,CACF,2014,RISING STAR ACAD CHILDCARE CTR,CHILD_BREAKFAST,21,47,1,0,48,650,14,0,664,31.619
SAN DIEGO,Aug 2014,CACF,2014,RISING STAR ACAD CHILDCARE CTR,CHILD_LUNCH,21,47,1,0,48,642,14,0,656,31.2381
SAN DIEGO,Aug 2014,CACF,2014,RISING STAR ACAD CHILDCARE CTR,CHILD_SNACK_PM,21,47,1,0,48,702,15,0,717,34.1429
SAN DIEGO,Sep 2014,CACF,2014,RISING STAR ACAD CHILDCARE CTR,CHILD_BREAKFAST,21,47,1,0,48,630,13,0,643,30.619
SAN DIEGO,Sep 2014,CACF,2014,RISING STAR ACAD CHILDCARE CTR,CHILD_LUNCH,21,47,1,0,48,471,10,0,481,22.9048
SAN DIEGO,Sep 2014,CACF,2014,RISING STAR ACAD CHILDCARE CTR,CHILD_SNACK_PM,21,47,1,0,48,650,14,0,664,31.619
SAN DIEGO,Oct 2013,CACF,2014,SAINT VINCENT DE PAUL VILLAGE,ES_CHILD_BREAKFAST,31,643,0,0,643,2533,0,0,2533,81.7097
SAN DIEGO,Oct 2013,CACF,2014,SAINT VINCENT DE PAUL VILLAGE,ES_CHILD_LUNCH,31,643,0,0,643,1753,0,0,1753,56.5484
SAN DIEGO,Oct 2013,CACF,2014,SAINT VINCENT DE PAUL VILLAGE,ES_CHILD_SUPPER,31,643,0,0,643,2465,0,0,2465,79.5161
SAN DIEGO,Nov 2013,CACF,2014,SAINT VINCENT DE PAUL VILLAGE,ES_CHILD_BREAKFAST,30,595,0,0,595,2194,0,0,2194,73.1333
SAN DIEGO,Nov 2013,CACF,2014,SAINT VINCENT DE PAUL VILLAGE,ES_CHILD_LUNCH,30,595,0,0,595,1918,0,0,1918,63.9333
SAN DIEGO,Nov 2013,CACF,2014,SAINT VINCENT DE PAUL VILLAGE,ES_CHILD_SUPPER,30,595,0,0,595,2003,0,0,2003,66.7667
SAN DIEGO,Dec 2013,CACF,2014,SAINT VINCENT DE PAUL VILLAGE,ES_CHILD_BREAKFAST,31,582,0,0,582,1777,0,0,1777,57.3226
SAN DIEGO,Dec 2013,CACF,2014,SAINT VINCENT DE PAUL VILLAGE,ES_CHILD_LUNCH,31,582,0,0,582,1899,0,0,1899,61.2581
SAN DIEGO,Dec 2013,CACF,2014,SAINT VINCENT DE PAUL VILLAGE,ES_CHILD_SUPPER,31,582,0,0,582,1764,0,0,1764,56.9032
SAN DIEGO,Jan 2014,CACF,2014,SAINT VINCENT DE PAUL VILLAGE,ES_CHILD_BREAKFAST,31,582,0,0,582,1735,0,0,1735,55.9677
SAN DIEGO,Jan 2014,CACF,2014,SAINT VINCENT DE PAUL VILLAGE,ES_CHILD_LUNCH,31,582,0,0,582,1957,0,0,1957,63.129
SAN DIEGO,Jan 2014,CACF,2014,SAINT VINCENT DE PAUL VILLAGE,ES_CHILD_SUPPER,31,582,0,0,582,1991,0,0,1991,64.2258
SAN DIEGO,Feb 2014,CACF,2014,SAINT VINCENT DE PAUL VILLAGE,ES_CHILD_BREAKFAST,28,586,0,0,586,1676,0,0,1676,59.8571
SAN DIEGO,Feb 2014,CACF,2014,SAINT VINCENT DE PAUL VILLAGE,ES_CHILD_LUNCH,28,586,0,0,586,1340,0,0,1340,47.8571
SAN DIEGO,Feb 2014,CACF,2014,SAINT VINCENT DE PAUL VILLAGE,ES_CHILD_SUPPER,28,586,0,0,586,1428,0,0,1428,51
SAN DIEGO,Mar 2014,CACF,2014,SAINT VINCENT DE PAUL VILLAGE,ES_CHILD_BREAKFAST,31,574,0,0,574,1676,0,0,1676,54.0645
SAN DIEGO,Mar 2014,CACF,2014,SAINT VINCENT DE PAUL VILLAGE,ES_CHILD_LUNCH,31,574,0,0,574,1472,0,0,1472,47.4839
SAN DIEGO,Mar 2014,CACF,2014,SAINT VINCENT DE PAUL VILLAGE,ES_CHILD_SUPPER,31,574,0,0,574,1351,0,0,1351,43.5806
SAN DIEGO,Apr 2014,CACF,2014,SAINT VINCENT DE PAUL VILLAGE,ES_CHILD_BREAKFAST,30,573,0,0,573,1923,0,0,1923,64.1
SAN DIEGO,Apr 2014,CACF,2014,SAINT VINCENT DE PAUL VILLAGE,ES_CHILD_LUNCH,30,573,0,0,573,1806,0,0,1806,60.2
SAN DIEGO,Apr 2014,CACF,2014,SAINT VINCENT DE PAUL VILLAGE,ES_CHILD_SUPPER,30,573,0,0,573,1574,0,0,1574,52.4667
SAN DIEGO,May 2014,CACF,2014,SAINT VINCENT DE PAUL VILLAGE,ES_CHILD_BREAKFAST,31,585,0,0,585,1688,0,0,1688,54.4516
SAN DIEGO,May 2014,CACF,2014,SAINT VINCENT DE PAUL VILLAGE,ES_CHILD_LUNCH,31,585,0,0,585,1249,0,0,1249,40.2903
SAN DIEGO,May 2014,CACF,2014,SAINT VINCENT DE PAUL VILLAGE,ES_CHILD_SUPPER,31,585,0,0,585,1589,0,0,1589,51.2581
SAN DIEGO,Jun 2014,CACF,2014,SAINT VINCENT DE PAUL VILLAGE,ES_CHILD_BREAKFAST,30,570,0,0,570,1612,0,0,1612,53.7333
SAN DIEGO,Jun 2014,CACF,2014,SAINT VINCENT DE PAUL VILLAGE,ES_CHILD_LUNCH,30,570,0,0,570,1058,0,0,1058,35.2667
SAN DIEGO,Jun 2014,CACF,2014,SAINT VINCENT DE PAUL VILLAGE,ES_CHILD_SUPPER,30,570,0,0,570,1499,0,0,1499,49.9667
SAN DIEGO,Jul 2014,CACF,2014,SAINT VINCENT DE PAUL VILLAGE,ES_CHILD_BREAKFAST,31,555,0,0,555,1755,0,0,1755,56.6129
SAN DIEGO,Jul 2014,CACF,2014,SAINT VINCENT DE PAUL VILLAGE,ES_CHILD_LUNCH,31,555,0,0,555,1384,0,0,1384,44.6452
SAN DIEGO,Jul 2014,CACF,2014,SAINT VINCENT DE PAUL VILLAGE,ES_CHILD_SUPPER,31,555,0,0,555,1489,0,0,1489,48.0323
SAN DIEGO,Aug 2014,CACF,2014,SAINT VINCENT DE PAUL VILLAGE,ES_CHILD_BREAKFAST,31,573,0,0,573,1811,0,0,1811,58.4194
SAN DIEGO,Aug 2014,CACF,2014,SAINT VINCENT DE PAUL VILLAGE,ES_CHILD_LUNCH,31,573,0,0,573,1507,0,0,1507,48.6129
SAN DIEGO,Aug 2014,CACF,2014,SAINT VINCENT DE PAUL VILLAGE,ES_CHILD_SUPPER,31,573,0,0,573,1426,0,0,1426,46
SAN DIEGO,Sep 2014,CACF,2014,SAINT VINCENT DE PAUL VILLAGE,ES_CHILD_BREAKFAST,30,606,0,0,606,1889,0,0,1889,62.9667
SAN DIEGO,Sep 2014,CACF,2014,SAINT VINCENT DE PAUL VILLAGE,ES_CHILD_LUNCH,30,606,0,0,606,740,0,0,740,24.6667
SAN DIEGO,Sep 2014,CACF,2014,SAINT VINCENT DE PAUL VILLAGE,ES_CHILD_SUPPER,30,606,0,0,606,1483,0,0,1483,49.4333
SAN DIEGO,Oct 2013,CACF,2014,SAN DIEGO COMMUNITY COLL DIST ,CHILD_BREAKFAST,23,111,8,21,140,1523,110,288,1921,83.5217
SAN DIEGO,Oct 2013,CACF,2014,SAN DIEGO COMMUNITY COLL DIST ,CHILD_LUNCH,23,111,8,21,140,1727,124,327,2178,94.6957
SAN DIEGO,Oct 2013,CACF,2014,SAN DIEGO COMMUNITY COLL DIST ,CHILD_SNACK_PM,23,111,8,21,140,988,71,187,1246,54.1739
SAN DIEGO,Nov 2013,CACF,2014,SAN DIEGO COMMUNITY COLL DIST ,CHILD_BREAKFAST,15,111,8,21,140,977,70,185,1232,82.1333
SAN DIEGO,Nov 2013,CACF,2014,SAN DIEGO COMMUNITY COLL DIST ,CHILD_LUNCH,15,111,8,21,140,1102,79,209,1390,92.6667
SAN DIEGO,Nov 2013,CACF,2014,SAN DIEGO COMMUNITY COLL DIST ,CHILD_SNACK_PM,15,111,8,21,140,601,43,114,758,50.5333
SAN DIEGO,Dec 2013,CACF,2014,SAN DIEGO COMMUNITY COLL DIST ,CHILD_BREAKFAST,11,111,8,21,140,680,49,128,857,77.9091
SAN DIEGO,Dec 2013,CACF,2014,SAN DIEGO COMMUNITY COLL DIST ,CHILD_LUNCH,11,111,8,21,140,790,57,149,996,90.5455
SAN DIEGO,Dec 2013,CACF,2014,SAN DIEGO COMMUNITY COLL DIST ,CHILD_SNACK_PM,11,111,8,21,140,438,32,82,552,50.1818
SAN DIEGO,Jan 2014,CACF,2014,SAN DIEGO COMMUNITY COLL DIST ,CHILD_BREAKFAST,19,111,8,21,140,487,35,92,614,32.3158
SAN DIEGO,Jan 2014,CACF,2014,SAN DIEGO COMMUNITY COLL DIST ,CHILD_LUNCH,19,111,8,21,140,595,43,112,750,39.4737
SAN DIEGO,Jan 2014,CACF,2014,SAN DIEGO COMMUNITY COLL DIST ,CHILD_SNACK_PM,19,111,8,21,140,298,21,57,376,19.7895
SAN DIEGO,Feb 2014,CACF,2014,SAN DIEGO COMMUNITY COLL DIST ,CHILD_BREAKFAST,18,111,8,21,140,1354,98,256,1708,94.8889
SAN DIEGO,Feb 2014,CACF,2014,SAN DIEGO COMMUNITY COLL DIST ,CHILD_LUNCH,18,111,8,21,140,1627,117,308,2052,114
SAN DIEGO,Feb 2014,CACF,2014,SAN DIEGO COMMUNITY COLL DIST ,CHILD_SNACK_PM,18,111,8,21,140,938,68,177,1183,65.7222
SAN DIEGO,Mar 2014,CACF,2014,SAN DIEGO COMMUNITY COLL DIST ,CHILD_BREAKFAST,20,111,8,21,140,1436,103,272,1811,90.55
SAN DIEGO,Mar 2014,CACF,2014,SAN DIEGO COMMUNITY COLL DIST ,CHILD_LUNCH,20,111,8,21,140,1767,127,334,2228,111.4
SAN DIEGO,Mar 2014,CACF,2014,SAN DIEGO COMMUNITY COLL DIST ,CHILD_SNACK_PM,20,111,8,21,140,956,69,181,1206,60.3
SAN DIEGO,Apr 2014,CACF,2014,SAN DIEGO COMMUNITY COLL DIST ,CHILD_BREAKFAST,18,111,8,21,140,1292,93,245,1630,90.5556
SAN DIEGO,Apr 2014,CACF,2014,SAN DIEGO COMMUNITY COLL DIST ,CHILD_LUNCH,18,111,8,21,140,1624,117,307,2048,113.7778
SAN DIEGO,Apr 2014,CACF,2014,SAN DIEGO COMMUNITY COLL DIST ,CHILD_SNACK_PM,18,111,8,21,140,898,65,170,1133,62.9444
SAN DIEGO,May 2014,CACF,2014,SAN DIEGO COMMUNITY COLL DIST ,CHILD_BREAKFAST,21,111,8,21,140,1082,78,205,1365,65
SAN DIEGO,May 2014,CACF,2014,SAN DIEGO COMMUNITY COLL DIST ,CHILD_LUNCH,21,111,8,21,140,1356,98,256,1710,81.4286
SAN DIEGO,May 2014,CACF,2014,SAN DIEGO COMMUNITY COLL DIST ,CHILD_SNACK_PM,21,111,8,21,140,726,52,138,916,43.619
SAN DIEGO,Jun 2014,CACF,2014,SAN DIEGO COMMUNITY COLL DIST ,CHILD_BREAKFAST,5,111,8,21,140,36,3,6,45,9
SAN DIEGO,Jun 2014,CACF,2014,SAN DIEGO COMMUNITY COLL DIST ,CHILD_LUNCH,5,111,8,21,140,35,3,6,44,8.8
SAN DIEGO,Jun 2014,CACF,2014,SAN DIEGO COMMUNITY COLL DIST ,CHILD_SNACK_PM,5,111,8,21,140,36,3,6,45,9
SAN DIEGO,Aug 2014,CACF,2014,SAN DIEGO COMMUNITY COLL DIST ,CHILD_BREAKFAST,10,111,8,21,140,426,31,80,537,53.7
SAN DIEGO,Aug 2014,CACF,2014,SAN DIEGO COMMUNITY COLL DIST ,CHILD_LUNCH,10,111,8,21,140,498,36,94,628,62.8
SAN DIEGO,Aug 2014,CACF,2014,SAN DIEGO COMMUNITY COLL DIST ,CHILD_SNACK_PM,10,111,8,21,140,270,19,51,340,34
SAN DIEGO,Sep 2014,CACF,2014,SAN DIEGO COMMUNITY COLL DIST ,CHILD_BREAKFAST,21,111,8,21,140,1173,85,222,1480,70.4762
SAN DIEGO,Sep 2014,CACF,2014,SAN DIEGO COMMUNITY COLL DIST ,CHILD_LUNCH,21,111,8,21,140,1284,93,243,1620,77.1429
SAN DIEGO,Sep 2014,CACF,2014,SAN DIEGO COMMUNITY COLL DIST ,CHILD_SNACK_PM,21,111,8,21,140,776,56,147,979,46.619
SAN DIEGO,Oct 2013,CACF,2014,San Diego Unified School District,ATRISK_CHILD_SUPPER,23,11032,0,0,11032,198452,0,0,198452,8628.3478
SAN DIEGO,Nov 2013,CACF,2014,San Diego Unified School District,ATRISK_CHILD_SUPPER,15,11251,0,0,11251,140139,0,0,140139,9342.6
SAN DIEGO,Dec 2013,CACF,2014,San Diego Unified School District,ATRISK_CHILD_SUPPER,15,11120,0,0,11120,128833,0,0,128833,8588.8667
SAN DIEGO,Jan 2014,CACF,2014,San Diego Unified School District,ATRISK_CHILD_SUPPER,19,11421,0,0,11421,125906,0,0,125906,6626.6316
SAN DIEGO,Feb 2014,CACF,2014,San Diego Unified School District,ATRISK_CHILD_SUPPER,18,11276,0,0,11276,168434,0,0,168434,9357.4444
SAN DIEGO,Mar 2014,CACF,2014,San Diego Unified School District,ATRISK_CHILD_SUPPER,20,11222,0,0,11222,182784,0,0,182784,9139.2
SAN DIEGO,Apr 2014,CACF,2014,San Diego Unified School District,ATRISK_CHILD_SUPPER,18,11513,0,0,11513,103056,0,0,103056,5725.3333
SAN DIEGO,May 2014,CACF,2014,San Diego Unified School District,ATRISK_CHILD_SUPPER,20,11543,0,0,11543,179331,0,0,179331,8966.55
SAN DIEGO,Jun 2014,CACF,2014,San Diego Unified School District,ATRISK_CHILD_SUPPER,21,11639,0,0,11639,133496,0,0,133496,6356.9524
SAN DIEGO,Jul 2014,CACF,2014,San Diego Unified School District,ATRISK_CHILD_SUPPER,14,4619,0,0,4619,51087,0,0,51087,3649.0714
SAN DIEGO,Aug 2014,CACF,2014,San Diego Unified School District,ATRISK_CHILD_SUPPER,20,1112,0,0,1112,5511,0,0,5511,275.55
SAN DIEGO,Sep 2014,CACF,2014,San Diego Unified School District,ATRISK_CHILD_SUPPER,21,11077,0,0,11077,176803,0,0,176803,8419.1905
SAN DIEGO,Oct 2013,CACF,2014,SANTEE SCHOOL DISTRICT,ATRISK_CHILD_SNACK,22,241,0,0,241,1072,0,0,1072,48.7273
SAN DIEGO,Oct 2013,CACF,2014,SANTEE SCHOOL DISTRICT,ATRISK_CHILD_SUPPER,22,241,0,0,241,3019,0,0,3019,137.2273
SAN DIEGO,Nov 2013,CACF,2014,SANTEE SCHOOL DISTRICT,ATRISK_CHILD_SNACK,15,233,0,0,233,719,0,0,719,47.9333
SAN DIEGO,Nov 2013,CACF,2014,SANTEE SCHOOL DISTRICT,ATRISK_CHILD_SUPPER,15,233,0,0,233,2360,0,0,2360,157.3333
SAN DIEGO,Dec 2013,CACF,2014,SANTEE SCHOOL DISTRICT,ATRISK_CHILD_SNACK,15,228,0,0,228,680,0,0,680,45.3333
SAN DIEGO,Dec 2013,CACF,2014,SANTEE SCHOOL DISTRICT,ATRISK_CHILD_SUPPER,15,228,0,0,228,2163,0,0,2163,144.2
SAN DIEGO,Jan 2014,CACF,2014,SANTEE SCHOOL DISTRICT,ATRISK_CHILD_SNACK,18,218,0,0,218,943,0,0,943,52.3889
SAN DIEGO,Jan 2014,CACF,2014,SANTEE SCHOOL DISTRICT,ATRISK_CHILD_SUPPER,18,218,0,0,218,2465,0,0,2465,136.9444
SAN DIEGO,Feb 2014,CACF,2014,SANTEE SCHOOL DISTRICT,ATRISK_CHILD_SNACK,18,222,0,0,222,769,0,0,769,42.7222
SAN DIEGO,Feb 2014,CACF,2014,SANTEE SCHOOL DISTRICT,ATRISK_CHILD_SUPPER,18,222,0,0,222,2221,0,0,2221,123.3889
SAN DIEGO,Mar 2014,CACF,2014,SANTEE SCHOOL DISTRICT,ATRISK_CHILD_SNACK,21,223,0,0,223,873,0,0,873,41.5714
SAN DIEGO,Mar 2014,CACF,2014,SANTEE SCHOOL DISTRICT,ATRISK_CHILD_SUPPER,21,223,0,0,223,2851,0,0,2851,135.7619
SAN DIEGO,Apr 2014,CACF,2014,SANTEE SCHOOL DISTRICT,ATRISK_CHILD_SNACK,21,218,0,0,218,1257,0,0,1257,59.8571
SAN DIEGO,Apr 2014,CACF,2014,SANTEE SCHOOL DISTRICT,ATRISK_CHILD_SUPPER,21,218,0,0,218,2264,0,0,2264,107.8095
SAN DIEGO,May 2014,CACF,2014,SANTEE SCHOOL DISTRICT,ATRISK_CHILD_SNACK,20,224,0,0,224,907,0,0,907,45.35
SAN DIEGO,May 2014,CACF,2014,SANTEE SCHOOL DISTRICT,ATRISK_CHILD_SUPPER,20,224,0,0,224,2851,0,0,2851,142.55
SAN DIEGO,Jun 2014,CACF,2014,SANTEE SCHOOL DISTRICT,ATRISK_CHILD_SNACK,18,230,0,0,230,806,0,0,806,44.7778
SAN DIEGO,Jun 2014,CACF,2014,SANTEE SCHOOL DISTRICT,ATRISK_CHILD_SUPPER,18,230,0,0,230,2311,0,0,2311,128.3889
SAN DIEGO,Aug 2014,CACF,2014,SANTEE SCHOOL DISTRICT,ATRISK_CHILD_SNACK,5,239,0,0,239,543,0,0,543,108.6
SAN DIEGO,Aug 2014,CACF,2014,SANTEE SCHOOL DISTRICT,ATRISK_CHILD_SUPPER,5,239,0,0,239,863,0,0,863,172.6
SAN DIEGO,Sep 2014,CACF,2014,SANTEE SCHOOL DISTRICT,ATRISK_CHILD_SNACK,21,251,0,0,251,2033,0,0,2033,96.8095
SAN DIEGO,Sep 2014,CACF,2014,SANTEE SCHOOL DISTRICT,ATRISK_CHILD_SNACK_AM,21,251,0,0,251,676,0,0,676,32.1905
SAN DIEGO,Sep 2014,CACF,2014,SANTEE SCHOOL DISTRICT,ATRISK_CHILD_SUPPER,21,251,0,0,251,3780,0,0,3780,180
SAN DIEGO,Apr 2014,CACF,2014,SELF DISCOVERY INC,CHILD_BREAKFAST,21,19,4,7,30,137,29,51,217,10.3333
SAN DIEGO,Apr 2014,CACF,2014,SELF DISCOVERY INC,CHILD_LUNCH,21,19,4,7,30,278,59,102,439,20.9048
SAN DIEGO,Apr 2014,CACF,2014,SELF DISCOVERY INC,CHILD_SNACK_AM,21,19,4,7,30,206,43,76,325,15.4762
SAN DIEGO,Apr 2014,CACF,2014,SELF DISCOVERY INC,CHILD_SNACK_PM,21,19,4,7,30,117,25,43,185,8.8095
SAN DIEGO,Apr 2014,CACF,2014,SELF DISCOVERY INC,CHILD_SUPPER,21,19,4,7,30,59,12,22,93,4.4286
SAN DIEGO,May 2014,CACF,2014,SELF DISCOVERY INC,CHILD_BREAKFAST,21,16,5,11,32,113,35,77,225,10.7143
SAN DIEGO,May 2014,CACF,2014,SELF DISCOVERY INC,CHILD_LUNCH,21,16,5,11,32,241,75,165,481,22.9048
SAN DIEGO,May 2014,CACF,2014,SELF DISCOVERY INC,CHILD_SNACK_AM,21,16,5,11,32,168,53,115,336,16
SAN DIEGO,May 2014,CACF,2014,SELF DISCOVERY INC,CHILD_SNACK_PM,21,16,5,11,32,118,37,81,236,11.2381
SAN DIEGO,May 2014,CACF,2014,SELF DISCOVERY INC,CHILD_SUPPER,21,16,5,11,32,72,22,49,143,6.8095
SAN DIEGO,Jun 2014,CACF,2014,SELF DISCOVERY INC,CHILD_BREAKFAST,21,16,5,14,35,91,28,79,198,9.4286
SAN DIEGO,Jun 2014,CACF,2014,SELF DISCOVERY INC,CHILD_LUNCH,21,16,5,14,35,192,60,169,421,20.0476
SAN DIEGO,Jun 2014,CACF,2014,SELF DISCOVERY INC,CHILD_SNACK_AM,21,16,5,14,35,143,45,124,312,14.8571
SAN DIEGO,Jun 2014,CACF,2014,SELF DISCOVERY INC,CHILD_SNACK_PM,21,16,5,14,35,99,31,87,217,10.3333
SAN DIEGO,Jun 2014,CACF,2014,SELF DISCOVERY INC,CHILD_SUPPER,21,16,5,14,35,54,17,47,118,5.619
SAN DIEGO,Jul 2014,CACF,2014,SELF DISCOVERY INC,CHILD_BREAKFAST,23,15,7,14,36,89,41,83,213,9.2609
SAN DIEGO,Jul 2014,CACF,2014,SELF DISCOVERY INC,CHILD_LUNCH,23,15,7,14,36,177,82,165,424,18.4348
SAN DIEGO,Jul 2014,CACF,2014,SELF DISCOVERY INC,CHILD_SNACK_AM,23,15,7,14,36,133,62,123,318,13.8261
SAN DIEGO,Jul 2014,CACF,2014,SELF DISCOVERY INC,CHILD_SNACK_PM,23,15,7,14,36,83,38,77,198,8.6087
SAN DIEGO,Jul 2014,CACF,2014,SELF DISCOVERY INC,CHILD_SUPPER,23,15,7,14,36,50,23,46,119,5.1739
SAN DIEGO,Aug 2014,CACF,2014,SELF DISCOVERY INC,CHILD_BREAKFAST,21,17,5,14,36,124,37,102,263,12.5238
SAN DIEGO,Aug 2014,CACF,2014,SELF DISCOVERY INC,CHILD_LUNCH,21,17,5,14,36,260,77,214,551,26.2381
SAN DIEGO,Aug 2014,CACF,2014,SELF DISCOVERY INC,CHILD_SNACK_AM,21,17,5,14,36,179,53,147,379,18.0476
SAN DIEGO,Aug 2014,CACF,2014,SELF DISCOVERY INC,CHILD_SNACK_PM,21,17,5,14,36,121,36,99,256,12.1905
SAN DIEGO,Aug 2014,CACF,2014,SELF DISCOVERY INC,CHILD_SUPPER,21,17,5,14,36,64,19,53,136,6.4762
SAN DIEGO,Sep 2014,CACF,2014,SELF DISCOVERY INC,CHILD_BREAKFAST,20,21,5,19,45,129,31,116,276,13.8
SAN DIEGO,Sep 2014,CACF,2014,SELF DISCOVERY INC,CHILD_LUNCH,20,21,5,19,45,273,65,247,585,29.25
SAN DIEGO,Sep 2014,CACF,2014,SELF DISCOVERY INC,CHILD_SNACK_AM,20,21,5,19,45,192,46,174,412,20.6
SAN DIEGO,Sep 2014,CACF,2014,SELF DISCOVERY INC,CHILD_SNACK_PM,20,21,5,19,45,146,35,131,312,15.6
SAN DIEGO,Sep 2014,CACF,2014,SELF DISCOVERY INC,CHILD_SUPPER,20,21,5,19,45,78,19,71,168,8.4
SAN DIEGO,Oct 2013,CACF,2014,SOUTHERN CALIF TRIBAL CHAIR ASSOC-RINCON COMM DAYCARE CTR,CHILD_BREAKFAST,23,11,5,0,16,131,59,0,190,8.2609
SAN DIEGO,Oct 2013,CACF,2014,SOUTHERN CALIF TRIBAL CHAIR ASSOC-RINCON COMM DAYCARE CTR,CHILD_LUNCH,23,11,5,0,16,147,67,0,214,9.3043
SAN DIEGO,Oct 2013,CACF,2014,SOUTHERN CALIF TRIBAL CHAIR ASSOC-RINCON COMM DAYCARE CTR,CHILD_SNACK_PM,23,11,5,0,16,100,45,0,145,6.3043
SAN DIEGO,Nov 2013,CACF,2014,SOUTHERN CALIF TRIBAL CHAIR ASSOC-RINCON COMM DAYCARE CTR,CHILD_BREAKFAST,17,11,5,0,16,98,44,0,142,8.3529
SAN DIEGO,Nov 2013,CACF,2014,SOUTHERN CALIF TRIBAL CHAIR ASSOC-RINCON COMM DAYCARE CTR,CHILD_LUNCH,17,11,5,0,16,114,52,0,166,9.7647
SAN DIEGO,Nov 2013,CACF,2014,SOUTHERN CALIF TRIBAL CHAIR ASSOC-RINCON COMM DAYCARE CTR,CHILD_SNACK_PM,17,11,5,0,16,71,33,0,104,6.1176
SAN DIEGO,Dec 2013,CACF,2014,SOUTHERN CALIF TRIBAL CHAIR ASSOC-RINCON COMM DAYCARE CTR,CHILD_BREAKFAST,17,11,5,0,16,100,45,0,145,8.5294
SAN DIEGO,Dec 2013,CACF,2014,SOUTHERN CALIF TRIBAL CHAIR ASSOC-RINCON COMM DAYCARE CTR,CHILD_LUNCH,17,11,5,0,16,121,55,0,176,10.3529
SAN DIEGO,Dec 2013,CACF,2014,SOUTHERN CALIF TRIBAL CHAIR ASSOC-RINCON COMM DAYCARE CTR,CHILD_SNACK_PM,17,11,5,0,16,66,30,0,96,5.6471
SAN DIEGO,Jan 2014,CACF,2014,SOUTHERN CALIF TRIBAL CHAIR ASSOC-RINCON COMM DAYCARE CTR,CHILD_BREAKFAST,20,11,5,0,16,115,53,0,168,8.4
SAN DIEGO,Jan 2014,CACF,2014,SOUTHERN CALIF TRIBAL CHAIR ASSOC-RINCON COMM DAYCARE CTR,CHILD_LUNCH,20,11,5,0,16,135,62,0,197,9.85
SAN DIEGO,Jan 2014,CACF,2014,SOUTHERN CALIF TRIBAL CHAIR ASSOC-RINCON COMM DAYCARE CTR,CHILD_SNACK_PM,20,11,5,0,16,83,38,0,121,6.05
SAN DIEGO,Feb 2014,CACF,2014,SOUTHERN CALIF TRIBAL CHAIR ASSOC-RINCON COMM DAYCARE CTR,CHILD_BREAKFAST,19,11,5,0,16,118,53,0,171,9
SAN DIEGO,Feb 2014,CACF,2014,SOUTHERN CALIF TRIBAL CHAIR ASSOC-RINCON COMM DAYCARE CTR,CHILD_LUNCH,19,11,5,0,16,131,60,0,191,10.0526
SAN DIEGO,Feb 2014,CACF,2014,SOUTHERN CALIF TRIBAL CHAIR ASSOC-RINCON COMM DAYCARE CTR,CHILD_SNACK_PM,19,11,5,0,16,69,32,0,101,5.3158
SAN DIEGO,Mar 2014,CACF,2014,SOUTHERN CALIF TRIBAL CHAIR ASSOC-RINCON COMM DAYCARE CTR,CHILD_BREAKFAST,20,11,5,0,16,129,58,0,187,9.35
SAN DIEGO,Mar 2014,CACF,2014,SOUTHERN CALIF TRIBAL CHAIR ASSOC-RINCON COMM DAYCARE CTR,CHILD_LUNCH,20,11,5,0,16,149,68,0,217,10.85
SAN DIEGO,Mar 2014,CACF,2014,SOUTHERN CALIF TRIBAL CHAIR ASSOC-RINCON COMM DAYCARE CTR,CHILD_SNACK_PM,20,11,5,0,16,95,43,0,138,6.9
SAN DIEGO,Apr 2014,CACF,2014,SOUTHERN CALIF TRIBAL CHAIR ASSOC-RINCON COMM DAYCARE CTR,CHILD_BREAKFAST,22,11,5,0,16,160,73,0,233,10.5909
SAN DIEGO,Apr 2014,CACF,2014,SOUTHERN CALIF TRIBAL CHAIR ASSOC-RINCON COMM DAYCARE CTR,CHILD_LUNCH,22,11,5,0,16,181,82,0,263,11.9545
SAN DIEGO,Apr 2014,CACF,2014,SOUTHERN CALIF TRIBAL CHAIR ASSOC-RINCON COMM DAYCARE CTR,CHILD_SNACK_PM,22,11,5,0,16,114,52,0,166,7.5455
SAN DIEGO,May 2014,CACF,2014,SOUTHERN CALIF TRIBAL CHAIR ASSOC-RINCON COMM DAYCARE CTR,CHILD_BREAKFAST,21,11,5,0,16,144,66,0,210,10
SAN DIEGO,May 2014,CACF,2014,SOUTHERN CALIF TRIBAL CHAIR ASSOC-RINCON COMM DAYCARE CTR,CHILD_LUNCH,21,11,5,0,16,176,80,0,256,12.1905
SAN DIEGO,May 2014,CACF,2014,SOUTHERN CALIF TRIBAL CHAIR ASSOC-RINCON COMM DAYCARE CTR,CHILD_SNACK_PM,21,11,5,0,16,109,49,0,158,7.5238
SAN DIEGO,Jun 2014,CACF,2014,SOUTHERN CALIF TRIBAL CHAIR ASSOC-RINCON COMM DAYCARE CTR,CHILD_BREAKFAST,21,11,5,0,16,146,67,0,213,10.1429
SAN DIEGO,Jun 2014,CACF,2014,SOUTHERN CALIF TRIBAL CHAIR ASSOC-RINCON COMM DAYCARE CTR,CHILD_LUNCH,21,11,5,0,16,167,76,0,243,11.5714
SAN DIEGO,Jun 2014,CACF,2014,SOUTHERN CALIF TRIBAL CHAIR ASSOC-RINCON COMM DAYCARE CTR,CHILD_SNACK_PM,21,11,5,0,16,122,56,0,178,8.4762
SAN DIEGO,Jul 2014,CACF,2014,SOUTHERN CALIF TRIBAL CHAIR ASSOC-RINCON COMM DAYCARE CTR,CHILD_BREAKFAST,22,11,5,0,16,129,59,0,188,8.5455
SAN DIEGO,Jul 2014,CACF,2014,SOUTHERN CALIF TRIBAL CHAIR ASSOC-RINCON COMM DAYCARE CTR,CHILD_LUNCH,22,11,5,0,16,133,61,0,194,8.8182
SAN DIEGO,Jul 2014,CACF,2014,SOUTHERN CALIF TRIBAL CHAIR ASSOC-RINCON COMM DAYCARE CTR,CHILD_SNACK_PM,22,11,5,0,16,96,43,0,139,6.3182
SAN DIEGO,Aug 2014,CACF,2014,SOUTHERN CALIF TRIBAL CHAIR ASSOC-RINCON COMM DAYCARE CTR,CHILD_BREAKFAST,21,11,5,0,16,122,55,0,177,8.4286
SAN DIEGO,Aug 2014,CACF,2014,SOUTHERN CALIF TRIBAL CHAIR ASSOC-RINCON COMM DAYCARE CTR,CHILD_LUNCH,21,11,5,0,16,121,55,0,176,8.381
SAN DIEGO,Aug 2014,CACF,2014,SOUTHERN CALIF TRIBAL CHAIR ASSOC-RINCON COMM DAYCARE CTR,CHILD_SNACK_PM,21,11,5,0,16,96,43,0,139,6.619
SAN DIEGO,Sep 2014,CACF,2014,SOUTHERN CALIF TRIBAL CHAIR ASSOC-RINCON COMM DAYCARE CTR,CHILD_BREAKFAST,22,11,5,0,16,144,66,0,210,9.5455
SAN DIEGO,Sep 2014,CACF,2014,SOUTHERN CALIF TRIBAL CHAIR ASSOC-RINCON COMM DAYCARE CTR,CHILD_LUNCH,22,11,5,0,16,144,66,0,210,9.5455
SAN DIEGO,Sep 2014,CACF,2014,SOUTHERN CALIF TRIBAL CHAIR ASSOC-RINCON COMM DAYCARE CTR,CHILD_SNACK_PM,22,11,5,0,16,112,51,0,163,7.4091
SAN DIEGO,Oct 2013,CACF,2014,SWEET BUSY BEES,CHILD_BREAKFAST,22,9,0,1,10,192,0,21,213,9.6818
SAN DIEGO,Oct 2013,CACF,2014,SWEET BUSY BEES,CHILD_LUNCH,22,9,0,1,10,192,0,21,213,9.6818
SAN DIEGO,Oct 2013,CACF,2014,SWEET BUSY BEES,CHILD_SNACK_AM,22,9,0,1,10,192,0,21,213,9.6818
SAN DIEGO,Nov 2013,CACF,2014,SWEET BUSY BEES,CHILD_BREAKFAST,18,9,0,1,10,146,0,16,162,9
SAN DIEGO,Nov 2013,CACF,2014,SWEET BUSY BEES,CHILD_LUNCH,18,9,0,1,10,146,0,16,162,9
SAN DIEGO,Nov 2013,CACF,2014,SWEET BUSY BEES,CHILD_SNACK_AM,18,9,0,1,10,146,0,16,162,9
SAN DIEGO,Dec 2013,CACF,2014,SWEET BUSY BEES,CHILD_BREAKFAST,18,9,0,1,10,143,0,16,159,8.8333
SAN DIEGO,Dec 2013,CACF,2014,SWEET BUSY BEES,CHILD_LUNCH,18,9,0,1,10,143,0,16,159,8.8333
SAN DIEGO,Dec 2013,CACF,2014,SWEET BUSY BEES,CHILD_SNACK_AM,18,9,0,1,10,143,0,16,159,8.8333
SAN DIEGO,Jan 2014,CACF,2014,SWEET BUSY BEES,CHILD_BREAKFAST,21,9,0,1,10,166,0,18,184,8.7619
SAN DIEGO,Jan 2014,CACF,2014,SWEET BUSY BEES,CHILD_LUNCH,21,9,0,1,10,166,0,18,184,8.7619
SAN DIEGO,Jan 2014,CACF,2014,SWEET BUSY BEES,CHILD_SNACK_AM,21,9,0,1,10,166,0,18,184,8.7619
SAN DIEGO,Feb 2014,CACF,2014,SWEET BUSY BEES,CHILD_BREAKFAST,19,9,0,1,10,152,0,17,169,8.8947
SAN DIEGO,Feb 2014,CACF,2014,SWEET BUSY BEES,CHILD_LUNCH,19,9,0,1,10,152,0,17,169,8.8947
SAN DIEGO,Feb 2014,CACF,2014,SWEET BUSY BEES,CHILD_SNACK_AM,19,9,0,1,10,152,0,17,169,8.8947
SAN DIEGO,Mar 2014,CACF,2014,SWEET BUSY BEES,CHILD_BREAKFAST,21,10,0,2,12,191,0,38,229,10.9048
SAN DIEGO,Mar 2014,CACF,2014,SWEET BUSY BEES,CHILD_LUNCH,21,10,0,2,12,191,0,38,229,10.9048
SAN DIEGO,Mar 2014,CACF,2014,SWEET BUSY BEES,CHILD_SNACK_AM,21,10,0,2,12,191,0,38,229,10.9048
SAN DIEGO,Apr 2014,CACF,2014,SWEET BUSY BEES,CHILD_BREAKFAST,22,10,0,2,12,170,0,34,204,9.2727
SAN DIEGO,Apr 2014,CACF,2014,SWEET BUSY BEES,CHILD_LUNCH,22,10,0,2,12,176,0,35,211,9.5909
SAN DIEGO,Apr 2014,CACF,2014,SWEET BUSY BEES,CHILD_SNACK_AM,22,10,0,2,12,176,0,35,211,9.5909
SAN DIEGO,May 2014,CACF,2014,SWEET BUSY BEES,CHILD_BREAKFAST,21,10,0,2,12,201,0,40,241,11.4762
SAN DIEGO,May 2014,CACF,2014,SWEET BUSY BEES,CHILD_LUNCH,21,10,0,2,12,202,0,40,242,11.5238
SAN DIEGO,May 2014,CACF,2014,SWEET BUSY BEES,CHILD_SNACK_AM,21,10,0,2,12,202,0,40,242,11.5238
SAN DIEGO,Jun 2014,CACF,2014,SWEET BUSY BEES,CHILD_BREAKFAST,21,11,0,2,13,214,0,39,253,12.0476
SAN DIEGO,Jun 2014,CACF,2014,SWEET BUSY BEES,CHILD_LUNCH,21,11,0,2,13,213,0,39,252,12
SAN DIEGO,Jun 2014,CACF,2014,SWEET BUSY BEES,CHILD_SNACK_AM,21,11,0,2,13,214,0,39,253,12.0476
SAN DIEGO,Jul 2014,CACF,2014,SWEET BUSY BEES,CHILD_BREAKFAST,22,11,0,2,13,220,0,40,260,11.8182
SAN DIEGO,Jul 2014,CACF,2014,SWEET BUSY BEES,CHILD_LUNCH,22,11,0,2,13,221,0,40,261,11.8636
SAN DIEGO,Jul 2014,CACF,2014,SWEET BUSY BEES,CHILD_SNACK_AM,22,11,0,2,13,221,0,40,261,11.8636
SAN DIEGO,Aug 2014,CACF,2014,SWEET BUSY BEES,CHILD_BREAKFAST,20,11,0,2,13,183,0,33,216,10.8
SAN DIEGO,Aug 2014,CACF,2014,SWEET BUSY BEES,CHILD_LUNCH,20,11,0,2,13,184,0,34,218,10.9
SAN DIEGO,Aug 2014,CACF,2014,SWEET BUSY BEES,CHILD_SNACK_AM,20,11,0,2,13,184,0,34,218,10.9
SAN DIEGO,Sep 2014,CACF,2014,SWEET BUSY BEES,CHILD_BREAKFAST,21,6,0,2,8,125,0,42,167,7.9524
SAN DIEGO,Sep 2014,CACF,2014,SWEET BUSY BEES,CHILD_LUNCH,21,6,0,2,8,125,0,42,167,7.9524
SAN DIEGO,Sep 2014,CACF,2014,SWEET BUSY BEES,CHILD_SNACK_AM,21,6,0,2,8,125,0,42,167,7.9524
SAN DIEGO,Oct 2013,CACF,2014,Sweetwater Union High School District,ATRISK_CHILD_SUPPER,18,31440,0,0,31440,31440,0,0,31440,1746.6667
SAN DIEGO,Nov 2013,CACF,2014,Sweetwater Union High School District,ATRISK_CHILD_SUPPER,18,26965,0,0,26965,26965,0,0,26965,1498.0556
SAN DIEGO,Dec 2013,CACF,2014,Sweetwater Union High School District,ATRISK_CHILD_SUPPER,15,21964,0,0,21964,21964,0,0,21964,1464.2667
SAN DIEGO,Jan 2014,CACF,2014,Sweetwater Union High School District,ATRISK_CHILD_SUPPER,18,18593,0,0,18593,18593,0,0,18593,1032.9444
SAN DIEGO,Feb 2014,CACF,2014,Sweetwater Union High School District,ATRISK_CHILD_SUPPER,18,28972,0,0,28972,28972,0,0,28972,1609.5556
SAN DIEGO,Mar 2014,CACF,2014,Sweetwater Union High School District,ATRISK_CHILD_SUPPER,15,21410,0,0,21410,21410,0,0,21410,1427.3333
SAN DIEGO,Apr 2014,CACF,2014,Sweetwater Union High School District,ATRISK_CHILD_SUPPER,18,25555,0,0,25555,25555,0,0,25555,1419.7222
SAN DIEGO,May 2014,CACF,2014,Sweetwater Union High School District,ATRISK_CHILD_SUPPER,21,26993,0,0,26993,26993,0,0,26993,1285.381
SAN DIEGO,Jun 2014,CACF,2014,Sweetwater Union High School District,ATRISK_CHILD_SUPPER,6,2168,0,0,2168,2168,0,0,2168,361.3333
SAN DIEGO,Jul 2014,CACF,2014,Sweetwater Union High School District,ATRISK_CHILD_SUPPER,7,6022,0,0,6022,6022,0,0,6022,860.2857
SAN DIEGO,Aug 2014,CACF,2014,Sweetwater Union High School District,ATRISK_CHILD_SUPPER,20,32467,0,0,32467,32467,0,0,32467,1623.35
SAN DIEGO,Sep 2014,CACF,2014,Sweetwater Union High School District,ATRISK_CHILD_SUPPER,14,25029,0,0,25029,25029,0,0,25029,1787.7857
SAN DIEGO,Oct 2013,CACF,2014,The Vine Learning Center,CHILD_BREAKFAST,23,23,3,54,80,337,44,792,1173,51
SAN DIEGO,Oct 2013,CACF,2014,The Vine Learning Center,CHILD_LUNCH,23,23,3,54,80,430,56,1010,1496,65.0435
SAN DIEGO,Oct 2013,CACF,2014,The Vine Learning Center,CHILD_SNACK_PM,23,23,3,54,80,421,55,987,1463,63.6087
SAN DIEGO,Nov 2013,CACF,2014,The Vine Learning Center,CHILD_BREAKFAST,18,23,3,54,80,269,35,630,934,51.8889
SAN DIEGO,Nov 2013,CACF,2014,The Vine Learning Center,CHILD_LUNCH,18,23,3,54,80,356,46,835,1237,68.7222
SAN DIEGO,Nov 2013,CACF,2014,The Vine Learning Center,CHILD_SNACK_PM,18,23,3,54,80,343,45,806,1194,66.3333
SAN DIEGO,Dec 2013,CACF,2014,The Vine Learning Center,CHILD_BREAKFAST,21,23,3,54,80,273,36,642,951,45.2857
SAN DIEGO,Dec 2013,CACF,2014,The Vine Learning Center,CHILD_LUNCH,21,23,3,54,80,351,46,824,1221,58.1429
SAN DIEGO,Dec 2013,CACF,2014,The Vine Learning Center,CHILD_SNACK_PM,21,23,3,54,80,333,43,783,1159,55.1905
SAN DIEGO,Jan 2014,CACF,2014,The Vine Learning Center,CHILD_BREAKFAST,22,23,3,54,80,372,49,874,1295,58.8636
SAN DIEGO,Jan 2014,CACF,2014,The Vine Learning Center,CHILD_LUNCH,22,23,3,54,80,471,61,1106,1638,74.4545
SAN DIEGO,Jan 2014,CACF,2014,The Vine Learning Center,CHILD_SNACK_PM,22,23,3,54,80,460,60,1079,1599,72.6818
SAN DIEGO,Feb 2014,CACF,2014,The Vine Learning Center,CHILD_BREAKFAST,19,23,3,54,80,323,42,760,1125,59.2105
SAN DIEGO,Feb 2014,CACF,2014,The Vine Learning Center,CHILD_LUNCH,19,23,3,54,80,432,56,1013,1501,79
SAN DIEGO,Feb 2014,CACF,2014,The Vine Learning Center,CHILD_SNACK_PM,19,23,3,54,80,415,54,973,1442,75.8947
SAN DIEGO,Mar 2014,CACF,2014,The Vine Learning Center,CHILD_BREAKFAST,21,23,3,54,80,380,50,890,1320,62.8571
SAN DIEGO,Mar 2014,CACF,2014,The Vine Learning Center,CHILD_LUNCH,21,23,3,54,80,470,61,1105,1636,77.9048
SAN DIEGO,Mar 2014,CACF,2014,The Vine Learning Center,CHILD_SNACK_PM,21,23,3,54,80,453,59,1062,1574,74.9524
SAN DIEGO,Apr 2014,CACF,2014,The Vine Learning Center,CHILD_BREAKFAST,22,23,3,54,80,428,56,1006,1490,67.7273
SAN DIEGO,Apr 2014,CACF,2014,The Vine Learning Center,CHILD_LUNCH,22,23,3,54,80,505,66,1187,1758,79.9091
SAN DIEGO,Apr 2014,CACF,2014,The Vine Learning Center,CHILD_SNACK_PM,22,23,3,54,80,505,66,1187,1758,79.9091
SAN DIEGO,May 2014,CACF,2014,The Vine Learning Center,CHILD_BREAKFAST,22,23,3,54,80,404,53,948,1405,63.8636
SAN DIEGO,May 2014,CACF,2014,The Vine Learning Center,CHILD_LUNCH,22,23,3,54,80,503,66,1180,1749,79.5
SAN DIEGO,May 2014,CACF,2014,The Vine Learning Center,CHILD_SNACK_PM,22,23,3,54,80,485,63,1139,1687,76.6818
SAN DIEGO,Jun 2014,CACF,2014,The Vine Learning Center,CHILD_BREAKFAST,21,23,3,54,80,324,42,762,1128,53.7143
SAN DIEGO,Jun 2014,CACF,2014,The Vine Learning Center,CHILD_LUNCH,21,23,3,54,80,406,53,954,1413,67.2857
SAN DIEGO,Jun 2014,CACF,2014,The Vine Learning Center,CHILD_SNACK_PM,21,23,3,54,80,391,51,919,1361,64.8095
SAN DIEGO,Jul 2014,CACF,2014,The Vine Learning Center,CHILD_BREAKFAST,22,23,3,54,80,371,48,870,1289,58.5909
SAN DIEGO,Jul 2014,CACF,2014,The Vine Learning Center,CHILD_LUNCH,22,23,3,54,80,484,63,1135,1682,76.4545
SAN DIEGO,Jul 2014,CACF,2014,The Vine Learning Center,CHILD_SNACK_PM,22,23,3,54,80,462,60,1084,1606,73
SAN DIEGO,Aug 2014,CACF,2014,The Vine Learning Center,CHILD_BREAKFAST,21,23,3,54,80,296,39,696,1031,49.0952
SAN DIEGO,Aug 2014,CACF,2014,The Vine Learning Center,CHILD_LUNCH,21,23,3,54,80,399,52,936,1387,66.0476
SAN DIEGO,Aug 2014,CACF,2014,The Vine Learning Center,CHILD_SNACK_PM,21,23,3,54,80,378,49,889,1316,62.6667
SAN DIEGO,Sep 2014,CACF,2014,The Vine Learning Center,CHILD_BREAKFAST,21,23,3,54,80,204,27,477,708,33.7143
SAN DIEGO,Sep 2014,CACF,2014,The Vine Learning Center,CHILD_LUNCH,21,23,3,54,80,265,35,623,923,43.9524
SAN DIEGO,Sep 2014,CACF,2014,The Vine Learning Center,CHILD_SNACK_PM,21,23,3,54,80,251,33,588,872,41.5238
SAN DIEGO,Oct 2013,CACF,2014,TODDLER TOWN LLC ,CHILD_BREAKFAST,23,54,6,24,84,630,70,280,980,42.6087
SAN DIEGO,Oct 2013,CACF,2014,TODDLER TOWN LLC ,CHILD_LUNCH,23,54,6,24,84,793,88,353,1234,53.6522
SAN DIEGO,Oct 2013,CACF,2014,TODDLER TOWN LLC ,CHILD_SNACK_PM,23,54,6,24,84,689,76,306,1071,46.5652
SAN DIEGO,Oct 2013,CACF,2014,TODDLER TOWN LLC ,OSCH_CHILD_BREAKFAST,23,9,2,3,14,53,12,18,83,3.6087
SAN DIEGO,Oct 2013,CACF,2014,TODDLER TOWN LLC ,OSCH_CHILD_LUNCH,23,9,2,3,14,26,6,8,40,1.7391
SAN DIEGO,Oct 2013,CACF,2014,TODDLER TOWN LLC ,OSCH_CHILD_SNACK_PM,23,9,2,3,14,116,26,38,180,7.8261
SAN DIEGO,Nov 2013,CACF,2014,TODDLER TOWN LLC ,CHILD_BREAKFAST,19,51,5,20,76,485,48,189,722,38
SAN DIEGO,Nov 2013,CACF,2014,TODDLER TOWN LLC ,CHILD_LUNCH,19,51,5,20,76,603,59,236,898,47.2632
SAN DIEGO,Nov 2013,CACF,2014,TODDLER TOWN LLC ,CHILD_SNACK_PM,19,51,5,20,76,544,53,213,810,42.6316
SAN DIEGO,Nov 2013,CACF,2014,TODDLER TOWN LLC ,OSCH_CHILD_BREAKFAST,19,12,2,3,17,34,6,8,48,2.5263
SAN DIEGO,Nov 2013,CACF,2014,TODDLER TOWN LLC ,OSCH_CHILD_LUNCH,19,12,2,3,17,17,3,4,24,1.2632
SAN DIEGO,Nov 2013,CACF,2014,TODDLER TOWN LLC ,OSCH_CHILD_SNACK_PM,19,12,2,3,17,96,16,24,136,7.1579
SAN DIEGO,Dec 2013,CACF,2014,TODDLER TOWN LLC ,CHILD_BREAKFAST,15,51,5,20,76,391,38,154,583,38.8667
SAN DIEGO,Dec 2013,CACF,2014,TODDLER TOWN LLC ,CHILD_LUNCH,15,51,5,20,76,458,45,179,682,45.4667
SAN DIEGO,Dec 2013,CACF,2014,TODDLER TOWN LLC ,CHILD_SNACK_PM,15,51,5,20,76,453,44,178,675,45
SAN DIEGO,Dec 2013,CACF,2014,TODDLER TOWN LLC ,OSCH_CHILD_BREAKFAST,15,12,2,3,17,16,3,4,23,1.5333
SAN DIEGO,Dec 2013,CACF,2014,TODDLER TOWN LLC ,OSCH_CHILD_LUNCH,15,12,2,3,17,2,0,1,3,0.2
SAN DIEGO,Dec 2013,CACF,2014,TODDLER TOWN LLC ,OSCH_CHILD_SNACK_PM,15,12,2,3,17,74,12,19,105,7
SAN DIEGO,Jan 2014,CACF,2014,TODDLER TOWN LLC ,CHILD_BREAKFAST,21,51,5,20,76,460,45,181,686,32.6667
SAN DIEGO,Jan 2014,CACF,2014,TODDLER TOWN LLC ,CHILD_LUNCH,21,51,5,20,76,614,60,241,915,43.5714
SAN DIEGO,Jan 2014,CACF,2014,TODDLER TOWN LLC ,CHILD_SNACK_PM,21,51,5,20,76,580,57,227,864,41.1429
SAN DIEGO,Jan 2014,CACF,2014,TODDLER TOWN LLC ,OSCH_CHILD_BREAKFAST,21,12,2,3,17,30,5,8,43,2.0476
SAN DIEGO,Jan 2014,CACF,2014,TODDLER TOWN LLC ,OSCH_CHILD_LUNCH,21,12,2,3,17,22,4,5,31,1.4762
SAN DIEGO,Jan 2014,CACF,2014,TODDLER TOWN LLC ,OSCH_CHILD_SNACK_PM,21,12,2,3,17,98,16,25,139,6.619
SAN DIEGO,Feb 2014,CACF,2014,TODDLER TOWN LLC ,CHILD_BREAKFAST,19,51,5,20,76,414,41,162,617,32.4737
SAN DIEGO,Feb 2014,CACF,2014,TODDLER TOWN LLC ,CHILD_LUNCH,19,51,5,20,76,601,59,236,896,47.1579
SAN DIEGO,Feb 2014,CACF,2014,TODDLER TOWN LLC ,CHILD_SNACK_PM,19,51,5,20,76,550,54,216,820,43.1579
SAN DIEGO,Feb 2014,CACF,2014,TODDLER TOWN LLC ,OSCH_CHILD_BREAKFAST,19,12,2,3,17,7,1,2,10,0.5263
SAN DIEGO,Feb 2014,CACF,2014,TODDLER TOWN LLC ,OSCH_CHILD_LUNCH,19,12,2,3,17,24,4,6,34,1.7895
SAN DIEGO,Feb 2014,CACF,2014,TODDLER TOWN LLC ,OSCH_CHILD_SNACK_PM,19,12,2,3,17,110,18,28,156,8.2105
SAN DIEGO,Mar 2014,CACF,2014,TODDLER TOWN LLC ,CHILD_BREAKFAST,21,51,5,20,76,490,48,192,730,34.7619
SAN DIEGO,Mar 2014,CACF,2014,TODDLER TOWN LLC ,CHILD_LUNCH,21,51,5,20,76,711,70,278,1059,50.4286
SAN DIEGO,Mar 2014,CACF,2014,TODDLER TOWN LLC ,CHILD_SNACK_PM,21,51,5,20,76,652,64,255,971,46.2381
SAN DIEGO,Mar 2014,CACF,2014,TODDLER TOWN LLC ,OSCH_CHILD_BREAKFAST,21,12,2,3,17,12,2,3,17,0.8095
SAN DIEGO,Mar 2014,CACF,2014,TODDLER TOWN LLC ,OSCH_CHILD_LUNCH,21,12,2,3,17,3,0,1,4,0.1905
SAN DIEGO,Mar 2014,CACF,2014,TODDLER TOWN LLC ,OSCH_CHILD_SNACK_PM,21,12,2,3,17,142,24,35,201,9.5714
SAN DIEGO,Apr 2014,CACF,2014,TODDLER TOWN LLC ,CHILD_BREAKFAST,22,51,5,20,76,586,57,230,873,39.6818
SAN DIEGO,Apr 2014,CACF,2014,TODDLER TOWN LLC ,CHILD_LUNCH,22,51,5,20,76,772,76,302,1150,52.2727
SAN DIEGO,Apr 2014,CACF,2014,TODDLER TOWN LLC ,CHILD_SNACK_PM,22,51,5,20,76,692,68,271,1031,46.8636
SAN DIEGO,Apr 2014,CACF,2014,TODDLER TOWN LLC ,OSCH_CHILD_BREAKFAST,22,12,2,3,17,39,6,10,55,2.5
SAN DIEGO,Apr 2014,CACF,2014,TODDLER TOWN LLC ,OSCH_CHILD_LUNCH,22,12,2,3,17,40,7,10,57,2.5909
SAN DIEGO,Apr 2014,CACF,2014,TODDLER TOWN LLC ,OSCH_CHILD_SNACK_PM,22,12,2,3,17,97,16,25,138,6.2727
SAN DIEGO,May 2014,CACF,2014,TODDLER TOWN LLC ,CHILD_BREAKFAST,18,51,5,20,76,499,49,196,744,41.3333
SAN DIEGO,May 2014,CACF,2014,TODDLER TOWN LLC ,CHILD_LUNCH,18,51,5,20,76,728,71,286,1085,60.2778
SAN DIEGO,May 2014,CACF,2014,TODDLER TOWN LLC ,CHILD_SNACK_PM,18,51,5,20,76,637,62,250,949,52.7222
SAN DIEGO,May 2014,CACF,2014,TODDLER TOWN LLC ,OSCH_CHILD_LUNCH,18,12,2,3,17,6,1,1,8,0.4444
SAN DIEGO,May 2014,CACF,2014,TODDLER TOWN LLC ,OSCH_CHILD_SNACK_PM,18,12,2,3,17,53,9,13,75,4.1667
SAN DIEGO,Jun 2014,CACF,2014,TODDLER TOWN LLC ,CHILD_BREAKFAST,21,51,5,20,76,512,50,201,763,36.3333
SAN DIEGO,Jun 2014,CACF,2014,TODDLER TOWN LLC ,CHILD_LUNCH,21,51,5,20,76,652,64,256,972,46.2857
SAN DIEGO,Jun 2014,CACF,2014,TODDLER TOWN LLC ,CHILD_SNACK_PM,21,51,5,20,76,577,57,226,860,40.9524
SAN DIEGO,Jun 2014,CACF,2014,TODDLER TOWN LLC ,OSCH_CHILD_BREAKFAST,21,12,2,3,17,38,6,10,54,2.5714
SAN DIEGO,Jun 2014,CACF,2014,TODDLER TOWN LLC ,OSCH_CHILD_LUNCH,21,12,2,3,17,54,9,13,76,3.619
SAN DIEGO,Jun 2014,CACF,2014,TODDLER TOWN LLC ,OSCH_CHILD_SNACK_PM,21,12,2,3,17,76,13,18,107,5.0952
SAN DIEGO,Jul 2014,CACF,2014,TODDLER TOWN LLC ,CHILD_BREAKFAST,22,51,5,20,76,477,47,187,711,32.3182
SAN DIEGO,Jul 2014,CACF,2014,TODDLER TOWN LLC ,CHILD_LUNCH,22,51,5,20,76,568,56,223,847,38.5
SAN DIEGO,Jul 2014,CACF,2014,TODDLER TOWN LLC ,CHILD_SNACK_PM,22,51,5,20,76,511,50,200,761,34.5909
SAN DIEGO,Jul 2014,CACF,2014,TODDLER TOWN LLC ,OSCH_CHILD_BREAKFAST,22,12,2,3,17,28,5,7,40,1.8182
SAN DIEGO,Jul 2014,CACF,2014,TODDLER TOWN LLC ,OSCH_CHILD_LUNCH,22,12,2,3,17,52,9,13,74,3.3636
SAN DIEGO,Jul 2014,CACF,2014,TODDLER TOWN LLC ,OSCH_CHILD_SNACK_PM,22,12,2,3,17,44,7,11,62,2.8182
SAN DIEGO,Aug 2014,CACF,2014,TODDLER TOWN LLC ,CHILD_BREAKFAST,20,51,5,20,76,423,41,166,630,31.5
SAN DIEGO,Aug 2014,CACF,2014,TODDLER TOWN LLC ,CHILD_LUNCH,20,51,5,20,76,501,49,197,747,37.35
SAN DIEGO,Aug 2014,CACF,2014,TODDLER TOWN LLC ,CHILD_SNACK_PM,20,51,5,20,76,483,47,189,719,35.95
SAN DIEGO,Aug 2014,CACF,2014,TODDLER TOWN LLC ,OSCH_CHILD_BREAKFAST,20,12,2,3,17,12,2,3,17,0.85
SAN DIEGO,Aug 2014,CACF,2014,TODDLER TOWN LLC ,OSCH_CHILD_LUNCH,20,12,2,3,17,25,4,6,35,1.75
SAN DIEGO,Aug 2014,CACF,2014,TODDLER TOWN LLC ,OSCH_CHILD_SNACK_PM,20,12,2,3,17,47,8,11,66,3.3
SAN DIEGO,Sep 2014,CACF,2014,TODDLER TOWN LLC ,CHILD_BREAKFAST,21,51,5,20,76,336,33,132,501,23.8571
SAN DIEGO,Sep 2014,CACF,2014,TODDLER TOWN LLC ,CHILD_LUNCH,21,51,5,20,76,448,44,176,668,31.8095
SAN DIEGO,Sep 2014,CACF,2014,TODDLER TOWN LLC ,CHILD_SNACK_PM,21,51,5,20,76,407,40,159,606,28.8571
SAN DIEGO,Sep 2014,CACF,2014,TODDLER TOWN LLC ,OSCH_CHILD_BREAKFAST,21,12,2,3,17,8,1,3,12,0.5714
SAN DIEGO,Sep 2014,CACF,2014,TODDLER TOWN LLC ,OSCH_CHILD_LUNCH,21,12,2,3,17,8,1,3,12,0.5714
SAN DIEGO,Sep 2014,CACF,2014,TODDLER TOWN LLC ,OSCH_CHILD_SNACK_PM,21,12,2,3,17,48,8,12,68,3.2381
SAN DIEGO,Oct 2013,CACF,2014,TUTOR TIME LEARNING CENTERS LLC,CHILD_BREAKFAST,23,125,27,194,346,1455,314,2257,4026,175.0435
SAN DIEGO,Oct 2013,CACF,2014,TUTOR TIME LEARNING CENTERS LLC,CHILD_LUNCH,23,125,27,194,346,1860,402,2886,5148,223.8261
SAN DIEGO,Oct 2013,CACF,2014,TUTOR TIME LEARNING CENTERS LLC,CHILD_SNACK_PM,23,125,27,194,346,1728,373,2681,4782,207.913
SAN DIEGO,Oct 2013,CACF,2014,TUTOR TIME LEARNING CENTERS LLC,OSCH_CHILD_BREAKFAST,23,48,16,50,114,151,50,158,359,15.6087
SAN DIEGO,Oct 2013,CACF,2014,TUTOR TIME LEARNING CENTERS LLC,OSCH_CHILD_LUNCH,23,48,16,50,114,216,72,225,513,22.3043
SAN DIEGO,Oct 2013,CACF,2014,TUTOR TIME LEARNING CENTERS LLC,OSCH_CHILD_SNACK_PM,23,48,16,50,114,766,256,798,1820,79.1304
SAN DIEGO,Nov 2013,CACF,2014,TUTOR TIME LEARNING CENTERS LLC,CHILD_BREAKFAST,19,125,27,194,346,1184,256,1837,3277,172.4737
SAN DIEGO,Nov 2013,CACF,2014,TUTOR TIME LEARNING CENTERS LLC,CHILD_LUNCH,19,125,27,194,346,1520,328,2360,4208,221.4737
SAN DIEGO,Nov 2013,CACF,2014,TUTOR TIME LEARNING CENTERS LLC,CHILD_SNACK_PM,19,125,27,194,346,1407,304,2182,3893,204.8947
SAN DIEGO,Nov 2013,CACF,2014,TUTOR TIME LEARNING CENTERS LLC,OSCH_CHILD_BREAKFAST,19,48,16,50,114,121,40,127,288,15.1579
SAN DIEGO,Nov 2013,CACF,2014,TUTOR TIME LEARNING CENTERS LLC,OSCH_CHILD_LUNCH,19,48,16,50,114,268,89,280,637,33.5263
SAN DIEGO,Nov 2013,CACF,2014,TUTOR TIME LEARNING CENTERS LLC,OSCH_CHILD_SNACK_PM,19,48,16,50,114,582,194,606,1382,72.7368
SAN DIEGO,Dec 2013,CACF,2014,TUTOR TIME LEARNING CENTERS LLC,CHILD_BREAKFAST,21,153,34,234,421,1362,303,2082,3747,178.4286
SAN DIEGO,Dec 2013,CACF,2014,TUTOR TIME LEARNING CENTERS LLC,CHILD_LUNCH,21,153,34,234,421,1849,411,2829,5089,242.3333
SAN DIEGO,Dec 2013,CACF,2014,TUTOR TIME LEARNING CENTERS LLC,CHILD_SNACK_PM,21,153,34,234,421,1688,375,2582,4645,221.1905
SAN DIEGO,Dec 2013,CACF,2014,TUTOR TIME LEARNING CENTERS LLC,OSCH_CHILD_BREAKFAST,21,61,21,88,170,134,46,193,373,17.7619
SAN DIEGO,Dec 2013,CACF,2014,TUTOR TIME LEARNING CENTERS LLC,OSCH_CHILD_LUNCH,21,61,21,88,170,238,82,342,662,31.5238
SAN DIEGO,Dec 2013,CACF,2014,TUTOR TIME LEARNING CENTERS LLC,OSCH_CHILD_SNACK_PM,21,61,21,88,170,681,234,983,1898,90.381
SAN DIEGO,Jan 2014,CACF,2014,TUTOR TIME LEARNING CENTERS LLC,CHILD_BREAKFAST,22,153,34,234,421,1645,366,2517,4528,205.8182
SAN DIEGO,Jan 2014,CACF,2014,TUTOR TIME LEARNING CENTERS LLC,CHILD_LUNCH,22,153,34,234,421,2160,480,3305,5945,270.2273
SAN DIEGO,Jan 2014,CACF,2014,TUTOR TIME LEARNING CENTERS LLC,CHILD_SNACK_PM,22,153,34,234,421,1942,432,2969,5343,242.8636
SAN DIEGO,Jan 2014,CACF,2014,TUTOR TIME LEARNING CENTERS LLC,OSCH_CHILD_BREAKFAST,22,61,21,88,170,168,58,241,467,21.2273
SAN DIEGO,Jan 2014,CACF,2014,TUTOR TIME LEARNING CENTERS LLC,OSCH_CHILD_LUNCH,22,61,21,88,170,284,98,410,792,36
SAN DIEGO,Jan 2014,CACF,2014,TUTOR TIME LEARNING CENTERS LLC,OSCH_CHILD_SNACK_PM,22,61,21,88,170,746,257,1076,2079,94.5
SAN DIEGO,Feb 2014,CACF,2014,TUTOR TIME LEARNING CENTERS LLC,CHILD_BREAKFAST,20,153,34,234,421,1564,348,2392,4304,215.2
SAN DIEGO,Feb 2014,CACF,2014,TUTOR TIME LEARNING CENTERS LLC,CHILD_LUNCH,20,153,34,234,421,2116,471,3237,5824,291.2
SAN DIEGO,Feb 2014,CACF,2014,TUTOR TIME LEARNING CENTERS LLC,CHILD_SNACK_PM,20,153,34,234,421,1940,431,2967,5338,266.9
SAN DIEGO,Feb 2014,CACF,2014,TUTOR TIME LEARNING CENTERS LLC,OSCH_CHILD_BREAKFAST,19,61,21,88,170,94,32,135,261,13.7368
SAN DIEGO,Feb 2014,CACF,2014,TUTOR TIME LEARNING CENTERS LLC,OSCH_CHILD_LUNCH,19,61,21,88,170,202,70,291,563,29.6316
SAN DIEGO,Feb 2014,CACF,2014,TUTOR TIME LEARNING CENTERS LLC,OSCH_CHILD_SNACK_PM,19,61,21,88,170,694,239,1001,1934,101.7895
SAN DIEGO,Mar 2014,CACF,2014,TUTOR TIME LEARNING CENTERS LLC,CHILD_BREAKFAST,21,153,34,234,421,1760,391,2693,4844,230.6667
SAN DIEGO,Mar 2014,CACF,2014,TUTOR TIME LEARNING CENTERS LLC,CHILD_LUNCH,21,153,34,234,421,2405,535,3677,6617,315.0952
SAN DIEGO,Mar 2014,CACF,2014,TUTOR TIME LEARNING CENTERS LLC,CHILD_SNACK_PM,21,153,34,234,421,2195,488,3357,6040,287.619
SAN DIEGO,Mar 2014,CACF,2014,TUTOR TIME LEARNING CENTERS LLC,OSCH_CHILD_BREAKFAST,21,61,21,88,170,202,70,291,563,26.8095
SAN DIEGO,Mar 2014,CACF,2014,TUTOR TIME LEARNING CENTERS LLC,OSCH_CHILD_LUNCH,21,61,21,88,170,336,116,484,936,44.5714
SAN DIEGO,Mar 2014,CACF,2014,TUTOR TIME LEARNING CENTERS LLC,OSCH_CHILD_SNACK_PM,21,61,21,88,170,780,268,1125,2173,103.4762
SAN DIEGO,Apr 2014,CACF,2014,TUTOR TIME LEARNING CENTERS LLC,CHILD_BREAKFAST,22,153,34,234,421,1906,424,2916,5246,238.4545
SAN DIEGO,Apr 2014,CACF,2014,TUTOR TIME LEARNING CENTERS LLC,CHILD_LUNCH,22,153,34,234,421,2579,573,3945,7097,322.5909
SAN DIEGO,Apr 2014,CACF,2014,TUTOR TIME LEARNING CENTERS LLC,CHILD_SNACK_PM,22,153,34,234,421,2330,518,3565,6413,291.5
SAN DIEGO,Apr 2014,CACF,2014,TUTOR TIME LEARNING CENTERS LLC,OSCH_CHILD_BREAKFAST,22,61,21,88,170,199,68,287,554,25.1818
SAN DIEGO,Apr 2014,CACF,2014,TUTOR TIME LEARNING CENTERS LLC,OSCH_CHILD_LUNCH,22,61,21,88,170,342,118,493,953,43.3182
SAN DIEGO,Apr 2014,CACF,2014,TUTOR TIME LEARNING CENTERS LLC,OSCH_CHILD_SNACK_PM,22,61,21,88,170,747,257,1078,2082,94.6364
SAN DIEGO,May 2014,CACF,2014,TUTOR TIME LEARNING CENTERS LLC,CHILD_BREAKFAST,21,153,34,234,421,1856,413,2839,5108,243.2381
SAN DIEGO,May 2014,CACF,2014,TUTOR TIME LEARNING CENTERS LLC,CHILD_LUNCH,21,153,34,234,421,2522,561,3856,6939,330.4286
SAN DIEGO,May 2014,CACF,2014,TUTOR TIME LEARNING CENTERS LLC,CHILD_SNACK_PM,21,153,34,234,421,2284,508,3492,6284,299.2381
SAN DIEGO,May 2014,CACF,2014,TUTOR TIME LEARNING CENTERS LLC,OSCH_CHILD_BREAKFAST,21,61,21,88,170,152,52,219,423,20.1429
SAN DIEGO,May 2014,CACF,2014,TUTOR TIME LEARNING CENTERS LLC,OSCH_CHILD_LUNCH,21,61,21,88,170,223,77,322,622,29.619
SAN DIEGO,May 2014,CACF,2014,TUTOR TIME LEARNING CENTERS LLC,OSCH_CHILD_SNACK_PM,21,61,21,88,170,758,261,1093,2112,100.5714
SAN DIEGO,Jun 2014,CACF,2014,TUTOR TIME LEARNING CENTERS LLC,CHILD_BREAKFAST,21,153,34,234,421,1748,389,2673,4810,229.0476
SAN DIEGO,Jun 2014,CACF,2014,TUTOR TIME LEARNING CENTERS LLC,CHILD_LUNCH,21,153,34,234,421,2358,524,3606,6488,308.9524
SAN DIEGO,Jun 2014,CACF,2014,TUTOR TIME LEARNING CENTERS LLC,CHILD_SNACK_PM,21,153,34,234,421,2153,479,3292,5924,282.0952
SAN DIEGO,Jun 2014,CACF,2014,TUTOR TIME LEARNING CENTERS LLC,OSCH_CHILD_BREAKFAST,21,61,21,88,170,235,81,338,654,31.1429
SAN DIEGO,Jun 2014,CACF,2014,TUTOR TIME LEARNING CENTERS LLC,OSCH_CHILD_LUNCH,21,61,21,88,170,517,178,747,1442,68.6667
SAN DIEGO,Jun 2014,CACF,2014,TUTOR TIME LEARNING CENTERS LLC,OSCH_CHILD_SNACK_PM,21,61,21,88,170,731,252,1055,2038,97.0476
SAN DIEGO,Jul 2014,CACF,2014,TUTOR TIME LEARNING CENTERS LLC,CHILD_BREAKFAST,22,153,34,234,421,1698,377,2597,4672,212.3636
SAN DIEGO,Jul 2014,CACF,2014,TUTOR TIME LEARNING CENTERS LLC,CHILD_LUNCH,22,153,34,234,421,2314,514,3539,6367,289.4091
SAN DIEGO,Jul 2014,CACF,2014,TUTOR TIME LEARNING CENTERS LLC,CHILD_SNACK_PM,22,153,34,234,421,2159,480,3302,5941,270.0455
SAN DIEGO,Jul 2014,CACF,2014,TUTOR TIME LEARNING CENTERS LLC,OSCH_CHILD_BREAKFAST,22,61,21,88,170,367,126,530,1023,46.5
SAN DIEGO,Jul 2014,CACF,2014,TUTOR TIME LEARNING CENTERS LLC,OSCH_CHILD_LUNCH,22,61,21,88,170,711,245,1026,1982,90.0909
SAN DIEGO,Jul 2014,CACF,2014,TUTOR TIME LEARNING CENTERS LLC,OSCH_CHILD_SNACK_PM,22,61,21,88,170,678,234,979,1891,85.9545
SAN DIEGO,Aug 2014,CACF,2014,TUTOR TIME LEARNING CENTERS LLC,CHILD_BREAKFAST,21,153,34,234,421,1588,353,2428,4369,208.0476
SAN DIEGO,Aug 2014,CACF,2014,TUTOR TIME LEARNING CENTERS LLC,CHILD_LUNCH,21,153,34,234,421,2119,471,3242,5832,277.7143
SAN DIEGO,Aug 2014,CACF,2014,TUTOR TIME LEARNING CENTERS LLC,CHILD_SNACK_PM,21,153,34,234,421,1951,434,2983,5368,255.619
SAN DIEGO,Aug 2014,CACF,2014,TUTOR TIME LEARNING CENTERS LLC,OSCH_CHILD_BREAKFAST,21,61,21,88,170,260,90,376,726,34.5714
SAN DIEGO,Aug 2014,CACF,2014,TUTOR TIME LEARNING CENTERS LLC,OSCH_CHILD_LUNCH,21,61,21,88,170,562,193,810,1565,74.5238
SAN DIEGO,Aug 2014,CACF,2014,TUTOR TIME LEARNING CENTERS LLC,OSCH_CHILD_SNACK_PM,21,61,21,88,170,711,245,1026,1982,94.381
SAN DIEGO,Sep 2014,CACF,2014,TUTOR TIME LEARNING CENTERS LLC,CHILD_BREAKFAST,21,153,34,234,421,1642,365,2511,4518,215.1429
SAN DIEGO,Sep 2014,CACF,2014,TUTOR TIME LEARNING CENTERS LLC,CHILD_LUNCH,21,153,34,234,421,2222,494,3398,6114,291.1429
SAN DIEGO,Sep 2014,CACF,2014,TUTOR TIME LEARNING CENTERS LLC,CHILD_SNACK_PM,21,153,34,234,421,2007,446,3070,5523,263
SAN DIEGO,Sep 2014,CACF,2014,TUTOR TIME LEARNING CENTERS LLC,OSCH_CHILD_BREAKFAST,21,61,21,88,170,231,79,333,643,30.619
SAN DIEGO,Sep 2014,CACF,2014,TUTOR TIME LEARNING CENTERS LLC,OSCH_CHILD_LUNCH,21,61,21,88,170,169,58,244,471,22.4286
SAN DIEGO,Sep 2014,CACF,2014,TUTOR TIME LEARNING CENTERS LLC,OSCH_CHILD_SNACK_PM,21,61,21,88,170,887,305,1279,2471,117.6667
SAN DIEGO,Oct 2013,CACF,2014,UNITED CHURCH/CHRIST LA MESA CHARLEY BROWNS CHILDREN CENTER,CHILD_BREAKFAST,23,7,4,72,83,79,45,813,937,40.7391
SAN DIEGO,Oct 2013,CACF,2014,UNITED CHURCH/CHRIST LA MESA CHARLEY BROWNS CHILDREN CENTER,CHILD_LUNCH,23,7,4,72,83,94,54,972,1120,48.6957
SAN DIEGO,Oct 2013,CACF,2014,UNITED CHURCH/CHRIST LA MESA CHARLEY BROWNS CHILDREN CENTER,CHILD_SNACK_PM,23,7,4,72,83,93,53,954,1100,47.8261
SAN DIEGO,Nov 2013,CACF,2014,UNITED CHURCH/CHRIST LA MESA CHARLEY BROWNS CHILDREN CENTER,CHILD_BREAKFAST,21,8,4,71,83,74,37,653,764,36.381
SAN DIEGO,Nov 2013,CACF,2014,UNITED CHURCH/CHRIST LA MESA CHARLEY BROWNS CHILDREN CENTER,CHILD_LUNCH,21,8,4,71,83,91,46,808,945,45
SAN DIEGO,Nov 2013,CACF,2014,UNITED CHURCH/CHRIST LA MESA CHARLEY BROWNS CHILDREN CENTER,CHILD_SNACK_PM,21,8,4,71,83,80,40,705,825,39.2857
SAN DIEGO,Dec 2013,CACF,2014,UNITED CHURCH/CHRIST LA MESA CHARLEY BROWNS CHILDREN CENTER,CHILD_BREAKFAST,19,8,4,71,83,68,34,605,707,37.2105
SAN DIEGO,Dec 2013,CACF,2014,UNITED CHURCH/CHRIST LA MESA CHARLEY BROWNS CHILDREN CENTER,CHILD_LUNCH,19,8,4,71,83,87,44,772,903,47.5263
SAN DIEGO,Dec 2013,CACF,2014,UNITED CHURCH/CHRIST LA MESA CHARLEY BROWNS CHILDREN CENTER,CHILD_SNACK_PM,19,8,4,71,83,76,38,674,788,41.4737
SAN DIEGO,Jan 2014,CACF,2014,UNITED CHURCH/CHRIST LA MESA CHARLEY BROWNS CHILDREN CENTER,CHILD_BREAKFAST,21,8,4,71,83,80,40,708,828,39.4286
SAN DIEGO,Jan 2014,CACF,2014,UNITED CHURCH/CHRIST LA MESA CHARLEY BROWNS CHILDREN CENTER,CHILD_LUNCH,21,8,4,71,83,106,53,940,1099,52.3333
SAN DIEGO,Jan 2014,CACF,2014,UNITED CHURCH/CHRIST LA MESA CHARLEY BROWNS CHILDREN CENTER,CHILD_SNACK_PM,21,8,4,71,83,97,49,864,1010,48.0952
SAN DIEGO,Feb 2014,CACF,2014,UNITED CHURCH/CHRIST LA MESA CHARLEY BROWNS CHILDREN CENTER,CHILD_BREAKFAST,19,8,4,71,83,82,41,727,850,44.7368
SAN DIEGO,Feb 2014,CACF,2014,UNITED CHURCH/CHRIST LA MESA CHARLEY BROWNS CHILDREN CENTER,CHILD_LUNCH,19,8,4,71,83,99,49,875,1023,53.8421
SAN DIEGO,Feb 2014,CACF,2014,UNITED CHURCH/CHRIST LA MESA CHARLEY BROWNS CHILDREN CENTER,CHILD_SNACK_PM,19,8,4,71,83,89,44,789,922,48.5263
SAN DIEGO,Mar 2014,CACF,2014,UNITED CHURCH/CHRIST LA MESA CHARLEY BROWNS CHILDREN CENTER,CHILD_BREAKFAST,21,8,4,71,83,90,45,794,929,44.2381
SAN DIEGO,Mar 2014,CACF,2014,UNITED CHURCH/CHRIST LA MESA CHARLEY BROWNS CHILDREN CENTER,CHILD_LUNCH,21,8,4,71,83,124,62,1098,1284,61.1429
SAN DIEGO,Mar 2014,CACF,2014,UNITED CHURCH/CHRIST LA MESA CHARLEY BROWNS CHILDREN CENTER,CHILD_SNACK_PM,21,8,4,71,83,109,54,967,1130,53.8095
SAN DIEGO,Apr 2014,CACF,2014,UNITED CHURCH/CHRIST LA MESA CHARLEY BROWNS CHILDREN CENTER,CHILD_BREAKFAST,21,8,4,71,83,90,45,794,929,44.2381
SAN DIEGO,Apr 2014,CACF,2014,UNITED CHURCH/CHRIST LA MESA CHARLEY BROWNS CHILDREN CENTER,CHILD_LUNCH,21,8,4,71,83,124,62,1098,1284,61.1429
SAN DIEGO,Apr 2014,CACF,2014,UNITED CHURCH/CHRIST LA MESA CHARLEY BROWNS CHILDREN CENTER,CHILD_SNACK_PM,21,8,4,71,83,109,54,967,1130,53.8095
SAN DIEGO,May 2014,CACF,2014,UNITED CHURCH/CHRIST LA MESA CHARLEY BROWNS CHILDREN CENTER,CHILD_BREAKFAST,21,8,4,71,83,91,46,807,944,44.9524
SAN DIEGO,May 2014,CACF,2014,UNITED CHURCH/CHRIST LA MESA CHARLEY BROWNS CHILDREN CENTER,CHILD_LUNCH,21,8,4,71,83,124,62,1097,1283,61.0952
SAN DIEGO,May 2014,CACF,2014,UNITED CHURCH/CHRIST LA MESA CHARLEY BROWNS CHILDREN CENTER,CHILD_SNACK_PM,21,8,4,71,83,109,54,967,1130,53.8095
SAN DIEGO,Jun 2014,CACF,2014,UNITED CHURCH/CHRIST LA MESA CHARLEY BROWNS CHILDREN CENTER,CHILD_BREAKFAST,20,8,4,71,83,88,44,777,909,45.45
SAN DIEGO,Jun 2014,CACF,2014,UNITED CHURCH/CHRIST LA MESA CHARLEY BROWNS CHILDREN CENTER,CHILD_LUNCH,20,8,4,71,83,114,57,1010,1181,59.05
SAN DIEGO,Jun 2014,CACF,2014,UNITED CHURCH/CHRIST LA MESA CHARLEY BROWNS CHILDREN CENTER,CHILD_SNACK_PM,20,8,4,71,83,100,50,886,1036,51.8
SAN DIEGO,Jul 2014,CACF,2014,UNITED CHURCH/CHRIST LA MESA CHARLEY BROWNS CHILDREN CENTER,CHILD_BREAKFAST,22,8,4,71,83,89,45,790,924,42
SAN DIEGO,Jul 2014,CACF,2014,UNITED CHURCH/CHRIST LA MESA CHARLEY BROWNS CHILDREN CENTER,CHILD_LUNCH,22,8,4,71,83,123,61,1090,1274,57.9091
SAN DIEGO,Jul 2014,CACF,2014,UNITED CHURCH/CHRIST LA MESA CHARLEY BROWNS CHILDREN CENTER,CHILD_SNACK_PM,22,8,4,71,83,106,53,938,1097,49.8636
SAN DIEGO,Aug 2014,CACF,2014,UNITED CHURCH/CHRIST LA MESA CHARLEY BROWNS CHILDREN CENTER,CHILD_BREAKFAST,21,8,4,71,83,84,42,744,870,41.4286
SAN DIEGO,Aug 2014,CACF,2014,UNITED CHURCH/CHRIST LA MESA CHARLEY BROWNS CHILDREN CENTER,CHILD_LUNCH,21,8,4,71,83,104,52,925,1081,51.4762
SAN DIEGO,Aug 2014,CACF,2014,UNITED CHURCH/CHRIST LA MESA CHARLEY BROWNS CHILDREN CENTER,CHILD_SNACK_PM,21,8,4,71,83,88,44,782,914,43.5238
SAN DIEGO,Sep 2014,CACF,2014,UNITED CHURCH/CHRIST LA MESA CHARLEY BROWNS CHILDREN CENTER,CHILD_BREAKFAST,21,8,4,71,83,98,49,874,1021,48.619
SAN DIEGO,Sep 2014,CACF,2014,UNITED CHURCH/CHRIST LA MESA CHARLEY BROWNS CHILDREN CENTER,CHILD_LUNCH,21,8,4,71,83,114,57,1009,1180,56.1905
SAN DIEGO,Sep 2014,CACF,2014,UNITED CHURCH/CHRIST LA MESA CHARLEY BROWNS CHILDREN CENTER,CHILD_SNACK_PM,21,8,4,71,83,100,50,888,1038,49.4286
SAN DIEGO,Oct 2013,CACF,2014,"University of California, San Diego",CHILD_BREAKFAST,23,24,11,147,182,264,121,1614,1999,86.913
SAN DIEGO,Oct 2013,CACF,2014,"University of California, San Diego",CHILD_LUNCH,23,24,11,147,182,503,230,3082,3815,165.8696
SAN DIEGO,Oct 2013,CACF,2014,"University of California, San Diego",CHILD_SNACK_PM,23,24,11,147,182,482,221,2951,3654,158.8696
SAN DIEGO,Nov 2013,CACF,2014,"University of California, San Diego",CHILD_BREAKFAST,17,24,11,147,182,200,92,1225,1517,89.2353
SAN DIEGO,Nov 2013,CACF,2014,"University of California, San Diego",CHILD_LUNCH,17,24,11,147,182,368,168,2251,2787,163.9412
SAN DIEGO,Nov 2013,CACF,2014,"University of California, San Diego",CHILD_SNACK_PM,17,24,11,147,182,350,160,2143,2653,156.0588
SAN DIEGO,Dec 2013,CACF,2014,"University of California, San Diego",CHILD_BREAKFAST,15,24,11,147,182,168,77,1029,1274,84.9333
SAN DIEGO,Dec 2013,CACF,2014,"University of California, San Diego",CHILD_LUNCH,15,24,11,147,182,308,141,1885,2334,155.6
SAN DIEGO,Dec 2013,CACF,2014,"University of California, San Diego",CHILD_SNACK_PM,15,24,11,147,182,294,135,1798,2227,148.4667
SAN DIEGO,Jan 2014,CACF,2014,"University of California, San Diego",CHILD_BREAKFAST,19,24,11,147,182,220,101,1346,1667,87.7368
SAN DIEGO,Jan 2014,CACF,2014,"University of California, San Diego",CHILD_LUNCH,19,24,11,147,182,412,189,2523,3124,164.4211
SAN DIEGO,Jan 2014,CACF,2014,"University of California, San Diego",CHILD_SNACK_PM,19,24,11,147,182,395,181,2415,2991,157.4211
SAN DIEGO,Feb 2014,CACF,2014,"University of California, San Diego",CHILD_BREAKFAST,19,24,11,147,182,218,100,1331,1649,86.7895
SAN DIEGO,Feb 2014,CACF,2014,"University of California, San Diego",CHILD_LUNCH,19,24,11,147,182,407,186,2491,3084,162.3158
SAN DIEGO,Feb 2014,CACF,2014,"University of California, San Diego",CHILD_SNACK_PM,19,24,11,147,182,391,179,2394,2964,156
SAN DIEGO,Mar 2014,CACF,2014,"University of California, San Diego",CHILD_BREAKFAST,19,24,11,147,182,209,96,1283,1588,83.5789
SAN DIEGO,Mar 2014,CACF,2014,"University of California, San Diego",CHILD_LUNCH,19,24,11,147,182,421,193,2576,3190,167.8947
SAN DIEGO,Mar 2014,CACF,2014,"University of California, San Diego",CHILD_SNACK_PM,19,24,11,147,182,408,187,2501,3096,162.9474
SAN DIEGO,Apr 2014,CACF,2014,"University of California, San Diego",CHILD_BREAKFAST,22,24,11,147,182,260,119,1591,1970,89.5455
SAN DIEGO,Apr 2014,CACF,2014,"University of California, San Diego",CHILD_LUNCH,22,24,11,147,182,498,228,3050,3776,171.6364
SAN DIEGO,Apr 2014,CACF,2014,"University of California, San Diego",CHILD_SNACK_PM,22,24,11,147,182,480,220,2938,3638,165.3636
SAN DIEGO,May 2014,CACF,2014,"University of California, San Diego",CHILD_BREAKFAST,21,24,11,147,182,270,124,1653,2047,97.4762
SAN DIEGO,May 2014,CACF,2014,"University of California, San Diego",CHILD_LUNCH,21,24,11,147,182,499,228,3055,3782,180.0952
SAN DIEGO,May 2014,CACF,2014,"University of California, San Diego",CHILD_SNACK_PM,21,24,11,147,182,477,218,2920,3615,172.1429
SAN DIEGO,Jun 2014,CACF,2014,"University of California, San Diego",CHILD_BREAKFAST,21,24,11,147,182,228,104,1395,1727,82.2381
SAN DIEGO,Jun 2014,CACF,2014,"University of California, San Diego",CHILD_LUNCH,21,24,11,147,182,443,203,2709,3355,159.7619
SAN DIEGO,Jun 2014,CACF,2014,"University of California, San Diego",CHILD_SNACK_PM,21,24,11,147,182,423,194,2590,3207,152.7143
SAN DIEGO,Jul 2014,CACF,2014,"University of California, San Diego",CHILD_BREAKFAST,22,24,11,147,182,212,97,1295,1604,72.9091
SAN DIEGO,Jul 2014,CACF,2014,"University of California, San Diego",CHILD_LUNCH,22,24,11,147,182,402,184,2464,3050,138.6364
SAN DIEGO,Jul 2014,CACF,2014,"University of California, San Diego",CHILD_SNACK_PM,22,24,11,147,182,390,178,2385,2953,134.2273
SAN DIEGO,Aug 2014,CACF,2014,"University of California, San Diego",CHILD_BREAKFAST,21,24,11,147,182,197,90,1204,1491,71
SAN DIEGO,Aug 2014,CACF,2014,"University of California, San Diego",CHILD_LUNCH,21,24,11,147,182,369,169,2262,2800,133.3333
SAN DIEGO,Aug 2014,CACF,2014,"University of California, San Diego",CHILD_SNACK_PM,21,24,11,147,182,355,163,2174,2692,128.1905
SAN DIEGO,Sep 2014,CACF,2014,"University of California, San Diego",CHILD_BREAKFAST,21,24,11,147,182,217,99,1328,1644,78.2857
SAN DIEGO,Sep 2014,CACF,2014,"University of California, San Diego",CHILD_LUNCH,21,24,11,147,182,370,170,2267,2807,133.6667
SAN DIEGO,Sep 2014,CACF,2014,"University of California, San Diego",CHILD_SNACK_PM,21,24,11,147,182,358,164,2190,2712,129.1429
SAN DIEGO,Oct 2013,CACF,2014,VISIONS OF GOD CHRISTIAN FELLOWSHIP,CHILD_BREAKFAST,23,24,4,13,41,276,46,149,471,20.4783
SAN DIEGO,Oct 2013,CACF,2014,VISIONS OF GOD CHRISTIAN FELLOWSHIP,CHILD_LUNCH,23,24,4,13,41,417,69,226,712,30.9565
SAN DIEGO,Oct 2013,CACF,2014,VISIONS OF GOD CHRISTIAN FELLOWSHIP,CHILD_SNACK_PM,23,24,4,13,41,391,65,212,668,29.0435
SAN DIEGO,Nov 2013,CACF,2014,VISIONS OF GOD CHRISTIAN FELLOWSHIP,CHILD_BREAKFAST,18,24,4,13,41,204,34,110,348,19.3333
SAN DIEGO,Nov 2013,CACF,2014,VISIONS OF GOD CHRISTIAN FELLOWSHIP,CHILD_LUNCH,18,24,4,13,41,359,60,194,613,34.0556
SAN DIEGO,Nov 2013,CACF,2014,VISIONS OF GOD CHRISTIAN FELLOWSHIP,CHILD_SNACK_PM,18,24,4,13,41,308,51,167,526,29.2222
SAN DIEGO,Dec 2013,CACF,2014,VISIONS OF GOD CHRISTIAN FELLOWSHIP,CHILD_BREAKFAST,17,24,4,13,41,238,40,128,406,23.8824
SAN DIEGO,Dec 2013,CACF,2014,VISIONS OF GOD CHRISTIAN FELLOWSHIP,CHILD_LUNCH,17,24,4,13,41,332,55,180,567,33.3529
SAN DIEGO,Dec 2013,CACF,2014,VISIONS OF GOD CHRISTIAN FELLOWSHIP,CHILD_SNACK_PM,17,24,4,13,41,319,53,173,545,32.0588
SAN DIEGO,Jan 2014,CACF,2014,VISIONS OF GOD CHRISTIAN FELLOWSHIP,CHILD_BREAKFAST,20,24,4,13,41,322,54,174,550,27.5
SAN DIEGO,Jan 2014,CACF,2014,VISIONS OF GOD CHRISTIAN FELLOWSHIP,CHILD_LUNCH,20,24,4,13,41,419,70,227,716,35.8
SAN DIEGO,Jan 2014,CACF,2014,VISIONS OF GOD CHRISTIAN FELLOWSHIP,CHILD_SNACK_PM,20,24,4,13,41,399,66,216,681,34.05
SAN DIEGO,Feb 2014,CACF,2014,VISIONS OF GOD CHRISTIAN FELLOWSHIP,CHILD_BREAKFAST,19,24,4,13,41,318,53,173,544,28.6316
SAN DIEGO,Feb 2014,CACF,2014,VISIONS OF GOD CHRISTIAN FELLOWSHIP,CHILD_LUNCH,19,24,4,13,41,421,70,228,719,37.8421
SAN DIEGO,Feb 2014,CACF,2014,VISIONS OF GOD CHRISTIAN FELLOWSHIP,CHILD_SNACK_PM,19,24,4,13,41,399,66,216,681,35.8421
SAN DIEGO,Mar 2014,CACF,2014,VISIONS OF GOD CHRISTIAN FELLOWSHIP,CHILD_BREAKFAST,21,24,4,13,41,347,58,188,593,28.2381
SAN DIEGO,Mar 2014,CACF,2014,VISIONS OF GOD CHRISTIAN FELLOWSHIP,CHILD_LUNCH,21,24,4,13,41,480,80,260,820,39.0476
SAN DIEGO,Mar 2014,CACF,2014,VISIONS OF GOD CHRISTIAN FELLOWSHIP,CHILD_SNACK_PM,21,24,4,13,41,445,74,242,761,36.2381
SAN DIEGO,Apr 2014,CACF,2014,VISIONS OF GOD CHRISTIAN FELLOWSHIP,CHILD_BREAKFAST,21,24,4,13,41,349,58,189,596,28.381
SAN DIEGO,Apr 2014,CACF,2014,VISIONS OF GOD CHRISTIAN FELLOWSHIP,CHILD_LUNCH,21,24,4,13,41,472,79,256,807,38.4286
SAN DIEGO,Apr 2014,CACF,2014,VISIONS OF GOD CHRISTIAN FELLOWSHIP,CHILD_SNACK_PM,21,24,4,13,41,460,77,248,785,37.381
SAN DIEGO,May 2014,CACF,2014,VISIONS OF GOD CHRISTIAN FELLOWSHIP,CHILD_BREAKFAST,21,24,4,13,41,349,58,189,596,28.381
SAN DIEGO,May 2014,CACF,2014,VISIONS OF GOD CHRISTIAN FELLOWSHIP,CHILD_LUNCH,21,24,4,13,41,462,77,251,790,37.619
SAN DIEGO,May 2014,CACF,2014,VISIONS OF GOD CHRISTIAN FELLOWSHIP,CHILD_SNACK_PM,21,24,4,13,41,426,71,231,728,34.6667
SAN DIEGO,Jun 2014,CACF,2014,VISIONS OF GOD CHRISTIAN FELLOWSHIP,CHILD_BREAKFAST,21,24,4,13,41,356,59,193,608,28.9524
SAN DIEGO,Jun 2014,CACF,2014,VISIONS OF GOD CHRISTIAN FELLOWSHIP,CHILD_LUNCH,21,24,4,13,41,503,84,272,859,40.9048
SAN DIEGO,Jun 2014,CACF,2014,VISIONS OF GOD CHRISTIAN FELLOWSHIP,CHILD_SNACK_PM,21,24,4,13,41,482,80,262,824,39.2381
SAN DIEGO,Jul 2014,CACF,2014,VISIONS OF GOD CHRISTIAN FELLOWSHIP,CHILD_BREAKFAST,22,24,4,13,41,383,64,208,655,29.7727
SAN DIEGO,Jul 2014,CACF,2014,VISIONS OF GOD CHRISTIAN FELLOWSHIP,CHILD_LUNCH,22,24,4,13,41,511,85,277,873,39.6818
SAN DIEGO,Jul 2014,CACF,2014,VISIONS OF GOD CHRISTIAN FELLOWSHIP,CHILD_SNACK_PM,22,24,4,13,41,484,81,262,827,37.5909
SAN DIEGO,Aug 2014,CACF,2014,VISIONS OF GOD CHRISTIAN FELLOWSHIP,CHILD_BREAKFAST,20,24,4,13,41,316,53,171,540,27
SAN DIEGO,Aug 2014,CACF,2014,VISIONS OF GOD CHRISTIAN FELLOWSHIP,CHILD_LUNCH,20,24,4,13,41,419,70,226,715,35.75
SAN DIEGO,Aug 2014,CACF,2014,VISIONS OF GOD CHRISTIAN FELLOWSHIP,CHILD_SNACK_PM,20,24,4,13,41,406,68,219,693,34.65
SAN DIEGO,Sep 2014,CACF,2014,VISIONS OF GOD CHRISTIAN FELLOWSHIP,CHILD_BREAKFAST,21,24,4,13,41,344,57,187,588,28
SAN DIEGO,Sep 2014,CACF,2014,VISIONS OF GOD CHRISTIAN FELLOWSHIP,CHILD_LUNCH,21,24,4,13,41,438,73,237,748,35.619
SAN DIEGO,Sep 2014,CACF,2014,VISIONS OF GOD CHRISTIAN FELLOWSHIP,CHILD_SNACK_PM,21,24,4,13,41,392,65,212,669,31.8571
SAN DIEGO,Oct 2013,CACF,2014,VISTA UNIFIED SCHOOL DISTRICT,ATRISK_CHILD_SNACK,23,622,0,0,622,2472,0,0,2472,107.4783
SAN DIEGO,Oct 2013,CACF,2014,VISTA UNIFIED SCHOOL DISTRICT,ATRISK_CHILD_SUPPER,23,622,0,0,622,3160,0,0,3160,137.3913
SAN DIEGO,Nov 2013,CACF,2014,VISTA UNIFIED SCHOOL DISTRICT,ATRISK_CHILD_SNACK,19,625,0,0,625,1778,0,0,1778,93.5789
SAN DIEGO,Nov 2013,CACF,2014,VISTA UNIFIED SCHOOL DISTRICT,ATRISK_CHILD_SUPPER,19,625,0,0,625,1962,0,0,1962,103.2632
SAN DIEGO,Dec 2013,CACF,2014,VISTA UNIFIED SCHOOL DISTRICT,ATRISK_CHILD_SNACK,20,618,0,0,618,1748,0,0,1748,87.4
SAN DIEGO,Dec 2013,CACF,2014,VISTA UNIFIED SCHOOL DISTRICT,ATRISK_CHILD_SUPPER,20,618,0,0,618,1949,0,0,1949,97.45
SAN DIEGO,Jan 2014,CACF,2014,VISTA UNIFIED SCHOOL DISTRICT,ATRISK_CHILD_SNACK,20,2580,0,0,2580,1957,0,0,1957,97.85
SAN DIEGO,Jan 2014,CACF,2014,VISTA UNIFIED SCHOOL DISTRICT,ATRISK_CHILD_SUPPER,20,2580,0,0,2580,2372,0,0,2372,118.6
SAN DIEGO,Feb 2014,CACF,2014,VISTA UNIFIED SCHOOL DISTRICT,ATRISK_CHILD_SNACK,19,5183,0,0,5183,1918,0,0,1918,100.9474
SAN DIEGO,Feb 2014,CACF,2014,VISTA UNIFIED SCHOOL DISTRICT,ATRISK_CHILD_SUPPER,19,5183,0,0,5183,7261,0,0,7261,382.1579
SAN DIEGO,Mar 2014,CACF,2014,VISTA UNIFIED SCHOOL DISTRICT,ATRISK_CHILD_SNACK,21,9401,0,0,9401,1803,0,0,1803,85.8571
SAN DIEGO,Mar 2014,CACF,2014,VISTA UNIFIED SCHOOL DISTRICT,ATRISK_CHILD_SUPPER,21,9401,0,0,9401,24389,0,0,24389,1161.381
SAN DIEGO,Apr 2014,CACF,2014,VISTA UNIFIED SCHOOL DISTRICT,ATRISK_CHILD_SNACK,22,7530,0,0,7530,2256,0,0,2256,102.5455
SAN DIEGO,Apr 2014,CACF,2014,VISTA UNIFIED SCHOOL DISTRICT,ATRISK_CHILD_SUPPER,22,7530,0,0,7530,35817,0,0,35817,1628.0455
SAN DIEGO,May 2014,CACF,2014,VISTA UNIFIED SCHOOL DISTRICT,ATRISK_CHILD_SNACK,19,7505,0,0,7505,1919,0,0,1919,101
SAN DIEGO,May 2014,CACF,2014,VISTA UNIFIED SCHOOL DISTRICT,ATRISK_CHILD_SUPPER,19,7505,0,0,7505,29959,0,0,29959,1576.7895
SAN DIEGO,Jun 2014,CACF,2014,VISTA UNIFIED SCHOOL DISTRICT,ATRISK_CHILD_SNACK,5,7476,0,0,7476,495,0,0,495,99
SAN DIEGO,Jun 2014,CACF,2014,VISTA UNIFIED SCHOOL DISTRICT,ATRISK_CHILD_SUPPER,5,7476,0,0,7476,5346,0,0,5346,1069.2
SAN DIEGO,Aug 2014,CACF,2014,VISTA UNIFIED SCHOOL DISTRICT,ATRISK_CHILD_SUPPER,10,9419,0,0,9419,17963,0,0,17963,1796.3
SAN DIEGO,Sep 2014,CACF,2014,VISTA UNIFIED SCHOOL DISTRICT,ATRISK_CHILD_SUPPER,21,9958,0,0,9958,40259,0,0,40259,1917.0952
SAN DIEGO,Oct 2013,CACF,2014,VOLUNTEERS OF AMERICA SOUTHWEST CA CORP,CHILD_BREAKFAST,23,150,25,6,181,2020,337,80,2437,105.9565
SAN DIEGO,Oct 2013,CACF,2014,VOLUNTEERS OF AMERICA SOUTHWEST CA CORP,CHILD_LUNCH,23,150,25,6,181,1503,251,60,1814,78.8696
SAN DIEGO,Oct 2013,CACF,2014,VOLUNTEERS OF AMERICA SOUTHWEST CA CORP,CHILD_SNACK_PM,23,150,25,6,181,1861,310,75,2246,97.6522
SAN DIEGO,Oct 2013,CACF,2014,VOLUNTEERS OF AMERICA SOUTHWEST CA CORP,HS_CHILD_BREAKFAST,23,254,0,0,254,812,0,0,812,35.3043
SAN DIEGO,Oct 2013,CACF,2014,VOLUNTEERS OF AMERICA SOUTHWEST CA CORP,HS_CHILD_LUNCH,23,254,0,0,254,1004,0,0,1004,43.6522
SAN DIEGO,Oct 2013,CACF,2014,VOLUNTEERS OF AMERICA SOUTHWEST CA CORP,HS_CHILD_SNACK_PM,23,254,0,0,254,752,0,0,752,32.6957
SAN DIEGO,Nov 2013,CACF,2014,VOLUNTEERS OF AMERICA SOUTHWEST CA CORP,CHILD_BREAKFAST,19,150,25,6,181,1366,228,54,1648,86.7368
SAN DIEGO,Nov 2013,CACF,2014,VOLUNTEERS OF AMERICA SOUTHWEST CA CORP,CHILD_LUNCH,19,150,25,6,181,1415,236,57,1708,89.8947
SAN DIEGO,Nov 2013,CACF,2014,VOLUNTEERS OF AMERICA SOUTHWEST CA CORP,CHILD_SNACK_PM,19,150,25,6,181,1295,216,52,1563,82.2632
SAN DIEGO,Nov 2013,CACF,2014,VOLUNTEERS OF AMERICA SOUTHWEST CA CORP,HS_CHILD_BREAKFAST,19,253,0,0,253,621,0,0,621,32.6842
SAN DIEGO,Nov 2013,CACF,2014,VOLUNTEERS OF AMERICA SOUTHWEST CA CORP,HS_CHILD_LUNCH,19,253,0,0,253,810,0,0,810,42.6316
SAN DIEGO,Nov 2013,CACF,2014,VOLUNTEERS OF AMERICA SOUTHWEST CA CORP,HS_CHILD_SNACK_PM,19,253,0,0,253,542,0,0,542,28.5263
SAN DIEGO,Dec 2013,CACF,2014,VOLUNTEERS OF AMERICA SOUTHWEST CA CORP,CHILD_BREAKFAST,16,150,26,5,181,1338,232,44,1614,100.875
SAN DIEGO,Dec 2013,CACF,2014,VOLUNTEERS OF AMERICA SOUTHWEST CA CORP,CHILD_LUNCH,16,150,26,5,181,1193,207,40,1440,90
SAN DIEGO,Dec 2013,CACF,2014,VOLUNTEERS OF AMERICA SOUTHWEST CA CORP,CHILD_SNACK_PM,16,150,26,5,181,1232,214,41,1487,92.9375
SAN DIEGO,Dec 2013,CACF,2014,VOLUNTEERS OF AMERICA SOUTHWEST CA CORP,HS_CHILD_BREAKFAST,16,254,0,0,254,561,0,0,561,35.0625
SAN DIEGO,Dec 2013,CACF,2014,VOLUNTEERS OF AMERICA SOUTHWEST CA CORP,HS_CHILD_LUNCH,16,254,0,0,254,706,0,0,706,44.125
SAN DIEGO,Dec 2013,CACF,2014,VOLUNTEERS OF AMERICA SOUTHWEST CA CORP,HS_CHILD_SNACK_PM,16,254,0,0,254,482,0,0,482,30.125
SAN DIEGO,Jan 2014,CACF,2014,VOLUNTEERS OF AMERICA SOUTHWEST CA CORP,CHILD_BREAKFAST,21,150,26,5,181,1622,281,54,1957,93.1905
SAN DIEGO,Jan 2014,CACF,2014,VOLUNTEERS OF AMERICA SOUTHWEST CA CORP,CHILD_LUNCH,21,150,26,5,181,1514,262,51,1827,87
SAN DIEGO,Jan 2014,CACF,2014,VOLUNTEERS OF AMERICA SOUTHWEST CA CORP,CHILD_SNACK_PM,21,150,26,5,181,1550,269,52,1871,89.0952
SAN DIEGO,Jan 2014,CACF,2014,VOLUNTEERS OF AMERICA SOUTHWEST CA CORP,HS_CHILD_BREAKFAST,21,254,0,0,254,712,0,0,712,33.9048
SAN DIEGO,Jan 2014,CACF,2014,VOLUNTEERS OF AMERICA SOUTHWEST CA CORP,HS_CHILD_LUNCH,21,254,0,0,254,907,0,0,907,43.1905
SAN DIEGO,Jan 2014,CACF,2014,VOLUNTEERS OF AMERICA SOUTHWEST CA CORP,HS_CHILD_SNACK_PM,21,254,0,0,254,604,0,0,604,28.7619
SAN DIEGO,Feb 2014,CACF,2014,VOLUNTEERS OF AMERICA SOUTHWEST CA CORP,CHILD_BREAKFAST,19,150,26,5,181,1626,282,54,1962,103.2632
SAN DIEGO,Feb 2014,CACF,2014,VOLUNTEERS OF AMERICA SOUTHWEST CA CORP,CHILD_LUNCH,19,150,26,5,181,1530,265,51,1846,97.1579
SAN DIEGO,Feb 2014,CACF,2014,VOLUNTEERS OF AMERICA SOUTHWEST CA CORP,CHILD_SNACK_PM,19,150,26,5,181,1558,270,52,1880,98.9474
SAN DIEGO,Feb 2014,CACF,2014,VOLUNTEERS OF AMERICA SOUTHWEST CA CORP,HS_CHILD_BREAKFAST,19,254,0,0,254,670,0,0,670,35.2632
SAN DIEGO,Feb 2014,CACF,2014,VOLUNTEERS OF AMERICA SOUTHWEST CA CORP,HS_CHILD_LUNCH,19,254,0,0,254,838,0,0,838,44.1053
SAN DIEGO,Feb 2014,CACF,2014,VOLUNTEERS OF AMERICA SOUTHWEST CA CORP,HS_CHILD_SNACK_PM,19,254,0,0,254,559,0,0,559,29.4211
SAN DIEGO,Mar 2014,CACF,2014,VOLUNTEERS OF AMERICA SOUTHWEST CA CORP,CHILD_BREAKFAST,21,150,26,5,181,1684,292,56,2032,96.7619
SAN DIEGO,Mar 2014,CACF,2014,VOLUNTEERS OF AMERICA SOUTHWEST CA CORP,CHILD_LUNCH,21,150,26,5,181,1603,278,53,1934,92.0952
SAN DIEGO,Mar 2014,CACF,2014,VOLUNTEERS OF AMERICA SOUTHWEST CA CORP,CHILD_SNACK_PM,21,150,26,5,181,1652,286,56,1994,94.9524
SAN DIEGO,Mar 2014,CACF,2014,VOLUNTEERS OF AMERICA SOUTHWEST CA CORP,HS_CHILD_BREAKFAST,21,254,0,0,254,671,0,0,671,31.9524
SAN DIEGO,Mar 2014,CACF,2014,VOLUNTEERS OF AMERICA SOUTHWEST CA CORP,HS_CHILD_LUNCH,21,254,0,0,254,856,0,0,856,40.7619
SAN DIEGO,Mar 2014,CACF,2014,VOLUNTEERS OF AMERICA SOUTHWEST CA CORP,HS_CHILD_SNACK_PM,21,254,0,0,254,608,0,0,608,28.9524
SAN DIEGO,Apr 2014,CACF,2014,VOLUNTEERS OF AMERICA SOUTHWEST CA CORP,CHILD_BREAKFAST,22,150,26,5,181,1958,339,66,2363,107.4091
SAN DIEGO,Apr 2014,CACF,2014,VOLUNTEERS OF AMERICA SOUTHWEST CA CORP,CHILD_LUNCH,22,150,26,5,181,1763,305,59,2127,96.6818
SAN DIEGO,Apr 2014,CACF,2014,VOLUNTEERS OF AMERICA SOUTHWEST CA CORP,CHILD_SNACK_PM,22,150,26,5,181,1820,315,61,2196,99.8182
SAN DIEGO,Apr 2014,CACF,2014,VOLUNTEERS OF AMERICA SOUTHWEST CA CORP,HS_CHILD_BREAKFAST,22,244,0,0,244,795,0,0,795,36.1364
SAN DIEGO,Apr 2014,CACF,2014,VOLUNTEERS OF AMERICA SOUTHWEST CA CORP,HS_CHILD_LUNCH,22,244,0,0,244,996,0,0,996,45.2727
SAN DIEGO,Apr 2014,CACF,2014,VOLUNTEERS OF AMERICA SOUTHWEST CA CORP,HS_CHILD_SNACK_PM,22,244,0,0,244,686,0,0,686,31.1818
SAN DIEGO,May 2014,CACF,2014,VOLUNTEERS OF AMERICA SOUTHWEST CA CORP,CHILD_BREAKFAST,21,150,26,5,181,1826,316,62,2204,104.9524
SAN DIEGO,May 2014,CACF,2014,VOLUNTEERS OF AMERICA SOUTHWEST CA CORP,CHILD_LUNCH,21,150,26,5,181,1623,281,55,1959,93.2857
SAN DIEGO,May 2014,CACF,2014,VOLUNTEERS OF AMERICA SOUTHWEST CA CORP,CHILD_SNACK_PM,21,150,26,5,181,1703,295,57,2055,97.8571
SAN DIEGO,May 2014,CACF,2014,VOLUNTEERS OF AMERICA SOUTHWEST CA CORP,HS_CHILD_BREAKFAST,21,254,0,0,254,815,0,0,815,38.8095
SAN DIEGO,May 2014,CACF,2014,VOLUNTEERS OF AMERICA SOUTHWEST CA CORP,HS_CHILD_LUNCH,21,254,0,0,254,963,0,0,963,45.8571
SAN DIEGO,May 2014,CACF,2014,VOLUNTEERS OF AMERICA SOUTHWEST CA CORP,HS_CHILD_SNACK_PM,21,254,0,0,254,628,0,0,628,29.9048
SAN DIEGO,Jun 2014,CACF,2014,VOLUNTEERS OF AMERICA SOUTHWEST CA CORP,CHILD_BREAKFAST,21,150,26,5,181,1711,297,57,2065,98.3333
SAN DIEGO,Jun 2014,CACF,2014,VOLUNTEERS OF AMERICA SOUTHWEST CA CORP,CHILD_LUNCH,21,150,26,5,181,1419,246,47,1712,81.5238
SAN DIEGO,Jun 2014,CACF,2014,VOLUNTEERS OF AMERICA SOUTHWEST CA CORP,CHILD_SNACK_PM,21,150,26,5,181,1483,257,50,1790,85.2381
SAN DIEGO,Jun 2014,CACF,2014,VOLUNTEERS OF AMERICA SOUTHWEST CA CORP,HS_CHILD_BREAKFAST,21,254,0,0,254,735,0,0,735,35
SAN DIEGO,Jun 2014,CACF,2014,VOLUNTEERS OF AMERICA SOUTHWEST CA CORP,HS_CHILD_LUNCH,21,254,0,0,254,814,0,0,814,38.7619
SAN DIEGO,Jun 2014,CACF,2014,VOLUNTEERS OF AMERICA SOUTHWEST CA CORP,HS_CHILD_SNACK_PM,21,254,0,0,254,513,0,0,513,24.4286
SAN DIEGO,Jul 2014,CACF,2014,VOLUNTEERS OF AMERICA SOUTHWEST CA CORP,CHILD_BREAKFAST,19,150,26,5,181,1333,231,45,1609,84.6842
SAN DIEGO,Jul 2014,CACF,2014,VOLUNTEERS OF AMERICA SOUTHWEST CA CORP,CHILD_LUNCH,19,150,26,5,181,1318,228,44,1590,83.6842
SAN DIEGO,Jul 2014,CACF,2014,VOLUNTEERS OF AMERICA SOUTHWEST CA CORP,CHILD_SNACK_PM,19,150,26,5,181,1251,217,41,1509,79.4211
SAN DIEGO,Jul 2014,CACF,2014,VOLUNTEERS OF AMERICA SOUTHWEST CA CORP,HS_CHILD_BREAKFAST,19,254,0,0,254,685,0,0,685,36.0526
SAN DIEGO,Jul 2014,CACF,2014,VOLUNTEERS OF AMERICA SOUTHWEST CA CORP,HS_CHILD_LUNCH,19,254,0,0,254,801,0,0,801,42.1579
SAN DIEGO,Jul 2014,CACF,2014,VOLUNTEERS OF AMERICA SOUTHWEST CA CORP,HS_CHILD_SNACK_PM,19,254,0,0,254,501,0,0,501,26.3684
SAN DIEGO,Aug 2014,CACF,2014,VOLUNTEERS OF AMERICA SOUTHWEST CA CORP,CHILD_BREAKFAST,21,150,26,5,181,1443,250,48,1741,82.9048
SAN DIEGO,Aug 2014,CACF,2014,VOLUNTEERS OF AMERICA SOUTHWEST CA CORP,CHILD_LUNCH,21,150,26,5,181,1294,224,43,1561,74.3333
SAN DIEGO,Aug 2014,CACF,2014,VOLUNTEERS OF AMERICA SOUTHWEST CA CORP,CHILD_SNACK_PM,21,150,26,5,181,1274,221,42,1537,73.1905
SAN DIEGO,Aug 2014,CACF,2014,VOLUNTEERS OF AMERICA SOUTHWEST CA CORP,HS_CHILD_BREAKFAST,21,254,0,0,254,831,0,0,831,39.5714
SAN DIEGO,Aug 2014,CACF,2014,VOLUNTEERS OF AMERICA SOUTHWEST CA CORP,HS_CHILD_LUNCH,21,254,0,0,254,914,0,0,914,43.5238
SAN DIEGO,Aug 2014,CACF,2014,VOLUNTEERS OF AMERICA SOUTHWEST CA CORP,HS_CHILD_SNACK_PM,21,254,0,0,254,528,0,0,528,25.1429
SAN DIEGO,Sep 2014,CACF,2014,VOLUNTEERS OF AMERICA SOUTHWEST CA CORP,CHILD_BREAKFAST,21,150,26,5,181,1596,277,53,1926,91.7143
SAN DIEGO,Sep 2014,CACF,2014,VOLUNTEERS OF AMERICA SOUTHWEST CA CORP,CHILD_LUNCH,21,150,26,5,181,1434,248,48,1730,82.381
SAN DIEGO,Sep 2014,CACF,2014,VOLUNTEERS OF AMERICA SOUTHWEST CA CORP,CHILD_SNACK_PM,21,150,26,5,181,1396,242,47,1685,80.2381
SAN DIEGO,Sep 2014,CACF,2014,VOLUNTEERS OF AMERICA SOUTHWEST CA CORP,HS_CHILD_BREAKFAST,21,254,0,0,254,828,0,0,828,39.4286
SAN DIEGO,Sep 2014,CACF,2014,VOLUNTEERS OF AMERICA SOUTHWEST CA CORP,HS_CHILD_LUNCH,21,254,0,0,254,952,0,0,952,45.3333
SAN DIEGO,Sep 2014,CACF,2014,VOLUNTEERS OF AMERICA SOUTHWEST CA CORP,HS_CHILD_SNACK_PM,21,254,0,0,254,615,0,0,615,29.2857
SAN DIEGO,Oct 2013,CACF,2014,WESTERN CONSULTING & ANCILLARY SERVICES INC,ADULT_BREAKFAST,23,121,0,11,132,1546,0,140,1686,73.3043
SAN DIEGO,Oct 2013,CACF,2014,WESTERN CONSULTING & ANCILLARY SERVICES INC,ADULT_LUNCH,23,121,0,11,132,1558,0,142,1700,73.913
SAN DIEGO,Oct 2013,CACF,2014,WESTERN CONSULTING & ANCILLARY SERVICES INC,ADULT_SNACK_PM,23,121,0,11,132,154,0,14,168,7.3043
SAN DIEGO,Nov 2013,CACF,2014,WESTERN CONSULTING & ANCILLARY SERVICES INC,ADULT_BREAKFAST,20,121,0,11,132,1377,0,125,1502,75.1
SAN DIEGO,Nov 2013,CACF,2014,WESTERN CONSULTING & ANCILLARY SERVICES INC,ADULT_LUNCH,20,121,0,11,132,1374,0,125,1499,74.95
SAN DIEGO,Nov 2013,CACF,2014,WESTERN CONSULTING & ANCILLARY SERVICES INC,ADULT_SNACK_PM,20,121,0,11,132,124,0,11,135,6.75
SAN DIEGO,Dec 2013,CACF,2014,WESTERN CONSULTING & ANCILLARY SERVICES INC,ADULT_BREAKFAST,21,121,0,11,132,1460,0,133,1593,75.8571
SAN DIEGO,Dec 2013,CACF,2014,WESTERN CONSULTING & ANCILLARY SERVICES INC,ADULT_LUNCH,21,121,0,11,132,1463,0,133,1596,76
SAN DIEGO,Dec 2013,CACF,2014,WESTERN CONSULTING & ANCILLARY SERVICES INC,ADULT_SNACK_PM,21,121,0,11,132,151,0,14,165,7.8571
SAN DIEGO,Jan 2014,CACF,2014,WESTERN CONSULTING & ANCILLARY SERVICES INC,ADULT_BREAKFAST,22,121,0,11,132,1557,0,142,1699,77.2273
SAN DIEGO,Jan 2014,CACF,2014,WESTERN CONSULTING & ANCILLARY SERVICES INC,ADULT_LUNCH,22,121,0,11,132,1557,0,142,1699,77.2273
SAN DIEGO,Jan 2014,CACF,2014,WESTERN CONSULTING & ANCILLARY SERVICES INC,ADULT_SNACK_PM,22,121,0,11,132,179,0,16,195,8.8636
SAN DIEGO,Feb 2014,CACF,2014,WESTERN CONSULTING & ANCILLARY SERVICES INC,ADULT_BREAKFAST,20,121,0,11,132,1476,0,134,1610,80.5
SAN DIEGO,Feb 2014,CACF,2014,WESTERN CONSULTING & ANCILLARY SERVICES INC,ADULT_LUNCH,20,121,0,11,132,1483,0,135,1618,80.9
SAN DIEGO,Feb 2014,CACF,2014,WESTERN CONSULTING & ANCILLARY SERVICES INC,ADULT_SNACK_PM,20,121,0,11,132,199,0,18,217,10.85
SAN DIEGO,Mar 2014,CACF,2014,WESTERN CONSULTING & ANCILLARY SERVICES INC,ADULT_BREAKFAST,21,121,0,11,132,1502,0,136,1638,78
SAN DIEGO,Mar 2014,CACF,2014,WESTERN CONSULTING & ANCILLARY SERVICES INC,ADULT_LUNCH,21,121,0,11,132,1502,0,136,1638,78
SAN DIEGO,Mar 2014,CACF,2014,WESTERN CONSULTING & ANCILLARY SERVICES INC,ADULT_SNACK_PM,21,121,0,11,132,227,0,21,248,11.8095
SAN DIEGO,Apr 2014,CACF,2014,WESTERN CONSULTING & ANCILLARY SERVICES INC,ADULT_BREAKFAST,22,121,0,11,132,1578,0,143,1721,78.2273
SAN DIEGO,Apr 2014,CACF,2014,WESTERN CONSULTING & ANCILLARY SERVICES INC,ADULT_LUNCH,22,121,0,11,132,1578,0,143,1721,78.2273
SAN DIEGO,Apr 2014,CACF,2014,WESTERN CONSULTING & ANCILLARY SERVICES INC,ADULT_SNACK_PM,22,121,0,11,132,204,0,19,223,10.1364
SAN DIEGO,May 2014,CACF,2014,WESTERN CONSULTING & ANCILLARY SERVICES INC,ADULT_BREAKFAST,21,121,0,11,132,1630,0,148,1778,84.6667
SAN DIEGO,May 2014,CACF,2014,WESTERN CONSULTING & ANCILLARY SERVICES INC,ADULT_LUNCH,21,121,0,11,132,1630,0,148,1778,84.6667
SAN DIEGO,May 2014,CACF,2014,WESTERN CONSULTING & ANCILLARY SERVICES INC,ADULT_SNACK_PM,21,121,0,11,132,236,0,21,257,12.2381
SAN DIEGO,Jun 2014,CACF,2014,WESTERN CONSULTING & ANCILLARY SERVICES INC,ADULT_BREAKFAST,21,121,0,11,132,1579,0,144,1723,82.0476
SAN DIEGO,Jun 2014,CACF,2014,WESTERN CONSULTING & ANCILLARY SERVICES INC,ADULT_LUNCH,21,121,0,11,132,1579,0,144,1723,82.0476
SAN DIEGO,Jun 2014,CACF,2014,WESTERN CONSULTING & ANCILLARY SERVICES INC,ADULT_SNACK_PM,21,121,0,11,132,223,0,20,243,11.5714
SAN DIEGO,Jul 2014,CACF,2014,WESTERN CONSULTING & ANCILLARY SERVICES INC,ADULT_BREAKFAST,22,121,0,11,132,1711,0,155,1866,84.8182
SAN DIEGO,Jul 2014,CACF,2014,WESTERN CONSULTING & ANCILLARY SERVICES INC,ADULT_LUNCH,22,121,0,11,132,1711,0,156,1867,84.8636
SAN DIEGO,Jul 2014,CACF,2014,WESTERN CONSULTING & ANCILLARY SERVICES INC,ADULT_SNACK_PM,22,121,0,11,132,173,0,16,189,8.5909
SAN DIEGO,Aug 2014,CACF,2014,WESTERN CONSULTING & ANCILLARY SERVICES INC,ADULT_BREAKFAST,21,121,0,11,132,1568,0,142,1710,81.4286
SAN DIEGO,Aug 2014,CACF,2014,WESTERN CONSULTING & ANCILLARY SERVICES INC,ADULT_LUNCH,21,121,0,11,132,1568,0,142,1710,81.4286
SAN DIEGO,Aug 2014,CACF,2014,WESTERN CONSULTING & ANCILLARY SERVICES INC,ADULT_SNACK_PM,21,121,0,11,132,189,0,17,206,9.8095
SAN DIEGO,Sep 2014,CACF,2014,WESTERN CONSULTING & ANCILLARY SERVICES INC,ADULT_BREAKFAST,21,121,0,11,132,1699,0,154,1853,88.2381
SAN DIEGO,Sep 2014,CACF,2014,WESTERN CONSULTING & ANCILLARY SERVICES INC,ADULT_LUNCH,21,121,0,11,132,1699,0,154,1853,88.2381
SAN DIEGO,Sep 2014,CACF,2014,WESTERN CONSULTING & ANCILLARY SERVICES INC,ADULT_SNACK_PM,21,121,0,11,132,209,0,19,228,10.8571
SAN DIEGO,Oct 2013,CACF,2014,YMCA OF SAN DIEGO COUNTY,CHILD_BREAKFAST,23,43,20,58,121,602,280,811,1693,73.6087
SAN DIEGO,Oct 2013,CACF,2014,YMCA OF SAN DIEGO COUNTY,CHILD_LUNCH,23,43,20,58,121,517,241,697,1455,63.2609
SAN DIEGO,Oct 2013,CACF,2014,YMCA OF SAN DIEGO COUNTY,CHILD_SNACK_AM,23,43,20,58,121,131,61,178,370,16.087
SAN DIEGO,Oct 2013,CACF,2014,YMCA OF SAN DIEGO COUNTY,CHILD_SNACK_PM,23,43,20,58,121,682,317,920,1919,83.4348
SAN DIEGO,Oct 2013,CACF,2014,YMCA OF SAN DIEGO COUNTY,OSCH_CHILD_BREAKFAST,23,128,28,206,362,101,22,163,286,12.4348
SAN DIEGO,Oct 2013,CACF,2014,YMCA OF SAN DIEGO COUNTY,OSCH_CHILD_LUNCH,23,128,28,206,362,31,7,51,89,3.8696
SAN DIEGO,Oct 2013,CACF,2014,YMCA OF SAN DIEGO COUNTY,OSCH_CHILD_SNACK_AM,23,128,28,206,362,41,9,66,116,5.0435
SAN DIEGO,Oct 2013,CACF,2014,YMCA OF SAN DIEGO COUNTY,OSCH_CHILD_SNACK_PM,23,128,28,206,362,1580,345,2543,4468,194.2609
SAN DIEGO,Nov 2013,CACF,2014,YMCA OF SAN DIEGO COUNTY,CHILD_BREAKFAST,16,43,20,58,121,486,226,655,1367,85.4375
SAN DIEGO,Nov 2013,CACF,2014,YMCA OF SAN DIEGO COUNTY,CHILD_LUNCH,16,43,20,58,121,399,185,538,1122,70.125
SAN DIEGO,Nov 2013,CACF,2014,YMCA OF SAN DIEGO COUNTY,CHILD_SNACK_AM,16,43,20,58,121,87,40,117,244,15.25
SAN DIEGO,Nov 2013,CACF,2014,YMCA OF SAN DIEGO COUNTY,CHILD_SNACK_PM,16,43,20,58,121,504,235,680,1419,88.6875
SAN DIEGO,Nov 2013,CACF,2014,YMCA OF SAN DIEGO COUNTY,OSCH_CHILD_BREAKFAST,19,128,28,206,362,169,37,273,479,25.2105
SAN DIEGO,Nov 2013,CACF,2014,YMCA OF SAN DIEGO COUNTY,OSCH_CHILD_LUNCH,19,128,28,206,362,90,20,145,255,13.4211
SAN DIEGO,Nov 2013,CACF,2014,YMCA OF SAN DIEGO COUNTY,OSCH_CHILD_SNACK_PM,19,128,28,206,362,1290,282,2075,3647,191.9474
SAN DIEGO,Dec 2013,CACF,2014,YMCA OF SAN DIEGO COUNTY,CHILD_BREAKFAST,20,43,20,58,121,424,197,573,1194,59.7
SAN DIEGO,Dec 2013,CACF,2014,YMCA OF SAN DIEGO COUNTY,CHILD_LUNCH,20,43,20,58,121,358,166,482,1006,50.3
SAN DIEGO,Dec 2013,CACF,2014,YMCA OF SAN DIEGO COUNTY,CHILD_SNACK_AM,20,43,20,58,121,59,27,80,166,8.3
SAN DIEGO,Dec 2013,CACF,2014,YMCA OF SAN DIEGO COUNTY,CHILD_SNACK_PM,20,43,20,58,121,472,219,636,1327,66.35
SAN DIEGO,Dec 2013,CACF,2014,YMCA OF SAN DIEGO COUNTY,OSCH_CHILD_BREAKFAST,15,128,28,206,362,85,18,136,239,15.9333
SAN DIEGO,Dec 2013,CACF,2014,YMCA OF SAN DIEGO COUNTY,OSCH_CHILD_LUNCH,15,128,28,206,362,61,13,99,173,11.5333
SAN DIEGO,Dec 2013,CACF,2014,YMCA OF SAN DIEGO COUNTY,OSCH_CHILD_SNACK_AM,15,128,28,206,362,38,8,61,107,7.1333
SAN DIEGO,Dec 2013,CACF,2014,YMCA OF SAN DIEGO COUNTY,OSCH_CHILD_SNACK_PM,15,128,28,206,362,1325,290,2131,3746,249.7333
SAN DIEGO,Jan 2014,CACF,2014,YMCA OF SAN DIEGO COUNTY,CHILD_BREAKFAST,21,43,20,58,121,443,206,598,1247,59.381
SAN DIEGO,Jan 2014,CACF,2014,YMCA OF SAN DIEGO COUNTY,CHILD_LUNCH,21,43,20,58,121,430,200,580,1210,57.619
SAN DIEGO,Jan 2014,CACF,2014,YMCA OF SAN DIEGO COUNTY,CHILD_SNACK_AM,21,43,20,58,121,21,10,27,58,2.7619
SAN DIEGO,Jan 2014,CACF,2014,YMCA OF SAN DIEGO COUNTY,CHILD_SNACK_PM,21,43,20,58,121,502,234,677,1413,67.2857
SAN DIEGO,Jan 2014,CACF,2014,YMCA OF SAN DIEGO COUNTY,OSCH_CHILD_BREAKFAST,21,128,28,206,362,84,18,136,238,11.3333
SAN DIEGO,Jan 2014,CACF,2014,YMCA OF SAN DIEGO COUNTY,OSCH_CHILD_LUNCH,21,128,28,206,362,118,26,189,333,15.8571
SAN DIEGO,Jan 2014,CACF,2014,YMCA OF SAN DIEGO COUNTY,OSCH_CHILD_SNACK_AM,21,128,28,206,362,28,6,46,80,3.8095
SAN DIEGO,Jan 2014,CACF,2014,YMCA OF SAN DIEGO COUNTY,OSCH_CHILD_SNACK_PM,21,128,28,206,362,1407,307,2264,3978,189.4286
SAN DIEGO,Feb 2014,CACF,2014,YMCA OF SAN DIEGO COUNTY,CHILD_BREAKFAST,18,43,20,58,121,482,224,649,1355,75.2778
SAN DIEGO,Feb 2014,CACF,2014,YMCA OF SAN DIEGO COUNTY,CHILD_LUNCH,18,43,20,58,121,428,199,576,1203,66.8333
SAN DIEGO,Feb 2014,CACF,2014,YMCA OF SAN DIEGO COUNTY,CHILD_SNACK_AM,18,43,20,58,121,139,65,188,392,21.7778
SAN DIEGO,Feb 2014,CACF,2014,YMCA OF SAN DIEGO COUNTY,CHILD_SNACK_PM,18,43,20,58,121,571,265,770,1606,89.2222
SAN DIEGO,Feb 2014,CACF,2014,YMCA OF SAN DIEGO COUNTY,OSCH_CHILD_BREAKFAST,18,128,28,206,362,76,17,122,215,11.9444
SAN DIEGO,Feb 2014,CACF,2014,YMCA OF SAN DIEGO COUNTY,OSCH_CHILD_LUNCH,18,128,28,206,362,28,6,45,79,4.3889
SAN DIEGO,Feb 2014,CACF,2014,YMCA OF SAN DIEGO COUNTY,OSCH_CHILD_SNACK_AM,18,128,28,206,362,12,3,19,34,1.8889
SAN DIEGO,Feb 2014,CACF,2014,YMCA OF SAN DIEGO COUNTY,OSCH_CHILD_SNACK_PM,18,128,28,206,362,1306,285,2102,3693,205.1667
SAN DIEGO,Mar 2014,CACF,2014,YMCA OF SAN DIEGO COUNTY,CHILD_BREAKFAST,21,43,20,58,121,474,221,639,1334,63.5238
SAN DIEGO,Mar 2014,CACF,2014,YMCA OF SAN DIEGO COUNTY,CHILD_LUNCH,21,43,20,58,121,482,224,649,1355,64.5238
SAN DIEGO,Mar 2014,CACF,2014,YMCA OF SAN DIEGO COUNTY,CHILD_SNACK_AM,21,43,20,58,121,105,49,141,295,14.0476
SAN DIEGO,Mar 2014,CACF,2014,YMCA OF SAN DIEGO COUNTY,CHILD_SNACK_PM,21,43,20,58,121,543,252,732,1527,72.7143
SAN DIEGO,Mar 2014,CACF,2014,YMCA OF SAN DIEGO COUNTY,OSCH_CHILD_BREAKFAST,21,128,28,206,362,78,17,127,222,10.5714
SAN DIEGO,Mar 2014,CACF,2014,YMCA OF SAN DIEGO COUNTY,OSCH_CHILD_LUNCH,21,128,28,206,362,21,5,34,60,2.8571
SAN DIEGO,Mar 2014,CACF,2014,YMCA OF SAN DIEGO COUNTY,OSCH_CHILD_SNACK_AM,21,128,28,206,362,2,0,3,5,0.2381
SAN DIEGO,Mar 2014,CACF,2014,YMCA OF SAN DIEGO COUNTY,OSCH_CHILD_SNACK_PM,21,128,28,206,362,1610,352,2592,4554,216.8571
SAN DIEGO,Apr 2014,CACF,2014,YMCA OF SAN DIEGO COUNTY,CHILD_BREAKFAST,22,43,20,58,121,432,201,582,1215,55.2273
SAN DIEGO,Apr 2014,CACF,2014,YMCA OF SAN DIEGO COUNTY,CHILD_LUNCH,22,43,20,58,121,434,202,585,1221,55.5
SAN DIEGO,Apr 2014,CACF,2014,YMCA OF SAN DIEGO COUNTY,CHILD_SNACK_AM,22,43,20,58,121,115,54,155,324,14.7273
SAN DIEGO,Apr 2014,CACF,2014,YMCA OF SAN DIEGO COUNTY,CHILD_SNACK_PM,22,43,20,58,121,516,240,697,1453,66.0455
SAN DIEGO,Apr 2014,CACF,2014,YMCA OF SAN DIEGO COUNTY,OSCH_CHILD_BREAKFAST,22,128,28,206,362,160,35,257,452,20.5455
SAN DIEGO,Apr 2014,CACF,2014,YMCA OF SAN DIEGO COUNTY,OSCH_CHILD_LUNCH,22,128,28,206,362,129,28,209,366,16.6364
SAN DIEGO,Apr 2014,CACF,2014,YMCA OF SAN DIEGO COUNTY,OSCH_CHILD_SNACK_AM,22,128,28,206,362,118,26,189,333,15.1364
SAN DIEGO,Apr 2014,CACF,2014,YMCA OF SAN DIEGO COUNTY,OSCH_CHILD_SNACK_PM,22,128,28,206,362,1138,249,1830,3217,146.2273
SAN DIEGO,May 2014,CACF,2014,YMCA OF SAN DIEGO COUNTY,CHILD_BREAKFAST,21,43,20,58,121,433,201,584,1218,58
SAN DIEGO,May 2014,CACF,2014,YMCA OF SAN DIEGO COUNTY,CHILD_LUNCH,21,43,20,58,121,451,210,609,1270,60.4762
SAN DIEGO,May 2014,CACF,2014,YMCA OF SAN DIEGO COUNTY,CHILD_SNACK_PM,21,43,20,58,121,458,213,617,1288,61.3333
SAN DIEGO,May 2014,CACF,2014,YMCA OF SAN DIEGO COUNTY,OSCH_CHILD_BREAKFAST,21,128,28,206,362,64,14,102,180,8.5714
SAN DIEGO,May 2014,CACF,2014,YMCA OF SAN DIEGO COUNTY,OSCH_CHILD_SNACK_AM,21,128,28,206,362,6,1,11,18,0.8571
SAN DIEGO,May 2014,CACF,2014,YMCA OF SAN DIEGO COUNTY,OSCH_CHILD_SNACK_PM,21,128,28,206,362,1251,273,2013,3537,168.4286
SAN DIEGO,Jun 2014,CACF,2014,YMCA OF SAN DIEGO COUNTY,CHILD_BREAKFAST,10,43,20,58,121,182,85,245,512,51.2
SAN DIEGO,Jun 2014,CACF,2014,YMCA OF SAN DIEGO COUNTY,CHILD_LUNCH,10,43,20,58,121,206,96,277,579,57.9
SAN DIEGO,Jun 2014,CACF,2014,YMCA OF SAN DIEGO COUNTY,CHILD_SNACK_PM,10,43,20,58,121,205,95,276,576,57.6
SAN DIEGO,Jun 2014,CACF,2014,YMCA OF SAN DIEGO COUNTY,OSCH_CHILD_BREAKFAST,10,128,28,206,362,30,7,48,85,8.5
SAN DIEGO,Jun 2014,CACF,2014,YMCA OF SAN DIEGO COUNTY,OSCH_CHILD_SNACK_AM,10,128,28,206,362,2,1,4,7,0.7
SAN DIEGO,Jun 2014,CACF,2014,YMCA OF SAN DIEGO COUNTY,OSCH_CHILD_SNACK_PM,10,128,28,206,362,359,78,578,1015,101.5
SAN DIEGO,Oct 2013,CACF,2014,YWCA OF SAN DIEGO COUNTY,ES_CHILD_BREAKFAST,31,96,0,0,96,487,0,0,487,15.7097
SAN DIEGO,Oct 2013,CACF,2014,YWCA OF SAN DIEGO COUNTY,ES_CHILD_SNACK_PM,31,96,0,0,96,174,0,0,174,5.6129
SAN DIEGO,Oct 2013,CACF,2014,YWCA OF SAN DIEGO COUNTY,ES_CHILD_SUPPER,31,96,0,0,96,903,0,0,903,29.129
SAN DIEGO,Nov 2013,CACF,2014,YWCA OF SAN DIEGO COUNTY,ES_CHILD_BREAKFAST,30,102,0,0,102,570,0,0,570,19
SAN DIEGO,Nov 2013,CACF,2014,YWCA OF SAN DIEGO COUNTY,ES_CHILD_SNACK_PM,30,102,0,0,102,158,0,0,158,5.2667
SAN DIEGO,Nov 2013,CACF,2014,YWCA OF SAN DIEGO COUNTY,ES_CHILD_SUPPER,30,102,0,0,102,820,0,0,820,27.3333
SAN DIEGO,Dec 2013,CACF,2014,YWCA OF SAN DIEGO COUNTY,ES_CHILD_BREAKFAST,31,101,0,0,101,354,0,0,354,11.4194
SAN DIEGO,Dec 2013,CACF,2014,YWCA OF SAN DIEGO COUNTY,ES_CHILD_SNACK_PM,31,101,0,0,101,148,0,0,148,4.7742
SAN DIEGO,Dec 2013,CACF,2014,YWCA OF SAN DIEGO COUNTY,ES_CHILD_SUPPER,31,101,0,0,101,686,0,0,686,22.129
SAN DIEGO,Jan 2014,CACF,2014,YWCA OF SAN DIEGO COUNTY,ES_CHILD_BREAKFAST,31,102,0,0,102,390,0,0,390,12.5806
SAN DIEGO,Jan 2014,CACF,2014,YWCA OF SAN DIEGO COUNTY,ES_CHILD_SNACK_PM,31,102,0,0,102,164,0,0,164,5.2903
SAN DIEGO,Jan 2014,CACF,2014,YWCA OF SAN DIEGO COUNTY,ES_CHILD_SUPPER,31,102,0,0,102,796,0,0,796,25.6774
SAN DIEGO,Feb 2014,CACF,2014,YWCA OF SAN DIEGO COUNTY,ES_CHILD_BREAKFAST,28,93,0,0,93,334,0,0,334,11.9286
SAN DIEGO,Feb 2014,CACF,2014,YWCA OF SAN DIEGO COUNTY,ES_CHILD_SNACK_PM,28,93,0,0,93,155,0,0,155,5.5357
SAN DIEGO,Feb 2014,CACF,2014,YWCA OF SAN DIEGO COUNTY,ES_CHILD_SUPPER,28,93,0,0,93,610,0,0,610,21.7857
SAN DIEGO,Mar 2014,CACF,2014,YWCA OF SAN DIEGO COUNTY,ES_CHILD_BREAKFAST,31,125,0,0,125,402,0,0,402,12.9677
SAN DIEGO,Mar 2014,CACF,2014,YWCA OF SAN DIEGO COUNTY,ES_CHILD_SNACK_PM,31,125,0,0,125,210,0,0,210,6.7742
SAN DIEGO,Mar 2014,CACF,2014,YWCA OF SAN DIEGO COUNTY,ES_CHILD_SUPPER,31,125,0,0,125,760,0,0,760,24.5161
SAN DIEGO,Apr 2014,CACF,2014,YWCA OF SAN DIEGO COUNTY,ES_CHILD_BREAKFAST,30,102,0,0,102,474,0,0,474,15.8
SAN DIEGO,Apr 2014,CACF,2014,YWCA OF SAN DIEGO COUNTY,ES_CHILD_SNACK_PM,30,102,0,0,102,222,0,0,222,7.4
SAN DIEGO,Apr 2014,CACF,2014,YWCA OF SAN DIEGO COUNTY,ES_CHILD_SUPPER,30,102,0,0,102,820,0,0,820,27.3333
SAN DIEGO,May 2014,CACF,2014,YWCA OF SAN DIEGO COUNTY,ES_CHILD_BREAKFAST,31,110,0,0,110,692,0,0,692,22.3226
SAN DIEGO,May 2014,CACF,2014,YWCA OF SAN DIEGO COUNTY,ES_CHILD_SNACK_PM,31,110,0,0,110,229,0,0,229,7.3871
SAN DIEGO,May 2014,CACF,2014,YWCA OF SAN DIEGO COUNTY,ES_CHILD_SUPPER,31,110,0,0,110,973,0,0,973,31.3871
SAN DIEGO,Jun 2014,CACF,2014,YWCA OF SAN DIEGO COUNTY,ES_CHILD_BREAKFAST,30,132,0,0,132,641,0,0,641,21.3667
SAN DIEGO,Jun 2014,CACF,2014,YWCA OF SAN DIEGO COUNTY,ES_CHILD_SNACK_PM,30,132,0,0,132,279,0,0,279,9.3
SAN DIEGO,Jun 2014,CACF,2014,YWCA OF SAN DIEGO COUNTY,ES_CHILD_SUPPER,30,132,0,0,132,1091,0,0,1091,36.3667
SAN DIEGO,Jul 2014,CACF,2014,YWCA OF SAN DIEGO COUNTY,ES_CHILD_BREAKFAST,31,130,0,0,130,513,0,0,513,16.5484
SAN DIEGO,Jul 2014,CACF,2014,YWCA OF SAN DIEGO COUNTY,ES_CHILD_SNACK_PM,31,130,0,0,130,219,0,0,219,7.0645
SAN DIEGO,Jul 2014,CACF,2014,YWCA OF SAN DIEGO COUNTY,ES_CHILD_SUPPER,31,130,0,0,130,1048,0,0,1048,33.8065
SAN DIEGO,Aug 2014,CACF,2014,YWCA OF SAN DIEGO COUNTY,ES_CHILD_BREAKFAST,31,116,0,0,116,615,0,0,615,19.8387
SAN DIEGO,Aug 2014,CACF,2014,YWCA OF SAN DIEGO COUNTY,ES_CHILD_SNACK_PM,31,116,0,0,116,208,0,0,208,6.7097
SAN DIEGO,Aug 2014,CACF,2014,YWCA OF SAN DIEGO COUNTY,ES_CHILD_SUPPER,31,116,0,0,116,1029,0,0,1029,33.1935
SAN DIEGO,Sep 2014,CACF,2014,YWCA OF SAN DIEGO COUNTY,ES_CHILD_BREAKFAST,30,117,0,0,117,660,0,0,660,22
SAN DIEGO,Sep 2014,CACF,2014,YWCA OF SAN DIEGO COUNTY,ES_CHILD_SNACK_PM,30,117,0,0,117,267,0,0,267,8.9
SAN DIEGO,Sep 2014,CACF,2014,YWCA OF SAN DIEGO COUNTY,ES_CHILD_SUPPER,30,117,0,0,117,1272,0,0,1272,42.4
