County,Claim Month/ Year,ProgramCode,Year,Name,Meal Group,Days Served,Free Eligible,Reduced Eligible,Paid Eligible,Enroll,Free Meals,Reduced Meals,Paid Meals,Total Meals,Average Daily Meals
SAN DIEGO,Oct 2015,CACF,2016,A PLACE OF OUR OWN CHILD,CHILD_BREAKFAST,22,77,4,4,85,987,51,51,1089,49.5
SAN DIEGO,Oct 2015,CACF,2016,A PLACE OF OUR OWN CHILD,CHILD_LUNCH,22,77,4,4,85,1251,65,65,1381,62.7727
SAN DIEGO,Oct 2015,CACF,2016,A PLACE OF OUR OWN CHILD,CHILD_SNACK_PM,22,77,4,4,85,699,36,37,772,35.0909
SAN DIEGO,Oct 2015,CACF,2016,A PLACE OF OUR OWN CHILD,OSCH_CHILD_BREAKFAST,22,19,2,3,24,36,4,5,45,2.0455
SAN DIEGO,Oct 2015,CACF,2016,A PLACE OF OUR OWN CHILD,OSCH_CHILD_LUNCH,22,19,2,3,24,36,4,5,45,2.0455
SAN DIEGO,Oct 2015,CACF,2016,A PLACE OF OUR OWN CHILD,OSCH_CHILD_SNACK_PM,22,19,2,3,24,291,31,45,367,16.6818
SAN DIEGO,Nov 2015,CACF,2016,A PLACE OF OUR OWN CHILD,CHILD_BREAKFAST,19,77,4,4,85,780,41,40,861,45.3158
SAN DIEGO,Nov 2015,CACF,2016,A PLACE OF OUR OWN CHILD,CHILD_LUNCH,19,77,4,4,85,1054,55,55,1164,61.2632
SAN DIEGO,Nov 2015,CACF,2016,A PLACE OF OUR OWN CHILD,CHILD_SNACK_PM,19,77,4,4,85,706,37,36,779,41
SAN DIEGO,Nov 2015,CACF,2016,A PLACE OF OUR OWN CHILD,OSCH_CHILD_BREAKFAST,19,19,2,3,24,52,5,9,66,3.4737
SAN DIEGO,Nov 2015,CACF,2016,A PLACE OF OUR OWN CHILD,OSCH_CHILD_LUNCH,19,19,2,3,24,56,6,9,71,3.7368
SAN DIEGO,Nov 2015,CACF,2016,A PLACE OF OUR OWN CHILD,OSCH_CHILD_SNACK_PM,19,19,2,3,24,248,26,39,313,16.4737
SAN DIEGO,Dec 2015,CACF,2016,A PLACE OF OUR OWN CHILD,CHILD_BREAKFAST,21,77,4,4,85,795,41,42,878,41.8095
SAN DIEGO,Dec 2015,CACF,2016,A PLACE OF OUR OWN CHILD,CHILD_LUNCH,21,77,4,4,85,1175,61,61,1297,61.7619
SAN DIEGO,Dec 2015,CACF,2016,A PLACE OF OUR OWN CHILD,CHILD_SNACK_PM,21,77,4,4,85,793,41,41,875,41.6667
SAN DIEGO,Dec 2015,CACF,2016,A PLACE OF OUR OWN CHILD,OSCH_CHILD_BREAKFAST,21,19,2,3,24,81,8,13,102,4.8571
SAN DIEGO,Dec 2015,CACF,2016,A PLACE OF OUR OWN CHILD,OSCH_CHILD_LUNCH,21,19,2,3,24,86,9,13,108,5.1429
SAN DIEGO,Dec 2015,CACF,2016,A PLACE OF OUR OWN CHILD,OSCH_CHILD_SNACK_PM,21,19,2,3,24,257,27,41,325,15.4762
SAN DIEGO,Jan 2016,CACF,2016,A PLACE OF OUR OWN CHILD,CHILD_BREAKFAST,21,98,4,4,106,863,35,35,933,44.4286
SAN DIEGO,Jan 2016,CACF,2016,A PLACE OF OUR OWN CHILD,CHILD_LUNCH,21,98,4,4,106,1228,50,50,1328,63.2381
SAN DIEGO,Jan 2016,CACF,2016,A PLACE OF OUR OWN CHILD,CHILD_SNACK_PM,21,98,4,4,106,763,31,31,825,39.2857
SAN DIEGO,Jan 2016,CACF,2016,A PLACE OF OUR OWN CHILD,OSCH_CHILD_BREAKFAST,21,28,2,3,33,42,3,5,50,2.381
SAN DIEGO,Jan 2016,CACF,2016,A PLACE OF OUR OWN CHILD,OSCH_CHILD_LUNCH,21,28,2,3,33,41,3,4,48,2.2857
SAN DIEGO,Jan 2016,CACF,2016,A PLACE OF OUR OWN CHILD,OSCH_CHILD_SNACK_PM,21,28,2,3,33,296,21,32,349,16.619
SAN DIEGO,Feb 2016,CACF,2016,A PLACE OF OUR OWN CHILD,CHILD_BREAKFAST,21,98,4,4,106,1172,48,48,1268,60.381
SAN DIEGO,Feb 2016,CACF,2016,A PLACE OF OUR OWN CHILD,CHILD_LUNCH,21,98,4,4,106,1531,62,63,1656,78.8571
SAN DIEGO,Feb 2016,CACF,2016,A PLACE OF OUR OWN CHILD,CHILD_SNACK_PM,21,98,4,4,106,1080,44,44,1168,55.619
SAN DIEGO,Feb 2016,CACF,2016,A PLACE OF OUR OWN CHILD,OSCH_CHILD_BREAKFAST,21,28,2,3,33,68,5,7,80,3.8095
SAN DIEGO,Feb 2016,CACF,2016,A PLACE OF OUR OWN CHILD,OSCH_CHILD_LUNCH,21,28,2,3,33,46,3,5,54,2.5714
SAN DIEGO,Feb 2016,CACF,2016,A PLACE OF OUR OWN CHILD,OSCH_CHILD_SNACK_PM,21,28,2,3,33,372,27,39,438,20.8571
SAN DIEGO,Mar 2016,CACF,2016,A PLACE OF OUR OWN CHILD,CHILD_BREAKFAST,23,121,6,4,131,1085,54,36,1175,51.087
SAN DIEGO,Mar 2016,CACF,2016,A PLACE OF OUR OWN CHILD,CHILD_LUNCH,23,121,6,4,131,2330,116,77,2523,109.6957
SAN DIEGO,Mar 2016,CACF,2016,A PLACE OF OUR OWN CHILD,CHILD_SNACK_PM,23,121,6,4,131,975,48,32,1055,45.8696
SAN DIEGO,Mar 2016,CACF,2016,A PLACE OF OUR OWN CHILD,OSCH_CHILD_BREAKFAST,23,36,1,2,39,190,5,11,206,8.9565
SAN DIEGO,Mar 2016,CACF,2016,A PLACE OF OUR OWN CHILD,OSCH_CHILD_LUNCH,23,36,1,2,39,223,6,13,242,10.5217
SAN DIEGO,Mar 2016,CACF,2016,A PLACE OF OUR OWN CHILD,OSCH_CHILD_SNACK_PM,23,36,1,2,39,422,12,23,457,19.8696
SAN DIEGO,Apr 2016,CACF,2016,A PLACE OF OUR OWN CHILD,CHILD_BREAKFAST,21,121,6,4,131,1085,54,36,1175,55.9524
SAN DIEGO,Apr 2016,CACF,2016,A PLACE OF OUR OWN CHILD,CHILD_LUNCH,21,121,6,4,131,1386,69,46,1501,71.4762
SAN DIEGO,Apr 2016,CACF,2016,A PLACE OF OUR OWN CHILD,CHILD_SNACK_PM,21,121,6,4,131,969,48,32,1049,49.9524
SAN DIEGO,Apr 2016,CACF,2016,A PLACE OF OUR OWN CHILD,OSCH_CHILD_BREAKFAST,21,36,1,2,39,27,1,1,29,1.381
SAN DIEGO,Apr 2016,CACF,2016,A PLACE OF OUR OWN CHILD,OSCH_CHILD_LUNCH,21,36,1,2,39,42,1,2,45,2.1429
SAN DIEGO,Apr 2016,CACF,2016,A PLACE OF OUR OWN CHILD,OSCH_CHILD_SNACK_PM,21,36,1,2,39,428,12,24,464,22.0952
SAN DIEGO,May 2016,CACF,2016,A PLACE OF OUR OWN CHILD,CHILD_BREAKFAST,21,121,6,4,131,1272,63,42,1377,65.5714
SAN DIEGO,May 2016,CACF,2016,A PLACE OF OUR OWN CHILD,CHILD_LUNCH,21,121,6,4,131,1409,70,46,1525,72.619
SAN DIEGO,May 2016,CACF,2016,A PLACE OF OUR OWN CHILD,CHILD_SNACK_PM,21,121,6,4,131,999,50,33,1082,51.5238
SAN DIEGO,May 2016,CACF,2016,A PLACE OF OUR OWN CHILD,OSCH_CHILD_SNACK_PM,21,36,1,2,39,443,12,25,480,22.8571
SAN DIEGO,Jun 2016,CACF,2016,A PLACE OF OUR OWN CHILD,CHILD_BREAKFAST,22,121,6,4,131,975,48,33,1056,48
SAN DIEGO,Jun 2016,CACF,2016,A PLACE OF OUR OWN CHILD,CHILD_LUNCH,22,121,6,4,131,1297,64,43,1404,63.8182
SAN DIEGO,Jun 2016,CACF,2016,A PLACE OF OUR OWN CHILD,CHILD_SNACK_PM,22,121,6,4,131,950,47,32,1029,46.7727
SAN DIEGO,Jun 2016,CACF,2016,A PLACE OF OUR OWN CHILD,OSCH_CHILD_BREAKFAST,22,36,1,2,39,249,7,14,270,12.2727
SAN DIEGO,Jun 2016,CACF,2016,A PLACE OF OUR OWN CHILD,OSCH_CHILD_LUNCH,22,36,1,2,39,337,9,19,365,16.5909
SAN DIEGO,Jun 2016,CACF,2016,A PLACE OF OUR OWN CHILD,OSCH_CHILD_SNACK_PM,22,36,1,2,39,414,11,23,448,20.3636
SAN DIEGO,Jul 2016,CACF,2016,A PLACE OF OUR OWN CHILD,CHILD_BREAKFAST,20,121,6,4,131,681,34,22,737,36.85
SAN DIEGO,Jul 2016,CACF,2016,A PLACE OF OUR OWN CHILD,CHILD_LUNCH,20,121,6,4,131,1015,50,34,1099,54.95
SAN DIEGO,Jul 2016,CACF,2016,A PLACE OF OUR OWN CHILD,CHILD_SNACK_PM,20,121,6,4,131,804,40,26,870,43.5
SAN DIEGO,Jul 2016,CACF,2016,A PLACE OF OUR OWN CHILD,OSCH_CHILD_BREAKFAST,20,36,1,2,39,240,7,13,260,13
SAN DIEGO,Jul 2016,CACF,2016,A PLACE OF OUR OWN CHILD,OSCH_CHILD_LUNCH,20,36,1,2,39,385,11,21,417,20.85
SAN DIEGO,Jul 2016,CACF,2016,A PLACE OF OUR OWN CHILD,OSCH_CHILD_SNACK_PM,20,36,1,2,39,340,9,19,368,18.4
SAN DIEGO,Oct 2015,CACF,2016,All Kids Academy Head Start Inc.,HS_CHILD_BREAKFAST,22,1079,0,0,1079,9578,0,0,9578,435.3636
SAN DIEGO,Oct 2015,CACF,2016,All Kids Academy Head Start Inc.,HS_CHILD_LUNCH,22,1079,0,0,1079,14464,0,0,14464,657.4545
SAN DIEGO,Oct 2015,CACF,2016,All Kids Academy Head Start Inc.,HS_CHILD_SNACK_PM,22,1079,0,0,1079,8507,0,0,8507,386.6818
SAN DIEGO,Nov 2015,CACF,2016,All Kids Academy Head Start Inc.,HS_CHILD_BREAKFAST,15,1079,0,0,1079,6799,0,0,6799,453.2667
SAN DIEGO,Nov 2015,CACF,2016,All Kids Academy Head Start Inc.,HS_CHILD_LUNCH,15,1079,0,0,1079,10236,0,0,10236,682.4
SAN DIEGO,Nov 2015,CACF,2016,All Kids Academy Head Start Inc.,HS_CHILD_SNACK_PM,15,1079,0,0,1079,5855,0,0,5855,390.3333
SAN DIEGO,Dec 2015,CACF,2016,All Kids Academy Head Start Inc.,HS_CHILD_BREAKFAST,17,1079,0,0,1079,6318,0,0,6318,371.6471
SAN DIEGO,Dec 2015,CACF,2016,All Kids Academy Head Start Inc.,HS_CHILD_LUNCH,17,1079,0,0,1079,9378,0,0,9378,551.6471
SAN DIEGO,Dec 2015,CACF,2016,All Kids Academy Head Start Inc.,HS_CHILD_SNACK_PM,17,1079,0,0,1079,5351,0,0,5351,314.7647
SAN DIEGO,Jan 2016,CACF,2016,All Kids Academy Head Start Inc.,HS_CHILD_BREAKFAST,19,1079,0,0,1079,8103,0,0,8103,426.4737
SAN DIEGO,Jan 2016,CACF,2016,All Kids Academy Head Start Inc.,HS_CHILD_LUNCH,19,1079,0,0,1079,12182,0,0,12182,641.1579
SAN DIEGO,Jan 2016,CACF,2016,All Kids Academy Head Start Inc.,HS_CHILD_SNACK_PM,19,1079,0,0,1079,7175,0,0,7175,377.6316
SAN DIEGO,Feb 2016,CACF,2016,All Kids Academy Head Start Inc.,HS_CHILD_BREAKFAST,18,1079,0,0,1079,7945,0,0,7945,441.3889
SAN DIEGO,Feb 2016,CACF,2016,All Kids Academy Head Start Inc.,HS_CHILD_LUNCH,18,1079,0,0,1079,12297,0,0,12297,683.1667
SAN DIEGO,Feb 2016,CACF,2016,All Kids Academy Head Start Inc.,HS_CHILD_SNACK_PM,18,1079,0,0,1079,7141,0,0,7141,396.7222
SAN DIEGO,Mar 2016,CACF,2016,All Kids Academy Head Start Inc.,HS_CHILD_BREAKFAST,22,1079,0,0,1079,7786,0,0,7786,353.9091
SAN DIEGO,Mar 2016,CACF,2016,All Kids Academy Head Start Inc.,HS_CHILD_LUNCH,22,1079,0,0,1079,12010,0,0,12010,545.9091
SAN DIEGO,Mar 2016,CACF,2016,All Kids Academy Head Start Inc.,HS_CHILD_SNACK_PM,22,1079,0,0,1079,7105,0,0,7105,322.9545
SAN DIEGO,Apr 2016,CACF,2016,All Kids Academy Head Start Inc.,HS_CHILD_BREAKFAST,21,1079,0,0,1079,8829,0,0,8829,420.4286
SAN DIEGO,Apr 2016,CACF,2016,All Kids Academy Head Start Inc.,HS_CHILD_LUNCH,21,1079,0,0,1079,13658,0,0,13658,650.381
SAN DIEGO,Apr 2016,CACF,2016,All Kids Academy Head Start Inc.,HS_CHILD_SNACK_PM,21,1079,0,0,1079,8021,0,0,8021,381.9524
SAN DIEGO,May 2016,CACF,2016,All Kids Academy Head Start Inc.,HS_CHILD_BREAKFAST,20,1079,0,0,1079,8971,0,0,8971,448.55
SAN DIEGO,May 2016,CACF,2016,All Kids Academy Head Start Inc.,HS_CHILD_LUNCH,20,1079,0,0,1079,13960,0,0,13960,698
SAN DIEGO,May 2016,CACF,2016,All Kids Academy Head Start Inc.,HS_CHILD_SNACK_PM,20,1079,0,0,1079,8041,0,0,8041,402.05
SAN DIEGO,Jun 2016,CACF,2016,All Kids Academy Head Start Inc.,HS_CHILD_BREAKFAST,22,1079,0,0,1079,5434,0,0,5434,247
SAN DIEGO,Jun 2016,CACF,2016,All Kids Academy Head Start Inc.,HS_CHILD_LUNCH,22,1079,0,0,1079,7994,0,0,7994,363.3636
SAN DIEGO,Jun 2016,CACF,2016,All Kids Academy Head Start Inc.,HS_CHILD_SNACK_PM,22,1079,0,0,1079,4481,0,0,4481,203.6818
SAN DIEGO,Jul 2016,CACF,2016,All Kids Academy Head Start Inc.,HS_CHILD_BREAKFAST,19,1079,0,0,1079,1403,0,0,1403,73.8421
SAN DIEGO,Jul 2016,CACF,2016,All Kids Academy Head Start Inc.,HS_CHILD_LUNCH,19,1079,0,0,1079,1463,0,0,1463,77
SAN DIEGO,Jul 2016,CACF,2016,All Kids Academy Head Start Inc.,HS_CHILD_SNACK_PM,19,1079,0,0,1079,985,0,0,985,51.8421
SAN DIEGO,Oct 2015,CACF,2016,AMERICARE ADHC INC ,ADULT_BREAKFAST,22,203,0,6,209,2569,0,76,2645,120.2273
SAN DIEGO,Oct 2015,CACF,2016,AMERICARE ADHC INC ,ADULT_LUNCH,22,203,0,6,209,2603,0,77,2680,121.8182
SAN DIEGO,Oct 2015,CACF,2016,AMERICARE ADHC INC ,ADULT_SNACK_AM,22,203,0,6,209,34,0,1,35,1.5909
SAN DIEGO,Oct 2015,CACF,2016,AMERICARE ADHC INC ,ADULT_SNACK_PM,22,203,0,6,209,651,0,19,670,30.4545
SAN DIEGO,Nov 2015,CACF,2016,AMERICARE ADHC INC ,ADULT_BREAKFAST,20,203,0,6,209,2318,0,68,2386,119.3
SAN DIEGO,Nov 2015,CACF,2016,AMERICARE ADHC INC ,ADULT_LUNCH,20,203,0,6,209,2349,0,69,2418,120.9
SAN DIEGO,Nov 2015,CACF,2016,AMERICARE ADHC INC ,ADULT_SNACK_AM,20,203,0,6,209,13,0,0,13,0.65
SAN DIEGO,Nov 2015,CACF,2016,AMERICARE ADHC INC ,ADULT_SNACK_PM,20,203,0,6,209,606,0,18,624,31.2
SAN DIEGO,Dec 2015,CACF,2016,AMERICARE ADHC INC ,ADULT_BREAKFAST,22,203,0,6,209,2507,0,74,2581,117.3182
SAN DIEGO,Dec 2015,CACF,2016,AMERICARE ADHC INC ,ADULT_LUNCH,22,203,0,6,209,2523,0,75,2598,118.0909
SAN DIEGO,Dec 2015,CACF,2016,AMERICARE ADHC INC ,ADULT_SNACK_AM,22,203,0,6,209,17,0,0,17,0.7727
SAN DIEGO,Dec 2015,CACF,2016,AMERICARE ADHC INC ,ADULT_SNACK_PM,22,203,0,6,209,700,0,21,721,32.7727
SAN DIEGO,Jan 2016,CACF,2016,AMERICARE ADHC INC ,ADULT_BREAKFAST,20,203,0,6,209,2346,0,69,2415,120.75
SAN DIEGO,Jan 2016,CACF,2016,AMERICARE ADHC INC ,ADULT_LUNCH,20,203,0,6,209,2359,0,70,2429,121.45
SAN DIEGO,Jan 2016,CACF,2016,AMERICARE ADHC INC ,ADULT_SNACK_AM,20,203,0,6,209,14,0,0,14,0.7
SAN DIEGO,Jan 2016,CACF,2016,AMERICARE ADHC INC ,ADULT_SNACK_PM,20,203,0,6,209,665,0,20,685,34.25
SAN DIEGO,Feb 2016,CACF,2016,AMERICARE ADHC INC ,ADULT_BREAKFAST,21,203,0,6,209,2389,0,71,2460,117.1429
SAN DIEGO,Feb 2016,CACF,2016,AMERICARE ADHC INC ,ADULT_LUNCH,21,203,0,6,209,2396,0,71,2467,117.4762
SAN DIEGO,Feb 2016,CACF,2016,AMERICARE ADHC INC ,ADULT_SNACK_AM,21,203,0,6,209,7,0,0,7,0.3333
SAN DIEGO,Feb 2016,CACF,2016,AMERICARE ADHC INC ,ADULT_SNACK_PM,21,203,0,6,209,676,0,20,696,33.1429
SAN DIEGO,Mar 2016,CACF,2016,AMERICARE ADHC INC ,ADULT_BREAKFAST,23,203,0,6,209,2554,0,75,2629,114.3043
SAN DIEGO,Mar 2016,CACF,2016,AMERICARE ADHC INC ,ADULT_LUNCH,23,203,0,6,209,2560,0,76,2636,114.6087
SAN DIEGO,Mar 2016,CACF,2016,AMERICARE ADHC INC ,ADULT_SNACK_AM,23,203,0,6,209,7,0,0,7,0.3043
SAN DIEGO,Mar 2016,CACF,2016,AMERICARE ADHC INC ,ADULT_SNACK_PM,23,203,0,6,209,756,0,22,778,33.8261
SAN DIEGO,Apr 2016,CACF,2016,AMERICARE ADHC INC ,ADULT_BREAKFAST,21,203,0,6,209,2380,0,70,2450,116.6667
SAN DIEGO,Apr 2016,CACF,2016,AMERICARE ADHC INC ,ADULT_LUNCH,21,203,0,6,209,2409,0,71,2480,118.0952
SAN DIEGO,Apr 2016,CACF,2016,AMERICARE ADHC INC ,ADULT_SNACK_AM,21,203,0,6,209,29,0,1,30,1.4286
SAN DIEGO,Apr 2016,CACF,2016,AMERICARE ADHC INC ,ADULT_SNACK_PM,21,203,0,6,209,694,0,20,714,34
SAN DIEGO,May 2016,CACF,2016,AMERICARE ADHC INC ,ADULT_BREAKFAST,21,203,0,6,209,2502,0,74,2576,122.6667
SAN DIEGO,May 2016,CACF,2016,AMERICARE ADHC INC ,ADULT_LUNCH,21,203,0,6,209,2507,0,74,2581,122.9048
SAN DIEGO,May 2016,CACF,2016,AMERICARE ADHC INC ,ADULT_SNACK_AM,21,203,0,6,209,5,0,0,5,0.2381
SAN DIEGO,Jun 2016,CACF,2016,AMERICARE ADHC INC ,ADULT_BREAKFAST,22,203,0,6,209,2453,0,72,2525,114.7727
SAN DIEGO,Jun 2016,CACF,2016,AMERICARE ADHC INC ,ADULT_LUNCH,22,203,0,6,209,2460,0,73,2533,115.1364
SAN DIEGO,Jun 2016,CACF,2016,AMERICARE ADHC INC ,ADULT_SNACK_AM,22,203,0,6,209,8,0,0,8,0.3636
SAN DIEGO,Jun 2016,CACF,2016,AMERICARE ADHC INC ,ADULT_SNACK_PM,22,203,0,6,209,722,0,21,743,33.7727
SAN DIEGO,Jul 2016,CACF,2016,AMERICARE ADHC INC ,ADULT_BREAKFAST,20,203,0,6,209,2160,0,64,2224,111.2
SAN DIEGO,Jul 2016,CACF,2016,AMERICARE ADHC INC ,ADULT_LUNCH,20,203,0,6,209,2189,0,65,2254,112.7
SAN DIEGO,Jul 2016,CACF,2016,AMERICARE ADHC INC ,ADULT_SNACK_AM,20,203,0,6,209,29,0,1,30,1.5
SAN DIEGO,Jul 2016,CACF,2016,AMERICARE ADHC INC ,ADULT_SNACK_PM,20,203,0,6,209,638,0,19,657,32.85
SAN DIEGO,Oct 2015,CACF,2016,ASSOC STUDENTS CSU SAN DIEGO CHILDRENS CENTER ,CHILD_BREAKFAST,22,33,13,158,204,312,123,1495,1930,87.7273
SAN DIEGO,Oct 2015,CACF,2016,ASSOC STUDENTS CSU SAN DIEGO CHILDRENS CENTER ,CHILD_LUNCH,22,33,13,158,204,518,204,2477,3199,145.4091
SAN DIEGO,Oct 2015,CACF,2016,ASSOC STUDENTS CSU SAN DIEGO CHILDRENS CENTER ,CHILD_SNACK_PM,22,33,13,158,204,466,184,2232,2882,131
SAN DIEGO,Nov 2015,CACF,2016,ASSOC STUDENTS CSU SAN DIEGO CHILDRENS CENTER ,CHILD_BREAKFAST,18,33,13,158,204,259,102,1241,1602,89
SAN DIEGO,Nov 2015,CACF,2016,ASSOC STUDENTS CSU SAN DIEGO CHILDRENS CENTER ,CHILD_LUNCH,18,33,13,158,204,421,166,2014,2601,144.5
SAN DIEGO,Nov 2015,CACF,2016,ASSOC STUDENTS CSU SAN DIEGO CHILDRENS CENTER ,CHILD_SNACK_PM,18,33,13,158,204,376,148,1801,2325,129.1667
SAN DIEGO,Dec 2015,CACF,2016,ASSOC STUDENTS CSU SAN DIEGO CHILDRENS CENTER ,CHILD_BREAKFAST,14,33,13,158,204,189,74,905,1168,83.4286
SAN DIEGO,Dec 2015,CACF,2016,ASSOC STUDENTS CSU SAN DIEGO CHILDRENS CENTER ,CHILD_LUNCH,14,33,13,158,204,322,127,1544,1993,142.3571
SAN DIEGO,Dec 2015,CACF,2016,ASSOC STUDENTS CSU SAN DIEGO CHILDRENS CENTER ,CHILD_SNACK_PM,14,33,13,158,204,291,115,1395,1801,128.6429
SAN DIEGO,Jan 2016,CACF,2016,ASSOC STUDENTS CSU SAN DIEGO CHILDRENS CENTER ,CHILD_BREAKFAST,16,33,13,158,204,203,80,973,1256,78.5
SAN DIEGO,Jan 2016,CACF,2016,ASSOC STUDENTS CSU SAN DIEGO CHILDRENS CENTER ,CHILD_LUNCH,16,33,13,158,204,341,134,1633,2108,131.75
SAN DIEGO,Jan 2016,CACF,2016,ASSOC STUDENTS CSU SAN DIEGO CHILDRENS CENTER ,CHILD_SNACK_PM,16,33,13,158,204,314,124,1504,1942,121.375
SAN DIEGO,Feb 2016,CACF,2016,ASSOC STUDENTS CSU SAN DIEGO CHILDRENS CENTER ,CHILD_BREAKFAST,21,33,13,158,204,300,118,1439,1857,88.4286
SAN DIEGO,Feb 2016,CACF,2016,ASSOC STUDENTS CSU SAN DIEGO CHILDRENS CENTER ,CHILD_LUNCH,21,33,13,158,204,506,199,2423,3128,148.9524
SAN DIEGO,Feb 2016,CACF,2016,ASSOC STUDENTS CSU SAN DIEGO CHILDRENS CENTER ,CHILD_SNACK_PM,21,33,13,158,204,461,181,2205,2847,135.5714
SAN DIEGO,Mar 2016,CACF,2016,ASSOC STUDENTS CSU SAN DIEGO CHILDRENS CENTER ,CHILD_BREAKFAST,22,33,13,158,204,297,117,1424,1838,83.5455
SAN DIEGO,Mar 2016,CACF,2016,ASSOC STUDENTS CSU SAN DIEGO CHILDRENS CENTER ,CHILD_LUNCH,22,33,13,158,204,514,202,2459,3175,144.3182
SAN DIEGO,Mar 2016,CACF,2016,ASSOC STUDENTS CSU SAN DIEGO CHILDRENS CENTER ,CHILD_SNACK_PM,22,33,13,158,204,475,187,2276,2938,133.5455
SAN DIEGO,Apr 2016,CACF,2016,ASSOC STUDENTS CSU SAN DIEGO CHILDRENS CENTER ,CHILD_BREAKFAST,21,33,13,158,204,306,120,1465,1891,90.0476
SAN DIEGO,Apr 2016,CACF,2016,ASSOC STUDENTS CSU SAN DIEGO CHILDRENS CENTER ,CHILD_LUNCH,21,33,13,158,204,529,208,2532,3269,155.6667
SAN DIEGO,Apr 2016,CACF,2016,ASSOC STUDENTS CSU SAN DIEGO CHILDRENS CENTER ,CHILD_SNACK_PM,21,33,13,158,204,483,190,2314,2987,142.2381
SAN DIEGO,May 2016,CACF,2016,ASSOC STUDENTS CSU SAN DIEGO CHILDRENS CENTER ,CHILD_BREAKFAST,21,33,13,158,204,266,105,1275,1646,78.381
SAN DIEGO,May 2016,CACF,2016,ASSOC STUDENTS CSU SAN DIEGO CHILDRENS CENTER ,CHILD_LUNCH,21,33,13,158,204,459,181,2194,2834,134.9524
SAN DIEGO,May 2016,CACF,2016,ASSOC STUDENTS CSU SAN DIEGO CHILDRENS CENTER ,CHILD_SNACK_PM,21,33,13,158,204,418,165,2003,2586,123.1429
SAN DIEGO,Jun 2016,CACF,2016,ASSOC STUDENTS CSU SAN DIEGO CHILDRENS CENTER ,CHILD_BREAKFAST,22,33,13,158,204,237,93,1133,1463,66.5
SAN DIEGO,Jun 2016,CACF,2016,ASSOC STUDENTS CSU SAN DIEGO CHILDRENS CENTER ,CHILD_LUNCH,22,33,13,158,204,438,173,2099,2710,123.1818
SAN DIEGO,Jun 2016,CACF,2016,ASSOC STUDENTS CSU SAN DIEGO CHILDRENS CENTER ,CHILD_SNACK_PM,22,33,13,158,204,396,156,1897,2449,111.3182
SAN DIEGO,Jul 2016,CACF,2016,ASSOC STUDENTS CSU SAN DIEGO CHILDRENS CENTER ,CHILD_BREAKFAST,20,33,13,158,204,220,87,1051,1358,67.9
SAN DIEGO,Jul 2016,CACF,2016,ASSOC STUDENTS CSU SAN DIEGO CHILDRENS CENTER ,CHILD_LUNCH,20,33,13,158,204,371,146,1775,2292,114.6
SAN DIEGO,Jul 2016,CACF,2016,ASSOC STUDENTS CSU SAN DIEGO CHILDRENS CENTER ,CHILD_SNACK_PM,20,33,13,158,204,350,138,1675,2163,108.15
SAN DIEGO,Oct 2015,CACF,2016,ATC PACIFIC LLC,CHILD_BREAKFAST,22,6,2,11,19,102,34,188,324,14.7273
SAN DIEGO,Oct 2015,CACF,2016,ATC PACIFIC LLC,CHILD_LUNCH,22,6,2,11,19,121,40,223,384,17.4545
SAN DIEGO,Oct 2015,CACF,2016,ATC PACIFIC LLC,CHILD_SNACK_PM,22,6,2,11,19,127,42,232,401,18.2273
SAN DIEGO,Oct 2015,CACF,2016,ATC PACIFIC LLC,OSCH_CHILD_BREAKFAST,22,5,0,5,10,56,0,56,112,5.0909
SAN DIEGO,Oct 2015,CACF,2016,ATC PACIFIC LLC,OSCH_CHILD_SNACK_PM,22,5,0,5,10,31,0,31,62,2.8182
SAN DIEGO,Nov 2015,CACF,2016,ATC PACIFIC LLC,CHILD_BREAKFAST,18,9,2,11,22,117,26,142,285,15.8333
SAN DIEGO,Nov 2015,CACF,2016,ATC PACIFIC LLC,CHILD_LUNCH,18,9,2,11,22,144,32,175,351,19.5
SAN DIEGO,Nov 2015,CACF,2016,ATC PACIFIC LLC,CHILD_SNACK_PM,18,9,2,11,22,144,32,175,351,19.5
SAN DIEGO,Nov 2015,CACF,2016,ATC PACIFIC LLC,OSCH_CHILD_BREAKFAST,18,5,0,5,10,49,0,49,98,5.4444
SAN DIEGO,Nov 2015,CACF,2016,ATC PACIFIC LLC,OSCH_CHILD_LUNCH,18,5,0,5,10,7,0,6,13,0.7222
SAN DIEGO,Nov 2015,CACF,2016,ATC PACIFIC LLC,OSCH_CHILD_SNACK_PM,18,5,0,5,10,19,0,19,38,2.1111
SAN DIEGO,Dec 2015,CACF,2016,ATC PACIFIC LLC,CHILD_BREAKFAST,20,9,2,11,22,140,31,171,342,17.1
SAN DIEGO,Dec 2015,CACF,2016,ATC PACIFIC LLC,CHILD_LUNCH,20,9,2,11,22,159,35,194,388,19.4
SAN DIEGO,Dec 2015,CACF,2016,ATC PACIFIC LLC,CHILD_SNACK_PM,20,9,2,11,22,160,36,196,392,19.6
SAN DIEGO,Dec 2015,CACF,2016,ATC PACIFIC LLC,OSCH_CHILD_BREAKFAST,20,5,0,5,10,46,0,45,91,4.55
SAN DIEGO,Dec 2015,CACF,2016,ATC PACIFIC LLC,OSCH_CHILD_LUNCH,20,5,0,5,10,7,0,7,14,0.7
SAN DIEGO,Dec 2015,CACF,2016,ATC PACIFIC LLC,OSCH_CHILD_SNACK_PM,20,5,0,5,10,29,0,29,58,2.9
SAN DIEGO,Jan 2016,CACF,2016,ATC PACIFIC LLC,CHILD_BREAKFAST,19,9,2,11,22,134,30,163,327,17.2105
SAN DIEGO,Jan 2016,CACF,2016,ATC PACIFIC LLC,CHILD_LUNCH,19,9,2,11,22,157,35,191,383,20.1579
SAN DIEGO,Jan 2016,CACF,2016,ATC PACIFIC LLC,CHILD_SNACK_PM,19,9,2,11,22,151,34,185,370,19.4737
SAN DIEGO,Jan 2016,CACF,2016,ATC PACIFIC LLC,OSCH_CHILD_BREAKFAST,19,5,0,5,10,43,0,42,85,4.4737
SAN DIEGO,Jan 2016,CACF,2016,ATC PACIFIC LLC,OSCH_CHILD_SNACK_PM,19,5,0,5,10,16,0,16,32,1.6842
SAN DIEGO,Feb 2016,CACF,2016,ATC PACIFIC LLC,CHILD_BREAKFAST,20,11,2,12,25,156,28,171,355,17.75
SAN DIEGO,Feb 2016,CACF,2016,ATC PACIFIC LLC,CHILD_LUNCH,20,11,2,12,25,191,35,207,433,21.65
SAN DIEGO,Feb 2016,CACF,2016,ATC PACIFIC LLC,CHILD_SNACK_PM,20,11,2,12,25,183,33,201,417,20.85
SAN DIEGO,Feb 2016,CACF,2016,ATC PACIFIC LLC,OSCH_CHILD_BREAKFAST,20,4,0,5,9,32,0,41,73,3.65
SAN DIEGO,Feb 2016,CACF,2016,ATC PACIFIC LLC,OSCH_CHILD_SNACK_PM,20,4,0,5,9,16,0,20,36,1.8
SAN DIEGO,Mar 2016,CACF,2016,ATC PACIFIC LLC,CHILD_BREAKFAST,23,14,0,14,28,221,0,220,441,19.1739
SAN DIEGO,Mar 2016,CACF,2016,ATC PACIFIC LLC,CHILD_LUNCH,23,14,0,14,28,261,0,260,521,22.6522
SAN DIEGO,Mar 2016,CACF,2016,ATC PACIFIC LLC,CHILD_SNACK_PM,23,14,0,14,28,257,0,256,513,22.3043
SAN DIEGO,Mar 2016,CACF,2016,ATC PACIFIC LLC,OSCH_CHILD_BREAKFAST,23,4,0,6,10,34,0,50,84,3.6522
SAN DIEGO,Mar 2016,CACF,2016,ATC PACIFIC LLC,OSCH_CHILD_LUNCH,23,4,0,6,10,8,0,11,19,0.8261
SAN DIEGO,Mar 2016,CACF,2016,ATC PACIFIC LLC,OSCH_CHILD_SNACK_PM,23,4,0,6,10,16,0,24,40,1.7391
SAN DIEGO,Apr 2016,CACF,2016,ATC PACIFIC LLC,CHILD_BREAKFAST,21,12,0,13,25,172,0,186,358,17.0476
SAN DIEGO,Apr 2016,CACF,2016,ATC PACIFIC LLC,CHILD_LUNCH,21,12,0,13,25,212,0,229,441,21
SAN DIEGO,Apr 2016,CACF,2016,ATC PACIFIC LLC,CHILD_SNACK_PM,21,12,0,13,25,187,0,203,390,18.5714
SAN DIEGO,Apr 2016,CACF,2016,ATC PACIFIC LLC,OSCH_CHILD_BREAKFAST,21,3,0,6,9,26,0,51,77,3.6667
SAN DIEGO,Apr 2016,CACF,2016,ATC PACIFIC LLC,OSCH_CHILD_LUNCH,21,3,0,6,9,16,0,31,47,2.2381
SAN DIEGO,May 2016,CACF,2016,ATC PACIFIC LLC,CHILD_BREAKFAST,21,26,4,14,44,327,50,176,553,26.3333
SAN DIEGO,May 2016,CACF,2016,ATC PACIFIC LLC,CHILD_LUNCH,21,26,4,14,44,367,56,198,621,29.5714
SAN DIEGO,May 2016,CACF,2016,ATC PACIFIC LLC,CHILD_SNACK_PM,21,26,4,14,44,354,54,191,599,28.5238
SAN DIEGO,May 2016,CACF,2016,ATC PACIFIC LLC,OSCH_CHILD_BREAKFAST,21,3,0,6,9,43,0,85,128,6.0952
SAN DIEGO,May 2016,CACF,2016,ATC PACIFIC LLC,OSCH_CHILD_LUNCH,21,3,0,6,9,42,0,83,125,5.9524
SAN DIEGO,Jun 2016,CACF,2016,ATC PACIFIC LLC,CHILD_BREAKFAST,19,23,0,13,36,240,0,135,375,19.7368
SAN DIEGO,Jun 2016,CACF,2016,ATC PACIFIC LLC,CHILD_LUNCH,19,23,0,13,36,299,0,169,468,24.6316
SAN DIEGO,Jun 2016,CACF,2016,ATC PACIFIC LLC,CHILD_SNACK_PM,19,23,0,13,36,274,0,155,429,22.5789
SAN DIEGO,Jun 2016,CACF,2016,ATC PACIFIC LLC,OSCH_CHILD_BREAKFAST,19,4,0,3,7,43,0,32,75,3.9474
SAN DIEGO,Jun 2016,CACF,2016,ATC PACIFIC LLC,OSCH_CHILD_LUNCH,19,4,0,3,7,19,0,14,33,1.7368
SAN DIEGO,Jun 2016,CACF,2016,ATC PACIFIC LLC,OSCH_CHILD_SNACK_PM,19,4,0,3,7,35,0,26,61,3.2105
SAN DIEGO,Oct 2015,CACF,2016,Boys & Girls Club of Greater San Diego,CHILD_BREAKFAST,22,44,8,1,53,656,119,15,790,35.9091
SAN DIEGO,Oct 2015,CACF,2016,Boys & Girls Club of Greater San Diego,CHILD_LUNCH,22,44,8,1,53,786,143,18,947,43.0455
SAN DIEGO,Oct 2015,CACF,2016,Boys & Girls Club of Greater San Diego,CHILD_SNACK_PM,22,44,8,1,53,723,131,17,871,39.5909
SAN DIEGO,Oct 2015,CACF,2016,Boys & Girls Club of Greater San Diego,OSCH_CHILD_BREAKFAST,22,33,3,3,39,25,2,3,30,1.3636
SAN DIEGO,Oct 2015,CACF,2016,Boys & Girls Club of Greater San Diego,OSCH_CHILD_LUNCH,22,33,3,3,39,177,16,16,209,9.5
SAN DIEGO,Oct 2015,CACF,2016,Boys & Girls Club of Greater San Diego,OSCH_CHILD_SNACK_PM,22,33,3,3,39,486,44,44,574,26.0909
SAN DIEGO,Nov 2015,CACF,2016,Boys & Girls Club of Greater San Diego,CHILD_BREAKFAST,18,44,8,1,53,570,104,12,686,38.1111
SAN DIEGO,Nov 2015,CACF,2016,Boys & Girls Club of Greater San Diego,CHILD_LUNCH,18,44,8,1,53,658,120,14,792,44
SAN DIEGO,Nov 2015,CACF,2016,Boys & Girls Club of Greater San Diego,CHILD_SNACK_PM,18,44,8,1,53,599,109,13,721,40.0556
SAN DIEGO,Nov 2015,CACF,2016,Boys & Girls Club of Greater San Diego,OSCH_CHILD_BREAKFAST,18,33,3,3,39,52,5,5,62,3.4444
SAN DIEGO,Nov 2015,CACF,2016,Boys & Girls Club of Greater San Diego,OSCH_CHILD_LUNCH,18,33,3,3,39,184,17,16,217,12.0556
SAN DIEGO,Nov 2015,CACF,2016,Boys & Girls Club of Greater San Diego,OSCH_CHILD_SNACK_PM,18,33,3,3,39,407,37,37,481,26.7222
SAN DIEGO,Dec 2015,CACF,2016,Boys & Girls Club of Greater San Diego,CHILD_BREAKFAST,18,44,8,1,53,547,99,13,659,36.6111
SAN DIEGO,Dec 2015,CACF,2016,Boys & Girls Club of Greater San Diego,CHILD_LUNCH,18,44,8,1,53,621,113,14,748,41.5556
SAN DIEGO,Dec 2015,CACF,2016,Boys & Girls Club of Greater San Diego,CHILD_SNACK_PM,18,44,8,1,53,538,98,12,648,36
SAN DIEGO,Dec 2015,CACF,2016,Boys & Girls Club of Greater San Diego,OSCH_CHILD_BREAKFAST,18,33,3,3,39,59,5,6,70,3.8889
SAN DIEGO,Dec 2015,CACF,2016,Boys & Girls Club of Greater San Diego,OSCH_CHILD_LUNCH,18,33,3,3,39,201,18,19,238,13.2222
SAN DIEGO,Dec 2015,CACF,2016,Boys & Girls Club of Greater San Diego,OSCH_CHILD_SNACK_PM,18,33,3,3,39,403,37,36,476,26.4444
SAN DIEGO,Jan 2016,CACF,2016,Boys & Girls Club of Greater San Diego,ATRISK_CHILD_SNACK,19,6159,0,0,6159,23913,0,0,23913,1258.5789
SAN DIEGO,Jan 2016,CACF,2016,Boys & Girls Club of Greater San Diego,CHILD_BREAKFAST,19,44,8,1,53,553,100,13,666,35.0526
SAN DIEGO,Jan 2016,CACF,2016,Boys & Girls Club of Greater San Diego,CHILD_LUNCH,19,44,8,1,53,649,118,15,782,41.1579
SAN DIEGO,Jan 2016,CACF,2016,Boys & Girls Club of Greater San Diego,CHILD_SNACK_PM,19,44,8,1,53,586,107,13,706,37.1579
SAN DIEGO,Jan 2016,CACF,2016,Boys & Girls Club of Greater San Diego,OSCH_CHILD_BREAKFAST,19,33,3,3,39,14,1,2,17,0.8947
SAN DIEGO,Jan 2016,CACF,2016,Boys & Girls Club of Greater San Diego,OSCH_CHILD_LUNCH,19,33,3,3,39,178,16,16,210,11.0526
SAN DIEGO,Jan 2016,CACF,2016,Boys & Girls Club of Greater San Diego,OSCH_CHILD_SNACK_PM,19,33,3,3,39,423,38,39,500,26.3158
SAN DIEGO,Feb 2016,CACF,2016,Boys & Girls Club of Greater San Diego,ATRISK_CHILD_SNACK,21,7209,0,0,7209,25469,0,0,25469,1212.8095
SAN DIEGO,Feb 2016,CACF,2016,Boys & Girls Club of Greater San Diego,CHILD_BREAKFAST,21,44,8,1,53,648,118,15,781,37.1905
SAN DIEGO,Feb 2016,CACF,2016,Boys & Girls Club of Greater San Diego,CHILD_LUNCH,21,44,8,1,53,721,131,16,868,41.3333
SAN DIEGO,Feb 2016,CACF,2016,Boys & Girls Club of Greater San Diego,CHILD_SNACK_PM,21,44,8,1,53,658,120,15,793,37.7619
SAN DIEGO,Feb 2016,CACF,2016,Boys & Girls Club of Greater San Diego,OSCH_CHILD_BREAKFAST,21,33,3,3,39,24,2,2,28,1.3333
SAN DIEGO,Feb 2016,CACF,2016,Boys & Girls Club of Greater San Diego,OSCH_CHILD_LUNCH,21,33,3,3,39,226,21,20,267,12.7143
SAN DIEGO,Feb 2016,CACF,2016,Boys & Girls Club of Greater San Diego,OSCH_CHILD_SNACK_PM,21,33,3,3,39,501,46,45,592,28.1905
SAN DIEGO,Mar 2016,CACF,2016,Boys & Girls Club of Greater San Diego,ATRISK_CHILD_SNACK,23,7208,0,0,7208,26144,0,0,26144,1136.6957
SAN DIEGO,Mar 2016,CACF,2016,Boys & Girls Club of Greater San Diego,CHILD_BREAKFAST,23,44,8,1,53,713,130,16,859,37.3478
SAN DIEGO,Mar 2016,CACF,2016,Boys & Girls Club of Greater San Diego,CHILD_LUNCH,23,44,8,1,53,805,146,19,970,42.1739
SAN DIEGO,Mar 2016,CACF,2016,Boys & Girls Club of Greater San Diego,CHILD_SNACK_PM,23,44,8,1,53,733,133,17,883,38.3913
SAN DIEGO,Mar 2016,CACF,2016,Boys & Girls Club of Greater San Diego,OSCH_CHILD_BREAKFAST,23,33,3,3,39,141,13,13,167,7.2609
SAN DIEGO,Mar 2016,CACF,2016,Boys & Girls Club of Greater San Diego,OSCH_CHILD_LUNCH,23,33,3,3,39,340,31,31,402,17.4783
SAN DIEGO,Mar 2016,CACF,2016,Boys & Girls Club of Greater San Diego,OSCH_CHILD_SNACK_PM,23,33,3,3,39,510,46,47,603,26.2174
SAN DIEGO,Apr 2016,CACF,2016,Boys & Girls Club of Greater San Diego,ATRISK_CHILD_SNACK,21,7172,0,0,7172,27297,0,0,27297,1299.8571
SAN DIEGO,Apr 2016,CACF,2016,Boys & Girls Club of Greater San Diego,CHILD_BREAKFAST,21,44,8,1,53,661,120,15,796,37.9048
SAN DIEGO,Apr 2016,CACF,2016,Boys & Girls Club of Greater San Diego,CHILD_LUNCH,21,44,8,1,53,737,134,17,888,42.2857
SAN DIEGO,Apr 2016,CACF,2016,Boys & Girls Club of Greater San Diego,CHILD_SNACK_PM,21,44,8,1,53,666,121,15,802,38.1905
SAN DIEGO,Apr 2016,CACF,2016,Boys & Girls Club of Greater San Diego,OSCH_CHILD_BREAKFAST,21,33,3,3,39,16,1,2,19,0.9048
SAN DIEGO,Apr 2016,CACF,2016,Boys & Girls Club of Greater San Diego,OSCH_CHILD_LUNCH,21,33,3,3,39,264,24,24,312,14.8571
SAN DIEGO,Apr 2016,CACF,2016,Boys & Girls Club of Greater San Diego,OSCH_CHILD_SNACK_PM,21,33,3,3,39,523,48,47,618,29.4286
SAN DIEGO,May 2016,CACF,2016,Boys & Girls Club of Greater San Diego,ATRISK_CHILD_SNACK,21,7208,0,0,7208,29110,0,0,29110,1386.1905
SAN DIEGO,May 2016,CACF,2016,Boys & Girls Club of Greater San Diego,CHILD_BREAKFAST,21,44,8,1,53,597,108,14,719,34.2381
SAN DIEGO,May 2016,CACF,2016,Boys & Girls Club of Greater San Diego,CHILD_LUNCH,21,44,8,1,53,707,128,16,851,40.5238
SAN DIEGO,May 2016,CACF,2016,Boys & Girls Club of Greater San Diego,CHILD_SNACK_PM,21,44,8,1,53,623,113,14,750,35.7143
SAN DIEGO,May 2016,CACF,2016,Boys & Girls Club of Greater San Diego,OSCH_CHILD_LUNCH,21,33,3,3,39,241,22,22,285,13.5714
SAN DIEGO,May 2016,CACF,2016,Boys & Girls Club of Greater San Diego,OSCH_CHILD_SNACK_PM,21,33,3,3,39,509,46,46,601,28.619
SAN DIEGO,Jun 2016,CACF,2016,Boys & Girls Club of Greater San Diego,ATRISK_CHILD_SNACK,21,7208,0,0,7208,9859,0,0,9859,469.4762
SAN DIEGO,Jun 2016,CACF,2016,Boys & Girls Club of Greater San Diego,CHILD_BREAKFAST,22,44,8,1,53,630,115,14,759,34.5
SAN DIEGO,Jun 2016,CACF,2016,Boys & Girls Club of Greater San Diego,CHILD_LUNCH,22,44,8,1,53,775,141,18,934,42.4545
SAN DIEGO,Jun 2016,CACF,2016,Boys & Girls Club of Greater San Diego,CHILD_SNACK_PM,22,44,8,1,53,707,128,16,851,38.6818
SAN DIEGO,Jun 2016,CACF,2016,Boys & Girls Club of Greater San Diego,OSCH_CHILD_BREAKFAST,22,33,3,3,39,289,26,27,342,15.5455
SAN DIEGO,Jun 2016,CACF,2016,Boys & Girls Club of Greater San Diego,OSCH_CHILD_LUNCH,22,33,3,3,39,469,43,42,554,25.1818
SAN DIEGO,Jun 2016,CACF,2016,Boys & Girls Club of Greater San Diego,OSCH_CHILD_SNACK_PM,22,33,3,3,39,496,45,45,586,26.6364
SAN DIEGO,Jul 2016,CACF,2016,Boys & Girls Club of Greater San Diego,CHILD_BREAKFAST,20,44,8,1,53,401,73,9,483,24.15
SAN DIEGO,Jul 2016,CACF,2016,Boys & Girls Club of Greater San Diego,CHILD_LUNCH,20,44,8,1,53,488,89,11,588,29.4
SAN DIEGO,Jul 2016,CACF,2016,Boys & Girls Club of Greater San Diego,CHILD_SNACK_PM,20,44,8,1,53,440,80,10,530,26.5
SAN DIEGO,Jul 2016,CACF,2016,Boys & Girls Club of Greater San Diego,OSCH_CHILD_BREAKFAST,20,33,3,3,39,491,45,44,580,29
SAN DIEGO,Jul 2016,CACF,2016,Boys & Girls Club of Greater San Diego,OSCH_CHILD_LUNCH,20,33,3,3,39,635,58,58,751,37.55
SAN DIEGO,Jul 2016,CACF,2016,Boys & Girls Club of Greater San Diego,OSCH_CHILD_SNACK_PM,20,33,3,3,39,556,51,50,657,32.85
SAN DIEGO,Oct 2015,CACF,2016,BOYS & GIRLS CLUB OF IMPERIAL BEACH ,ATRISK_CHILD_SNACK,22,150,0,0,150,1199,0,0,1199,54.5
SAN DIEGO,Dec 2015,CACF,2016,BOYS & GIRLS CLUB OF IMPERIAL BEACH ,ATRISK_CHILD_SNACK,14,150,0,0,150,501,0,0,501,35.7857
SAN DIEGO,Jan 2016,CACF,2016,BOYS & GIRLS CLUB OF IMPERIAL BEACH ,ATRISK_CHILD_SNACK,20,150,0,0,150,789,0,0,789,39.45
SAN DIEGO,Oct 2015,CACF,2016,"BOYS & GIRLS CLUBS OF OCEANSIDE, CALIFORNIA, INCORPORATED",ATRISK_CHILD_SNACK,22,144,0,0,144,1367,0,0,1367,62.1364
SAN DIEGO,Oct 2015,CACF,2016,"BOYS & GIRLS CLUBS OF OCEANSIDE, CALIFORNIA, INCORPORATED",ATRISK_CHILD_SUPPER,22,144,0,0,144,858,0,0,858,39
SAN DIEGO,Nov 2015,CACF,2016,"BOYS & GIRLS CLUBS OF OCEANSIDE, CALIFORNIA, INCORPORATED",ATRISK_CHILD_SNACK,18,1446,0,0,1446,1302,0,0,1302,72.3333
SAN DIEGO,Nov 2015,CACF,2016,"BOYS & GIRLS CLUBS OF OCEANSIDE, CALIFORNIA, INCORPORATED",ATRISK_CHILD_SUPPER,18,1446,0,0,1446,1150,0,0,1150,63.8889
SAN DIEGO,Dec 2015,CACF,2016,"BOYS & GIRLS CLUBS OF OCEANSIDE, CALIFORNIA, INCORPORATED",ATRISK_CHILD_SNACK,20,1698,0,0,1698,865,0,0,865,43.25
SAN DIEGO,Dec 2015,CACF,2016,"BOYS & GIRLS CLUBS OF OCEANSIDE, CALIFORNIA, INCORPORATED",ATRISK_CHILD_SUPPER,20,1698,0,0,1698,1270,0,0,1270,63.5
SAN DIEGO,Jan 2016,CACF,2016,"BOYS & GIRLS CLUBS OF OCEANSIDE, CALIFORNIA, INCORPORATED",ATRISK_CHILD_SNACK,20,144,0,0,144,1349,0,0,1349,67.45
SAN DIEGO,Jan 2016,CACF,2016,"BOYS & GIRLS CLUBS OF OCEANSIDE, CALIFORNIA, INCORPORATED",ATRISK_CHILD_SUPPER,20,144,0,0,144,656,0,0,656,32.8
SAN DIEGO,Feb 2016,CACF,2016,"BOYS & GIRLS CLUBS OF OCEANSIDE, CALIFORNIA, INCORPORATED",ATRISK_CHILD_SNACK,20,1435,0,0,1435,918,0,0,918,45.9
SAN DIEGO,Feb 2016,CACF,2016,"BOYS & GIRLS CLUBS OF OCEANSIDE, CALIFORNIA, INCORPORATED",ATRISK_CHILD_SUPPER,20,1435,0,0,1435,1418,0,0,1418,70.9
SAN DIEGO,Mar 2016,CACF,2016,"BOYS & GIRLS CLUBS OF OCEANSIDE, CALIFORNIA, INCORPORATED",ATRISK_CHILD_SNACK,23,151,0,0,151,965,0,0,965,41.9565
SAN DIEGO,Mar 2016,CACF,2016,"BOYS & GIRLS CLUBS OF OCEANSIDE, CALIFORNIA, INCORPORATED",ATRISK_CHILD_SUPPER,23,151,0,0,151,1395,0,0,1395,60.6522
SAN DIEGO,Apr 2016,CACF,2016,"BOYS & GIRLS CLUBS OF OCEANSIDE, CALIFORNIA, INCORPORATED",ATRISK_CHILD_SNACK,21,1146,0,0,1146,942,0,0,942,44.8571
SAN DIEGO,Apr 2016,CACF,2016,"BOYS & GIRLS CLUBS OF OCEANSIDE, CALIFORNIA, INCORPORATED",ATRISK_CHILD_SUPPER,21,1146,0,0,1146,1281,0,0,1281,61
SAN DIEGO,May 2016,CACF,2016,"BOYS & GIRLS CLUBS OF OCEANSIDE, CALIFORNIA, INCORPORATED",ATRISK_CHILD_SNACK,21,62,0,0,62,513,0,0,513,24.4286
SAN DIEGO,May 2016,CACF,2016,"BOYS & GIRLS CLUBS OF OCEANSIDE, CALIFORNIA, INCORPORATED",ATRISK_CHILD_SUPPER,21,62,0,0,62,1118,0,0,1118,53.2381
SAN DIEGO,Jun 2016,CACF,2016,"BOYS & GIRLS CLUBS OF OCEANSIDE, CALIFORNIA, INCORPORATED",ATRISK_CHILD_SNACK,2,58,0,0,58,97,0,0,97,48.5
SAN DIEGO,Jun 2016,CACF,2016,"BOYS & GIRLS CLUBS OF OCEANSIDE, CALIFORNIA, INCORPORATED",ATRISK_CHILD_SUPPER,2,58,0,0,58,51,0,0,51,25.5
SAN DIEGO,Oct 2015,CACF,2016,BOYS CLUB OF FALLBROOK,ATRISK_CHILD_SUPPER,15,196,0,0,196,1799,0,0,1799,119.9333
SAN DIEGO,Nov 2015,CACF,2016,BOYS CLUB OF FALLBROOK,ATRISK_CHILD_SNACK,19,319,0,0,319,148,0,0,148,7.7895
SAN DIEGO,Nov 2015,CACF,2016,BOYS CLUB OF FALLBROOK,ATRISK_CHILD_SUPPER,19,319,0,0,319,2075,0,0,2075,109.2105
SAN DIEGO,Dec 2015,CACF,2016,BOYS CLUB OF FALLBROOK,ATRISK_CHILD_SUPPER,14,171,0,0,171,1566,0,0,1566,111.8571
SAN DIEGO,Jan 2016,CACF,2016,BOYS CLUB OF FALLBROOK,ATRISK_CHILD_SUPPER,19,168,0,0,168,2090,0,0,2090,110
SAN DIEGO,Feb 2016,CACF,2016,BOYS CLUB OF FALLBROOK,ATRISK_CHILD_SNACK,21,180,0,0,180,230,0,0,230,10.9524
SAN DIEGO,Feb 2016,CACF,2016,BOYS CLUB OF FALLBROOK,ATRISK_CHILD_SUPPER,21,180,0,0,180,1925,0,0,1925,91.6667
SAN DIEGO,Mar 2016,CACF,2016,BOYS CLUB OF FALLBROOK,ATRISK_CHILD_SNACK,23,160,0,0,160,100,0,0,100,4.3478
SAN DIEGO,Mar 2016,CACF,2016,BOYS CLUB OF FALLBROOK,ATRISK_CHILD_SUPPER,23,160,0,0,160,2197,0,0,2197,95.5217
SAN DIEGO,Apr 2016,CACF,2016,BOYS CLUB OF FALLBROOK,ATRISK_CHILD_SNACK,21,175,0,0,175,14,0,0,14,0.6667
SAN DIEGO,Apr 2016,CACF,2016,BOYS CLUB OF FALLBROOK,ATRISK_CHILD_SUPPER,21,175,0,0,175,2301,0,0,2301,109.5714
SAN DIEGO,May 2016,CACF,2016,BOYS CLUB OF FALLBROOK,ATRISK_CHILD_SUPPER,21,245,0,0,245,2383,0,0,2383,113.4762
SAN DIEGO,Jun 2016,CACF,2016,BOYS CLUB OF FALLBROOK,ATRISK_CHILD_SUPPER,3,162,0,0,162,306,0,0,306,102
SAN DIEGO,Oct 2015,CACF,2016,CA RELIABLE MEDICAL SYSTEMS INC ,ADULT_BREAKFAST,31,469,0,0,469,5614,0,0,5614,181.0968
SAN DIEGO,Oct 2015,CACF,2016,CA RELIABLE MEDICAL SYSTEMS INC ,ADULT_LUNCH,31,469,0,0,469,5614,0,0,5614,181.0968
SAN DIEGO,Oct 2015,CACF,2016,CA RELIABLE MEDICAL SYSTEMS INC ,ADULT_SNACK_AM,31,469,0,0,469,5614,0,0,5614,181.0968
SAN DIEGO,Nov 2015,CACF,2016,CA RELIABLE MEDICAL SYSTEMS INC ,ADULT_BREAKFAST,30,469,0,0,469,5488,0,0,5488,182.9333
SAN DIEGO,Nov 2015,CACF,2016,CA RELIABLE MEDICAL SYSTEMS INC ,ADULT_LUNCH,30,469,0,0,469,5488,0,0,5488,182.9333
SAN DIEGO,Nov 2015,CACF,2016,CA RELIABLE MEDICAL SYSTEMS INC ,ADULT_SNACK_AM,30,469,0,0,469,5488,0,0,5488,182.9333
SAN DIEGO,Dec 2015,CACF,2016,CA RELIABLE MEDICAL SYSTEMS INC ,ADULT_BREAKFAST,31,469,0,0,469,5522,0,0,5522,178.129
SAN DIEGO,Dec 2015,CACF,2016,CA RELIABLE MEDICAL SYSTEMS INC ,ADULT_LUNCH,31,469,0,0,469,5522,0,0,5522,178.129
SAN DIEGO,Dec 2015,CACF,2016,CA RELIABLE MEDICAL SYSTEMS INC ,ADULT_SNACK_AM,31,469,0,0,469,5522,0,0,5522,178.129
SAN DIEGO,Jan 2016,CACF,2016,CA RELIABLE MEDICAL SYSTEMS INC ,ADULT_BREAKFAST,31,469,0,0,469,5368,0,0,5368,173.1613
SAN DIEGO,Jan 2016,CACF,2016,CA RELIABLE MEDICAL SYSTEMS INC ,ADULT_LUNCH,31,469,0,0,469,5368,0,0,5368,173.1613
SAN DIEGO,Jan 2016,CACF,2016,CA RELIABLE MEDICAL SYSTEMS INC ,ADULT_SNACK_AM,31,469,0,0,469,5368,0,0,5368,173.1613
SAN DIEGO,Feb 2016,CACF,2016,CA RELIABLE MEDICAL SYSTEMS INC ,ADULT_BREAKFAST,29,469,0,0,469,5320,0,0,5320,183.4483
SAN DIEGO,Feb 2016,CACF,2016,CA RELIABLE MEDICAL SYSTEMS INC ,ADULT_LUNCH,29,469,0,0,469,5320,0,0,5320,183.4483
SAN DIEGO,Feb 2016,CACF,2016,CA RELIABLE MEDICAL SYSTEMS INC ,ADULT_SNACK_AM,29,469,0,0,469,5320,0,0,5320,183.4483
SAN DIEGO,Mar 2016,CACF,2016,CA RELIABLE MEDICAL SYSTEMS INC ,ADULT_BREAKFAST,30,469,0,0,469,5541,0,0,5541,184.7
SAN DIEGO,Mar 2016,CACF,2016,CA RELIABLE MEDICAL SYSTEMS INC ,ADULT_LUNCH,30,469,0,0,469,5541,0,0,5541,184.7
SAN DIEGO,Mar 2016,CACF,2016,CA RELIABLE MEDICAL SYSTEMS INC ,ADULT_SNACK_AM,30,469,0,0,469,5541,0,0,5541,184.7
SAN DIEGO,Apr 2016,CACF,2016,CA RELIABLE MEDICAL SYSTEMS INC ,ADULT_BREAKFAST,30,469,0,0,469,5616,0,0,5616,187.2
SAN DIEGO,Apr 2016,CACF,2016,CA RELIABLE MEDICAL SYSTEMS INC ,ADULT_LUNCH,30,469,0,0,469,5616,0,0,5616,187.2
SAN DIEGO,Apr 2016,CACF,2016,CA RELIABLE MEDICAL SYSTEMS INC ,ADULT_SNACK_AM,30,469,0,0,469,5616,0,0,5616,187.2
SAN DIEGO,May 2016,CACF,2016,CA RELIABLE MEDICAL SYSTEMS INC ,ADULT_BREAKFAST,31,469,0,0,469,5895,0,0,5895,190.1613
SAN DIEGO,May 2016,CACF,2016,CA RELIABLE MEDICAL SYSTEMS INC ,ADULT_LUNCH,31,469,0,0,469,5895,0,0,5895,190.1613
SAN DIEGO,May 2016,CACF,2016,CA RELIABLE MEDICAL SYSTEMS INC ,ADULT_SNACK_AM,31,469,0,0,469,5895,0,0,5895,190.1613
SAN DIEGO,Jun 2016,CACF,2016,CA RELIABLE MEDICAL SYSTEMS INC ,ADULT_BREAKFAST,30,469,0,0,469,5704,0,0,5704,190.1333
SAN DIEGO,Jun 2016,CACF,2016,CA RELIABLE MEDICAL SYSTEMS INC ,ADULT_LUNCH,30,469,0,0,469,5704,0,0,5704,190.1333
SAN DIEGO,Jun 2016,CACF,2016,CA RELIABLE MEDICAL SYSTEMS INC ,ADULT_SNACK_AM,30,469,0,0,469,5704,0,0,5704,190.1333
SAN DIEGO,Jul 2016,CACF,2016,CA RELIABLE MEDICAL SYSTEMS INC ,ADULT_BREAKFAST,31,469,0,0,469,5831,0,0,5831,188.0968
SAN DIEGO,Jul 2016,CACF,2016,CA RELIABLE MEDICAL SYSTEMS INC ,ADULT_LUNCH,31,469,0,0,469,5831,0,0,5831,188.0968
SAN DIEGO,Jul 2016,CACF,2016,CA RELIABLE MEDICAL SYSTEMS INC ,ADULT_SNACK_AM,31,469,0,0,469,5831,0,0,5831,188.0968
SAN DIEGO,Oct 2015,CACF,2016,CASA DE AMPARO,HS_CHILD_BREAKFAST,21,27,0,0,27,351,0,0,351,16.7143
SAN DIEGO,Oct 2015,CACF,2016,CASA DE AMPARO,HS_CHILD_LUNCH,21,27,0,0,27,415,0,0,415,19.7619
SAN DIEGO,Oct 2015,CACF,2016,CASA DE AMPARO,HS_CHILD_SNACK_PM,21,27,0,0,27,225,0,0,225,10.7143
SAN DIEGO,Nov 2015,CACF,2016,CASA DE AMPARO,CHILD_BREAKFAST,19,1,0,0,1,3,0,0,3,0.1579
SAN DIEGO,Nov 2015,CACF,2016,CASA DE AMPARO,CHILD_LUNCH,19,1,0,0,1,15,0,0,15,0.7895
SAN DIEGO,Nov 2015,CACF,2016,CASA DE AMPARO,CHILD_SNACK_PM,19,1,0,0,1,8,0,0,8,0.4211
SAN DIEGO,Nov 2015,CACF,2016,CASA DE AMPARO,HS_CHILD_BREAKFAST,19,25,0,0,25,318,0,0,318,16.7368
SAN DIEGO,Nov 2015,CACF,2016,CASA DE AMPARO,HS_CHILD_LUNCH,19,25,0,0,25,400,0,0,400,21.0526
SAN DIEGO,Nov 2015,CACF,2016,CASA DE AMPARO,HS_CHILD_SNACK_PM,19,25,0,0,25,233,0,0,233,12.2632
SAN DIEGO,Dec 2015,CACF,2016,CASA DE AMPARO,CHILD_BREAKFAST,15,1,0,0,1,2,0,0,2,0.1333
SAN DIEGO,Dec 2015,CACF,2016,CASA DE AMPARO,CHILD_LUNCH,15,1,0,0,1,14,0,0,14,0.9333
SAN DIEGO,Dec 2015,CACF,2016,CASA DE AMPARO,CHILD_SNACK_PM,15,1,0,0,1,9,0,0,9,0.6
SAN DIEGO,Dec 2015,CACF,2016,CASA DE AMPARO,HS_CHILD_BREAKFAST,20,25,0,0,25,256,0,0,256,12.8
SAN DIEGO,Dec 2015,CACF,2016,CASA DE AMPARO,HS_CHILD_LUNCH,20,25,0,0,25,358,0,0,358,17.9
SAN DIEGO,Dec 2015,CACF,2016,CASA DE AMPARO,HS_CHILD_SNACK_PM,20,25,0,0,25,236,0,0,236,11.8
SAN DIEGO,Jan 2016,CACF,2016,CASA DE AMPARO,CHILD_BREAKFAST,16,1,0,0,1,3,0,0,3,0.1875
SAN DIEGO,Jan 2016,CACF,2016,CASA DE AMPARO,CHILD_LUNCH,16,1,0,0,1,15,0,0,15,0.9375
SAN DIEGO,Jan 2016,CACF,2016,CASA DE AMPARO,CHILD_SNACK_PM,16,1,0,0,1,12,0,0,12,0.75
SAN DIEGO,Jan 2016,CACF,2016,CASA DE AMPARO,HS_CHILD_BREAKFAST,18,21,0,0,21,187,0,0,187,10.3889
SAN DIEGO,Jan 2016,CACF,2016,CASA DE AMPARO,HS_CHILD_LUNCH,18,21,0,0,21,305,0,0,305,16.9444
SAN DIEGO,Jan 2016,CACF,2016,CASA DE AMPARO,HS_CHILD_SNACK_PM,18,21,0,0,21,219,0,0,219,12.1667
SAN DIEGO,Feb 2016,CACF,2016,CASA DE AMPARO,CHILD_LUNCH,20,1,0,0,1,16,0,0,16,0.8
SAN DIEGO,Feb 2016,CACF,2016,CASA DE AMPARO,CHILD_SNACK_PM,20,1,0,0,1,10,0,0,10,0.5
SAN DIEGO,Feb 2016,CACF,2016,CASA DE AMPARO,HS_CHILD_BREAKFAST,20,24,0,0,24,264,0,0,264,13.2
SAN DIEGO,Feb 2016,CACF,2016,CASA DE AMPARO,HS_CHILD_LUNCH,20,24,0,0,24,391,0,0,391,19.55
SAN DIEGO,Feb 2016,CACF,2016,CASA DE AMPARO,HS_CHILD_SNACK_PM,20,24,0,0,24,264,0,0,264,13.2
SAN DIEGO,Mar 2016,CACF,2016,CASA DE AMPARO,CHILD_BREAKFAST,12,1,0,0,1,2,0,0,2,0.1667
SAN DIEGO,Mar 2016,CACF,2016,CASA DE AMPARO,CHILD_LUNCH,12,1,0,0,1,12,0,0,12,1
SAN DIEGO,Mar 2016,CACF,2016,CASA DE AMPARO,CHILD_SNACK_PM,12,1,0,0,1,5,0,0,5,0.4167
SAN DIEGO,Mar 2016,CACF,2016,CASA DE AMPARO,HS_CHILD_BREAKFAST,22,25,0,0,25,300,0,0,300,13.6364
SAN DIEGO,Mar 2016,CACF,2016,CASA DE AMPARO,HS_CHILD_LUNCH,22,25,0,0,25,447,0,0,447,20.3182
SAN DIEGO,Mar 2016,CACF,2016,CASA DE AMPARO,HS_CHILD_SNACK_PM,22,25,0,0,25,287,0,0,287,13.0455
SAN DIEGO,Apr 2016,CACF,2016,CASA DE AMPARO,CHILD_BREAKFAST,12,1,0,0,1,8,0,0,8,0.6667
SAN DIEGO,Apr 2016,CACF,2016,CASA DE AMPARO,CHILD_LUNCH,12,1,0,0,1,12,0,0,12,1
SAN DIEGO,Apr 2016,CACF,2016,CASA DE AMPARO,CHILD_SNACK_PM,12,1,0,0,1,7,0,0,7,0.5833
SAN DIEGO,Apr 2016,CACF,2016,CASA DE AMPARO,HS_CHILD_BREAKFAST,21,23,0,0,23,284,0,0,284,13.5238
SAN DIEGO,Apr 2016,CACF,2016,CASA DE AMPARO,HS_CHILD_LUNCH,21,23,0,0,23,396,0,0,396,18.8571
SAN DIEGO,Apr 2016,CACF,2016,CASA DE AMPARO,HS_CHILD_SNACK_PM,21,23,0,0,23,296,0,0,296,14.0952
SAN DIEGO,May 2016,CACF,2016,CASA DE AMPARO,CHILD_BREAKFAST,12,1,0,0,1,10,0,0,10,0.8333
SAN DIEGO,May 2016,CACF,2016,CASA DE AMPARO,CHILD_LUNCH,12,1,0,0,1,12,0,0,12,1
SAN DIEGO,May 2016,CACF,2016,CASA DE AMPARO,CHILD_SNACK_PM,12,1,0,0,1,10,0,0,10,0.8333
SAN DIEGO,May 2016,CACF,2016,CASA DE AMPARO,HS_CHILD_BREAKFAST,22,20,0,0,20,230,0,0,230,10.4545
SAN DIEGO,May 2016,CACF,2016,CASA DE AMPARO,HS_CHILD_LUNCH,22,20,0,0,20,284,0,0,284,12.9091
SAN DIEGO,May 2016,CACF,2016,CASA DE AMPARO,HS_CHILD_SNACK_PM,22,20,0,0,20,234,0,0,234,10.6364
SAN DIEGO,Jun 2016,CACF,2016,CASA DE AMPARO,CHILD_BREAKFAST,18,1,0,0,1,15,0,0,15,0.8333
SAN DIEGO,Jun 2016,CACF,2016,CASA DE AMPARO,CHILD_LUNCH,18,1,0,0,1,17,0,0,17,0.9444
SAN DIEGO,Jun 2016,CACF,2016,CASA DE AMPARO,CHILD_SNACK_PM,18,1,0,0,1,10,0,0,10,0.5556
SAN DIEGO,Jun 2016,CACF,2016,CASA DE AMPARO,HS_CHILD_BREAKFAST,22,19,0,0,19,231,0,0,231,10.5
SAN DIEGO,Jun 2016,CACF,2016,CASA DE AMPARO,HS_CHILD_LUNCH,22,19,0,0,19,256,0,0,256,11.6364
SAN DIEGO,Jun 2016,CACF,2016,CASA DE AMPARO,HS_CHILD_SNACK_PM,22,19,0,0,19,205,0,0,205,9.3182
SAN DIEGO,Jul 2016,CACF,2016,CASA DE AMPARO,CHILD_BREAKFAST,14,1,0,0,1,10,0,0,10,0.7143
SAN DIEGO,Jul 2016,CACF,2016,CASA DE AMPARO,CHILD_LUNCH,14,1,0,0,1,14,0,0,14,1
SAN DIEGO,Jul 2016,CACF,2016,CASA DE AMPARO,CHILD_SNACK_PM,14,1,0,0,1,11,0,0,11,0.7857
SAN DIEGO,Jul 2016,CACF,2016,CASA DE AMPARO,HS_CHILD_BREAKFAST,20,15,0,0,15,218,0,0,218,10.9
SAN DIEGO,Jul 2016,CACF,2016,CASA DE AMPARO,HS_CHILD_LUNCH,20,15,0,0,15,234,0,0,234,11.7
SAN DIEGO,Jul 2016,CACF,2016,CASA DE AMPARO,HS_CHILD_SNACK_PM,20,15,0,0,15,198,0,0,198,9.9
SAN DIEGO,Oct 2015,CACF,2016,CENTRO DE SALUD DE LA,ADULT_BREAKFAST,22,180,0,2,182,2669,0,30,2699,122.6818
SAN DIEGO,Oct 2015,CACF,2016,CENTRO DE SALUD DE LA,ADULT_LUNCH,22,180,0,2,182,2748,0,31,2779,126.3182
SAN DIEGO,Nov 2015,CACF,2016,CENTRO DE SALUD DE LA,ADULT_BREAKFAST,19,180,0,2,182,2274,0,25,2299,121
SAN DIEGO,Nov 2015,CACF,2016,CENTRO DE SALUD DE LA,ADULT_LUNCH,19,180,0,2,182,2314,0,26,2340,123.1579
SAN DIEGO,Dec 2015,CACF,2016,CENTRO DE SALUD DE LA,ADULT_BREAKFAST,20,180,0,2,182,2329,0,26,2355,117.75
SAN DIEGO,Dec 2015,CACF,2016,CENTRO DE SALUD DE LA,ADULT_LUNCH,20,180,0,2,182,2368,0,26,2394,119.7
SAN DIEGO,Jan 2016,CACF,2016,CENTRO DE SALUD DE LA,ADULT_BREAKFAST,20,180,0,2,182,2084,0,23,2107,105.35
SAN DIEGO,Jan 2016,CACF,2016,CENTRO DE SALUD DE LA,ADULT_LUNCH,20,180,0,2,182,2108,0,23,2131,106.55
SAN DIEGO,Jan 2016,CACF,2016,CENTRO DE SALUD DE LA,ADULT_SNACK_PM,20,180,0,2,182,511,0,6,517,25.85
SAN DIEGO,Feb 2016,CACF,2016,CENTRO DE SALUD DE LA,ADULT_BREAKFAST,21,180,0,2,182,2259,0,25,2284,108.7619
SAN DIEGO,Feb 2016,CACF,2016,CENTRO DE SALUD DE LA,ADULT_LUNCH,21,180,0,2,182,2298,0,26,2324,110.6667
SAN DIEGO,Feb 2016,CACF,2016,CENTRO DE SALUD DE LA,ADULT_SNACK_PM,21,180,0,2,182,806,0,9,815,38.8095
SAN DIEGO,Mar 2016,CACF,2016,CENTRO DE SALUD DE LA,ADULT_BREAKFAST,23,174,0,3,177,2513,0,43,2556,111.1304
SAN DIEGO,Mar 2016,CACF,2016,CENTRO DE SALUD DE LA,ADULT_LUNCH,23,174,0,3,177,2560,0,44,2604,113.2174
SAN DIEGO,Mar 2016,CACF,2016,CENTRO DE SALUD DE LA,ADULT_SNACK_PM,23,174,0,3,177,845,0,15,860,37.3913
SAN DIEGO,Apr 2016,CACF,2016,CENTRO DE SALUD DE LA,ADULT_BREAKFAST,20,174,0,3,177,2183,0,38,2221,111.05
SAN DIEGO,Apr 2016,CACF,2016,CENTRO DE SALUD DE LA,ADULT_LUNCH,20,174,0,3,177,2203,0,38,2241,112.05
SAN DIEGO,Apr 2016,CACF,2016,CENTRO DE SALUD DE LA,ADULT_SNACK_PM,20,174,0,3,177,778,0,13,791,39.55
SAN DIEGO,May 2016,CACF,2016,CENTRO DE SALUD DE LA,ADULT_BREAKFAST,21,174,0,3,177,2358,0,41,2399,114.2381
SAN DIEGO,May 2016,CACF,2016,CENTRO DE SALUD DE LA,ADULT_LUNCH,21,174,0,3,177,2396,0,41,2437,116.0476
SAN DIEGO,May 2016,CACF,2016,CENTRO DE SALUD DE LA,ADULT_SNACK_PM,21,174,0,3,177,874,0,15,889,42.3333
SAN DIEGO,Jun 2016,CACF,2016,CENTRO DE SALUD DE LA,ADULT_BREAKFAST,22,174,0,3,177,2428,0,42,2470,112.2727
SAN DIEGO,Jun 2016,CACF,2016,CENTRO DE SALUD DE LA,ADULT_LUNCH,22,174,0,3,177,2506,0,43,2549,115.8636
SAN DIEGO,Jun 2016,CACF,2016,CENTRO DE SALUD DE LA,ADULT_SNACK_PM,22,174,0,3,177,860,0,15,875,39.7727
SAN DIEGO,Jul 2016,CACF,2016,CENTRO DE SALUD DE LA,ADULT_BREAKFAST,20,174,0,3,177,1658,0,28,1686,84.3
SAN DIEGO,Jul 2016,CACF,2016,CENTRO DE SALUD DE LA,ADULT_LUNCH,20,174,0,3,177,1750,0,30,1780,89
SAN DIEGO,Jul 2016,CACF,2016,CENTRO DE SALUD DE LA,ADULT_SNACK_PM,20,174,0,3,177,630,0,11,641,32.05
SAN DIEGO,Oct 2015,CACF,2016,CHICANO FEDERATION OF SAN DIEGO COUNTY INC,CHILD_BREAKFAST,22,54,9,2,65,668,111,25,804,36.5455
SAN DIEGO,Oct 2015,CACF,2016,CHICANO FEDERATION OF SAN DIEGO COUNTY INC,CHILD_LUNCH,22,54,9,2,65,854,142,32,1028,46.7273
SAN DIEGO,Oct 2015,CACF,2016,CHICANO FEDERATION OF SAN DIEGO COUNTY INC,CHILD_SNACK_PM,22,54,9,2,65,740,123,28,891,40.5
SAN DIEGO,Oct 2015,DCH,2016,CHICANO FEDERATION OF SAN DIEGO COUNTY INC,DCH_BREAKFAST,22,0,0,0,0,0,0,0,0,0
SAN DIEGO,Oct 2015,DCH,2016,CHICANO FEDERATION OF SAN DIEGO COUNTY INC,DCH_BREAKFAST,27,0,0,0,0,0,0,0,0,0
SAN DIEGO,Oct 2015,DCH,2016,CHICANO FEDERATION OF SAN DIEGO COUNTY INC,DCH_BREAKFAST,24,0,0,0,0,0,0,0,0,0
SAN DIEGO,Oct 2015,DCH,2016,CHICANO FEDERATION OF SAN DIEGO COUNTY INC,DCH_BREAKFAST,,0,0,0,0,0,493,2083,2576,0
SAN DIEGO,Oct 2015,DCH,2016,CHICANO FEDERATION OF SAN DIEGO COUNTY INC,DCH_BREAKFAST,31,0,0,0,0,57957,0,0,57957,1869.5806
SAN DIEGO,Oct 2015,DCH,2016,CHICANO FEDERATION OF SAN DIEGO COUNTY INC,DCH_LUNCH,24,0,0,0,0,0,0,0,0,0
SAN DIEGO,Oct 2015,DCH,2016,CHICANO FEDERATION OF SAN DIEGO COUNTY INC,DCH_LUNCH,31,0,0,0,0,77806,0,0,77806,2509.871
SAN DIEGO,Oct 2015,DCH,2016,CHICANO FEDERATION OF SAN DIEGO COUNTY INC,DCH_LUNCH,27,0,0,0,0,0,0,0,0,0
SAN DIEGO,Oct 2015,DCH,2016,CHICANO FEDERATION OF SAN DIEGO COUNTY INC,DCH_LUNCH,,0,0,0,0,0,1003,4473,5476,0
SAN DIEGO,Oct 2015,DCH,2016,CHICANO FEDERATION OF SAN DIEGO COUNTY INC,DCH_LUNCH,22,0,0,0,0,0,0,0,0,0
SAN DIEGO,Oct 2015,DCH,2016,CHICANO FEDERATION OF SAN DIEGO COUNTY INC,DCH_SNACK_AM,22,0,0,0,0,0,0,0,0,0
SAN DIEGO,Oct 2015,DCH,2016,CHICANO FEDERATION OF SAN DIEGO COUNTY INC,DCH_SNACK_AM,31,0,0,0,0,36673,0,0,36673,1183
SAN DIEGO,Oct 2015,DCH,2016,CHICANO FEDERATION OF SAN DIEGO COUNTY INC,DCH_SNACK_AM,,0,0,0,0,0,656,1682,2338,0
SAN DIEGO,Oct 2015,DCH,2016,CHICANO FEDERATION OF SAN DIEGO COUNTY INC,DCH_SNACK_AM,24,0,0,0,0,0,0,0,0,0
SAN DIEGO,Oct 2015,DCH,2016,CHICANO FEDERATION OF SAN DIEGO COUNTY INC,DCH_SNACK_AM,27,0,0,0,0,0,0,0,0,0
SAN DIEGO,Oct 2015,DCH,2016,CHICANO FEDERATION OF SAN DIEGO COUNTY INC,DCH_SNACK_NT,24,0,0,0,0,0,0,0,0,0
SAN DIEGO,Oct 2015,DCH,2016,CHICANO FEDERATION OF SAN DIEGO COUNTY INC,DCH_SNACK_NT,,0,0,0,0,0,0,69,69,0
SAN DIEGO,Oct 2015,DCH,2016,CHICANO FEDERATION OF SAN DIEGO COUNTY INC,DCH_SNACK_NT,31,0,0,0,0,10457,0,0,10457,337.3226
SAN DIEGO,Oct 2015,DCH,2016,CHICANO FEDERATION OF SAN DIEGO COUNTY INC,DCH_SNACK_NT,22,0,0,0,0,0,0,0,0,0
SAN DIEGO,Oct 2015,DCH,2016,CHICANO FEDERATION OF SAN DIEGO COUNTY INC,DCH_SNACK_NT,27,0,0,0,0,0,0,0,0,0
SAN DIEGO,Oct 2015,DCH,2016,CHICANO FEDERATION OF SAN DIEGO COUNTY INC,DCH_SNACK_PM,27,0,0,0,0,0,0,0,0,0
SAN DIEGO,Oct 2015,DCH,2016,CHICANO FEDERATION OF SAN DIEGO COUNTY INC,DCH_SNACK_PM,22,0,0,0,0,0,0,0,0,0
SAN DIEGO,Oct 2015,DCH,2016,CHICANO FEDERATION OF SAN DIEGO COUNTY INC,DCH_SNACK_PM,24,0,0,0,0,0,0,0,0,0
SAN DIEGO,Oct 2015,DCH,2016,CHICANO FEDERATION OF SAN DIEGO COUNTY INC,DCH_SNACK_PM,,0,0,0,0,0,450,3327,3777,0
SAN DIEGO,Oct 2015,DCH,2016,CHICANO FEDERATION OF SAN DIEGO COUNTY INC,DCH_SNACK_PM,31,0,0,0,0,72229,0,0,72229,2329.9677
SAN DIEGO,Oct 2015,DCH,2016,CHICANO FEDERATION OF SAN DIEGO COUNTY INC,DCH_SUPPER,,0,0,0,0,0,1020,3695,4715,0
SAN DIEGO,Oct 2015,DCH,2016,CHICANO FEDERATION OF SAN DIEGO COUNTY INC,DCH_SUPPER,24,0,0,0,0,0,0,0,0,0
SAN DIEGO,Oct 2015,DCH,2016,CHICANO FEDERATION OF SAN DIEGO COUNTY INC,DCH_SUPPER,27,0,0,0,0,0,0,0,0,0
SAN DIEGO,Oct 2015,DCH,2016,CHICANO FEDERATION OF SAN DIEGO COUNTY INC,DCH_SUPPER,22,0,0,0,0,0,0,0,0,0
SAN DIEGO,Oct 2015,DCH,2016,CHICANO FEDERATION OF SAN DIEGO COUNTY INC,DCH_SUPPER,31,0,0,0,0,89932,0,0,89932,2901.0323
SAN DIEGO,Nov 2015,CACF,2016,CHICANO FEDERATION OF SAN DIEGO COUNTY INC,CHILD_BREAKFAST,18,52,8,3,63,484,74,28,586,32.5556
SAN DIEGO,Nov 2015,CACF,2016,CHICANO FEDERATION OF SAN DIEGO COUNTY INC,CHILD_LUNCH,18,52,8,3,63,623,96,36,755,41.9444
SAN DIEGO,Nov 2015,CACF,2016,CHICANO FEDERATION OF SAN DIEGO COUNTY INC,CHILD_SNACK_PM,18,52,8,3,63,560,86,33,679,37.7222
SAN DIEGO,Nov 2015,DCH,2016,CHICANO FEDERATION OF SAN DIEGO COUNTY INC,DCH_BREAKFAST,19,0,0,0,0,0,0,0,0,0
SAN DIEGO,Nov 2015,DCH,2016,CHICANO FEDERATION OF SAN DIEGO COUNTY INC,DCH_BREAKFAST,22,0,0,0,0,0,0,0,0,0
SAN DIEGO,Nov 2015,DCH,2016,CHICANO FEDERATION OF SAN DIEGO COUNTY INC,DCH_BREAKFAST,20,0,0,0,0,0,0,0,0,0
SAN DIEGO,Nov 2015,DCH,2016,CHICANO FEDERATION OF SAN DIEGO COUNTY INC,DCH_BREAKFAST,28,0,0,0,0,44383,0,0,44383,1585.1071
SAN DIEGO,Nov 2015,DCH,2016,CHICANO FEDERATION OF SAN DIEGO COUNTY INC,DCH_BREAKFAST,,0,0,0,0,0,422,1589,2011,0
SAN DIEGO,Nov 2015,DCH,2016,CHICANO FEDERATION OF SAN DIEGO COUNTY INC,DCH_LUNCH,19,0,0,0,0,0,0,0,0,0
SAN DIEGO,Nov 2015,DCH,2016,CHICANO FEDERATION OF SAN DIEGO COUNTY INC,DCH_LUNCH,22,0,0,0,0,0,0,0,0,0
SAN DIEGO,Nov 2015,DCH,2016,CHICANO FEDERATION OF SAN DIEGO COUNTY INC,DCH_LUNCH,20,0,0,0,0,0,0,0,0,0
SAN DIEGO,Nov 2015,DCH,2016,CHICANO FEDERATION OF SAN DIEGO COUNTY INC,DCH_LUNCH,,0,0,0,0,0,861,3480,4341,0
SAN DIEGO,Nov 2015,DCH,2016,CHICANO FEDERATION OF SAN DIEGO COUNTY INC,DCH_LUNCH,28,0,0,0,0,64152,0,0,64152,2291.1429
SAN DIEGO,Nov 2015,DCH,2016,CHICANO FEDERATION OF SAN DIEGO COUNTY INC,DCH_SNACK_AM,19,0,0,0,0,0,0,0,0,0
SAN DIEGO,Nov 2015,DCH,2016,CHICANO FEDERATION OF SAN DIEGO COUNTY INC,DCH_SNACK_AM,20,0,0,0,0,0,0,0,0,0
SAN DIEGO,Nov 2015,DCH,2016,CHICANO FEDERATION OF SAN DIEGO COUNTY INC,DCH_SNACK_AM,,0,0,0,0,0,496,1358,1854,0
SAN DIEGO,Nov 2015,DCH,2016,CHICANO FEDERATION OF SAN DIEGO COUNTY INC,DCH_SNACK_AM,28,0,0,0,0,30724,0,0,30724,1097.2857
SAN DIEGO,Nov 2015,DCH,2016,CHICANO FEDERATION OF SAN DIEGO COUNTY INC,DCH_SNACK_AM,22,0,0,0,0,0,0,0,0,0
SAN DIEGO,Nov 2015,DCH,2016,CHICANO FEDERATION OF SAN DIEGO COUNTY INC,DCH_SNACK_NT,28,0,0,0,0,8074,0,0,8074,288.3571
SAN DIEGO,Nov 2015,DCH,2016,CHICANO FEDERATION OF SAN DIEGO COUNTY INC,DCH_SNACK_NT,,0,0,0,0,0,0,63,63,0
SAN DIEGO,Nov 2015,DCH,2016,CHICANO FEDERATION OF SAN DIEGO COUNTY INC,DCH_SNACK_NT,22,0,0,0,0,0,0,0,0,0
SAN DIEGO,Nov 2015,DCH,2016,CHICANO FEDERATION OF SAN DIEGO COUNTY INC,DCH_SNACK_NT,19,0,0,0,0,0,0,0,0,0
SAN DIEGO,Nov 2015,DCH,2016,CHICANO FEDERATION OF SAN DIEGO COUNTY INC,DCH_SNACK_NT,20,0,0,0,0,0,0,0,0,0
SAN DIEGO,Nov 2015,DCH,2016,CHICANO FEDERATION OF SAN DIEGO COUNTY INC,DCH_SNACK_PM,,0,0,0,0,0,473,2488,2961,0
SAN DIEGO,Nov 2015,DCH,2016,CHICANO FEDERATION OF SAN DIEGO COUNTY INC,DCH_SNACK_PM,19,0,0,0,0,0,0,0,0,0
SAN DIEGO,Nov 2015,DCH,2016,CHICANO FEDERATION OF SAN DIEGO COUNTY INC,DCH_SNACK_PM,20,0,0,0,0,0,0,0,0,0
SAN DIEGO,Nov 2015,DCH,2016,CHICANO FEDERATION OF SAN DIEGO COUNTY INC,DCH_SNACK_PM,28,0,0,0,0,56026,0,0,56026,2000.9286
SAN DIEGO,Nov 2015,DCH,2016,CHICANO FEDERATION OF SAN DIEGO COUNTY INC,DCH_SNACK_PM,22,0,0,0,0,0,0,0,0,0
SAN DIEGO,Nov 2015,DCH,2016,CHICANO FEDERATION OF SAN DIEGO COUNTY INC,DCH_SUPPER,20,0,0,0,0,0,0,0,0,0
SAN DIEGO,Nov 2015,DCH,2016,CHICANO FEDERATION OF SAN DIEGO COUNTY INC,DCH_SUPPER,28,0,0,0,0,68740,0,0,68740,2455
SAN DIEGO,Nov 2015,DCH,2016,CHICANO FEDERATION OF SAN DIEGO COUNTY INC,DCH_SUPPER,,0,0,0,0,0,939,2607,3546,0
SAN DIEGO,Nov 2015,DCH,2016,CHICANO FEDERATION OF SAN DIEGO COUNTY INC,DCH_SUPPER,22,0,0,0,0,0,0,0,0,0
SAN DIEGO,Nov 2015,DCH,2016,CHICANO FEDERATION OF SAN DIEGO COUNTY INC,DCH_SUPPER,19,0,0,0,0,0,0,0,0,0
SAN DIEGO,Dec 2015,CACF,2016,CHICANO FEDERATION OF SAN DIEGO COUNTY INC,CHILD_BREAKFAST,22,43,7,3,53,433,71,30,534,24.2727
SAN DIEGO,Dec 2015,CACF,2016,CHICANO FEDERATION OF SAN DIEGO COUNTY INC,CHILD_LUNCH,22,43,7,3,53,566,92,40,698,31.7273
SAN DIEGO,Dec 2015,CACF,2016,CHICANO FEDERATION OF SAN DIEGO COUNTY INC,CHILD_SNACK_PM,22,43,7,3,53,470,76,33,579,26.3182
SAN DIEGO,Dec 2015,DCH,2016,CHICANO FEDERATION OF SAN DIEGO COUNTY INC,DCH_BREAKFAST,30,0,0,0,0,47546,0,0,47546,1584.8667
SAN DIEGO,Dec 2015,DCH,2016,CHICANO FEDERATION OF SAN DIEGO COUNTY INC,DCH_BREAKFAST,25,0,0,0,0,0,0,0,0,0
SAN DIEGO,Dec 2015,DCH,2016,CHICANO FEDERATION OF SAN DIEGO COUNTY INC,DCH_BREAKFAST,24,0,0,0,0,0,0,0,0,0
SAN DIEGO,Dec 2015,DCH,2016,CHICANO FEDERATION OF SAN DIEGO COUNTY INC,DCH_BREAKFAST,26,0,0,0,0,0,0,0,0,0
SAN DIEGO,Dec 2015,DCH,2016,CHICANO FEDERATION OF SAN DIEGO COUNTY INC,DCH_BREAKFAST,,0,0,0,0,0,406,1676,2082,0
SAN DIEGO,Dec 2015,DCH,2016,CHICANO FEDERATION OF SAN DIEGO COUNTY INC,DCH_LUNCH,24,0,0,0,0,0,0,0,0,0
SAN DIEGO,Dec 2015,DCH,2016,CHICANO FEDERATION OF SAN DIEGO COUNTY INC,DCH_LUNCH,26,0,0,0,0,0,0,0,0,0
SAN DIEGO,Dec 2015,DCH,2016,CHICANO FEDERATION OF SAN DIEGO COUNTY INC,DCH_LUNCH,25,0,0,0,0,0,0,0,0,0
SAN DIEGO,Dec 2015,DCH,2016,CHICANO FEDERATION OF SAN DIEGO COUNTY INC,DCH_LUNCH,30,0,0,0,0,76053,0,0,76053,2535.1
SAN DIEGO,Dec 2015,DCH,2016,CHICANO FEDERATION OF SAN DIEGO COUNTY INC,DCH_LUNCH,,0,0,0,0,0,1242,3538,4780,0
SAN DIEGO,Dec 2015,DCH,2016,CHICANO FEDERATION OF SAN DIEGO COUNTY INC,DCH_SNACK_AM,30,0,0,0,0,35803,0,0,35803,1193.4333
SAN DIEGO,Dec 2015,DCH,2016,CHICANO FEDERATION OF SAN DIEGO COUNTY INC,DCH_SNACK_AM,25,0,0,0,0,0,0,0,0,0
SAN DIEGO,Dec 2015,DCH,2016,CHICANO FEDERATION OF SAN DIEGO COUNTY INC,DCH_SNACK_AM,24,0,0,0,0,0,0,0,0,0
SAN DIEGO,Dec 2015,DCH,2016,CHICANO FEDERATION OF SAN DIEGO COUNTY INC,DCH_SNACK_AM,26,0,0,0,0,0,0,0,0,0
SAN DIEGO,Dec 2015,DCH,2016,CHICANO FEDERATION OF SAN DIEGO COUNTY INC,DCH_SNACK_AM,,0,0,0,0,0,597,1379,1976,0
SAN DIEGO,Dec 2015,DCH,2016,CHICANO FEDERATION OF SAN DIEGO COUNTY INC,DCH_SNACK_NT,25,0,0,0,0,0,0,0,0,0
SAN DIEGO,Dec 2015,DCH,2016,CHICANO FEDERATION OF SAN DIEGO COUNTY INC,DCH_SNACK_NT,24,0,0,0,0,0,0,0,0,0
SAN DIEGO,Dec 2015,DCH,2016,CHICANO FEDERATION OF SAN DIEGO COUNTY INC,DCH_SNACK_NT,,0,0,0,0,0,0,53,53,0
SAN DIEGO,Dec 2015,DCH,2016,CHICANO FEDERATION OF SAN DIEGO COUNTY INC,DCH_SNACK_NT,30,0,0,0,0,9125,0,0,9125,304.1667
SAN DIEGO,Dec 2015,DCH,2016,CHICANO FEDERATION OF SAN DIEGO COUNTY INC,DCH_SNACK_NT,26,0,0,0,0,0,0,0,0,0
SAN DIEGO,Dec 2015,DCH,2016,CHICANO FEDERATION OF SAN DIEGO COUNTY INC,DCH_SNACK_PM,30,0,0,0,0,63412,0,0,63412,2113.7333
SAN DIEGO,Dec 2015,DCH,2016,CHICANO FEDERATION OF SAN DIEGO COUNTY INC,DCH_SNACK_PM,,0,0,0,0,0,770,2518,3288,0
SAN DIEGO,Dec 2015,DCH,2016,CHICANO FEDERATION OF SAN DIEGO COUNTY INC,DCH_SNACK_PM,26,0,0,0,0,0,0,0,0,0
SAN DIEGO,Dec 2015,DCH,2016,CHICANO FEDERATION OF SAN DIEGO COUNTY INC,DCH_SNACK_PM,24,0,0,0,0,0,0,0,0,0
SAN DIEGO,Dec 2015,DCH,2016,CHICANO FEDERATION OF SAN DIEGO COUNTY INC,DCH_SNACK_PM,25,0,0,0,0,0,0,0,0,0
SAN DIEGO,Dec 2015,DCH,2016,CHICANO FEDERATION OF SAN DIEGO COUNTY INC,DCH_SUPPER,30,0,0,0,0,77704,0,0,77704,2590.1333
SAN DIEGO,Dec 2015,DCH,2016,CHICANO FEDERATION OF SAN DIEGO COUNTY INC,DCH_SUPPER,,0,0,0,0,0,1289,2681,3970,0
SAN DIEGO,Dec 2015,DCH,2016,CHICANO FEDERATION OF SAN DIEGO COUNTY INC,DCH_SUPPER,24,0,0,0,0,0,0,0,0,0
SAN DIEGO,Dec 2015,DCH,2016,CHICANO FEDERATION OF SAN DIEGO COUNTY INC,DCH_SUPPER,25,0,0,0,0,0,0,0,0,0
SAN DIEGO,Dec 2015,DCH,2016,CHICANO FEDERATION OF SAN DIEGO COUNTY INC,DCH_SUPPER,26,0,0,0,0,0,0,0,0,0
SAN DIEGO,Jan 2016,CACF,2016,CHICANO FEDERATION OF SAN DIEGO COUNTY INC,CHILD_BREAKFAST,19,49,11,5,65,501,112,51,664,34.9474
SAN DIEGO,Jan 2016,CACF,2016,CHICANO FEDERATION OF SAN DIEGO COUNTY INC,CHILD_LUNCH,19,49,11,5,65,620,139,64,823,43.3158
SAN DIEGO,Jan 2016,CACF,2016,CHICANO FEDERATION OF SAN DIEGO COUNTY INC,CHILD_SNACK_PM,19,49,11,5,65,487,109,50,646,34
SAN DIEGO,Jan 2016,DCH,2016,CHICANO FEDERATION OF SAN DIEGO COUNTY INC,DCH_BREAKFAST,29,0,0,0,0,47343,0,0,47343,1632.5172
SAN DIEGO,Jan 2016,DCH,2016,CHICANO FEDERATION OF SAN DIEGO COUNTY INC,DCH_BREAKFAST,,0,0,0,0,0,452,1606,2058,0
SAN DIEGO,Jan 2016,DCH,2016,CHICANO FEDERATION OF SAN DIEGO COUNTY INC,DCH_BREAKFAST,23,0,0,0,0,0,0,0,0,0
SAN DIEGO,Jan 2016,DCH,2016,CHICANO FEDERATION OF SAN DIEGO COUNTY INC,DCH_BREAKFAST,21,0,0,0,0,0,0,0,0,0
SAN DIEGO,Jan 2016,DCH,2016,CHICANO FEDERATION OF SAN DIEGO COUNTY INC,DCH_BREAKFAST,23,0,0,0,0,0,0,0,0,0
SAN DIEGO,Jan 2016,DCH,2016,CHICANO FEDERATION OF SAN DIEGO COUNTY INC,DCH_LUNCH,29,0,0,0,0,71138,0,0,71138,2453.0345
SAN DIEGO,Jan 2016,DCH,2016,CHICANO FEDERATION OF SAN DIEGO COUNTY INC,DCH_LUNCH,,0,0,0,0,0,1264,3462,4726,0
SAN DIEGO,Jan 2016,DCH,2016,CHICANO FEDERATION OF SAN DIEGO COUNTY INC,DCH_LUNCH,21,0,0,0,0,0,0,0,0,0
SAN DIEGO,Jan 2016,DCH,2016,CHICANO FEDERATION OF SAN DIEGO COUNTY INC,DCH_LUNCH,23,0,0,0,0,0,0,0,0,0
SAN DIEGO,Jan 2016,DCH,2016,CHICANO FEDERATION OF SAN DIEGO COUNTY INC,DCH_LUNCH,23,0,0,0,0,0,0,0,0,0
SAN DIEGO,Jan 2016,DCH,2016,CHICANO FEDERATION OF SAN DIEGO COUNTY INC,DCH_SNACK_AM,23,0,0,0,0,0,0,0,0,0
SAN DIEGO,Jan 2016,DCH,2016,CHICANO FEDERATION OF SAN DIEGO COUNTY INC,DCH_SNACK_AM,,0,0,0,0,0,661,1172,1833,0
SAN DIEGO,Jan 2016,DCH,2016,CHICANO FEDERATION OF SAN DIEGO COUNTY INC,DCH_SNACK_AM,29,0,0,0,0,33785,0,0,33785,1165
SAN DIEGO,Jan 2016,DCH,2016,CHICANO FEDERATION OF SAN DIEGO COUNTY INC,DCH_SNACK_AM,21,0,0,0,0,0,0,0,0,0
SAN DIEGO,Jan 2016,DCH,2016,CHICANO FEDERATION OF SAN DIEGO COUNTY INC,DCH_SNACK_AM,23,0,0,0,0,0,0,0,0,0
SAN DIEGO,Jan 2016,DCH,2016,CHICANO FEDERATION OF SAN DIEGO COUNTY INC,DCH_SNACK_NT,,0,0,0,0,0,25,45,70,0
SAN DIEGO,Jan 2016,DCH,2016,CHICANO FEDERATION OF SAN DIEGO COUNTY INC,DCH_SNACK_NT,23,0,0,0,0,0,0,0,0,0
SAN DIEGO,Jan 2016,DCH,2016,CHICANO FEDERATION OF SAN DIEGO COUNTY INC,DCH_SNACK_NT,23,0,0,0,0,0,0,0,0,0
SAN DIEGO,Jan 2016,DCH,2016,CHICANO FEDERATION OF SAN DIEGO COUNTY INC,DCH_SNACK_NT,21,0,0,0,0,0,0,0,0,0
SAN DIEGO,Jan 2016,DCH,2016,CHICANO FEDERATION OF SAN DIEGO COUNTY INC,DCH_SNACK_NT,29,0,0,0,0,9056,0,0,9056,312.2759
SAN DIEGO,Jan 2016,DCH,2016,CHICANO FEDERATION OF SAN DIEGO COUNTY INC,DCH_SNACK_PM,23,0,0,0,0,0,0,0,0,0
SAN DIEGO,Jan 2016,DCH,2016,CHICANO FEDERATION OF SAN DIEGO COUNTY INC,DCH_SNACK_PM,23,0,0,0,0,0,0,0,0,0
SAN DIEGO,Jan 2016,DCH,2016,CHICANO FEDERATION OF SAN DIEGO COUNTY INC,DCH_SNACK_PM,21,0,0,0,0,0,0,0,0,0
SAN DIEGO,Jan 2016,DCH,2016,CHICANO FEDERATION OF SAN DIEGO COUNTY INC,DCH_SNACK_PM,,0,0,0,0,0,798,2641,3439,0
SAN DIEGO,Jan 2016,DCH,2016,CHICANO FEDERATION OF SAN DIEGO COUNTY INC,DCH_SNACK_PM,29,0,0,0,0,60776,0,0,60776,2095.7241
SAN DIEGO,Jan 2016,DCH,2016,CHICANO FEDERATION OF SAN DIEGO COUNTY INC,DCH_SUPPER,23,0,0,0,0,0,0,0,0,0
SAN DIEGO,Jan 2016,DCH,2016,CHICANO FEDERATION OF SAN DIEGO COUNTY INC,DCH_SUPPER,23,0,0,0,0,0,0,0,0,0
SAN DIEGO,Jan 2016,DCH,2016,CHICANO FEDERATION OF SAN DIEGO COUNTY INC,DCH_SUPPER,21,0,0,0,0,0,0,0,0,0
SAN DIEGO,Jan 2016,DCH,2016,CHICANO FEDERATION OF SAN DIEGO COUNTY INC,DCH_SUPPER,,0,0,0,0,0,1273,2623,3896,0
SAN DIEGO,Jan 2016,DCH,2016,CHICANO FEDERATION OF SAN DIEGO COUNTY INC,DCH_SUPPER,29,0,0,0,0,73737,0,0,73737,2542.6552
SAN DIEGO,Feb 2016,CACF,2016,CHICANO FEDERATION OF SAN DIEGO COUNTY INC,CHILD_BREAKFAST,20,55,13,5,73,619,146,56,821,41.05
SAN DIEGO,Feb 2016,CACF,2016,CHICANO FEDERATION OF SAN DIEGO COUNTY INC,CHILD_LUNCH,20,55,13,5,73,759,179,69,1007,50.35
SAN DIEGO,Feb 2016,CACF,2016,CHICANO FEDERATION OF SAN DIEGO COUNTY INC,CHILD_SNACK_PM,20,55,13,5,73,654,155,59,868,43.4
SAN DIEGO,Feb 2016,DCH,2016,CHICANO FEDERATION OF SAN DIEGO COUNTY INC,DCH_BREAKFAST,22,0,0,0,0,0,0,0,0,0
SAN DIEGO,Feb 2016,DCH,2016,CHICANO FEDERATION OF SAN DIEGO COUNTY INC,DCH_BREAKFAST,23,0,0,0,0,0,0,0,0,0
SAN DIEGO,Feb 2016,DCH,2016,CHICANO FEDERATION OF SAN DIEGO COUNTY INC,DCH_BREAKFAST,24,0,0,0,0,0,0,0,0,0
SAN DIEGO,Feb 2016,DCH,2016,CHICANO FEDERATION OF SAN DIEGO COUNTY INC,DCH_BREAKFAST,,0,0,0,0,0,518,1976,2494,0
SAN DIEGO,Feb 2016,DCH,2016,CHICANO FEDERATION OF SAN DIEGO COUNTY INC,DCH_BREAKFAST,28,0,0,0,0,54532,0,0,54532,1947.5714
SAN DIEGO,Feb 2016,DCH,2016,CHICANO FEDERATION OF SAN DIEGO COUNTY INC,DCH_LUNCH,28,0,0,0,0,70889,0,0,70889,2531.75
SAN DIEGO,Feb 2016,DCH,2016,CHICANO FEDERATION OF SAN DIEGO COUNTY INC,DCH_LUNCH,,0,0,0,0,0,1179,3708,4887,0
SAN DIEGO,Feb 2016,DCH,2016,CHICANO FEDERATION OF SAN DIEGO COUNTY INC,DCH_LUNCH,22,0,0,0,0,0,0,0,0,0
SAN DIEGO,Feb 2016,DCH,2016,CHICANO FEDERATION OF SAN DIEGO COUNTY INC,DCH_LUNCH,24,0,0,0,0,0,0,0,0,0
SAN DIEGO,Feb 2016,DCH,2016,CHICANO FEDERATION OF SAN DIEGO COUNTY INC,DCH_LUNCH,23,0,0,0,0,0,0,0,0,0
SAN DIEGO,Feb 2016,DCH,2016,CHICANO FEDERATION OF SAN DIEGO COUNTY INC,DCH_SNACK_AM,23,0,0,0,0,0,0,0,0,0
SAN DIEGO,Feb 2016,DCH,2016,CHICANO FEDERATION OF SAN DIEGO COUNTY INC,DCH_SNACK_AM,28,0,0,0,0,34914,0,0,34914,1246.9286
SAN DIEGO,Feb 2016,DCH,2016,CHICANO FEDERATION OF SAN DIEGO COUNTY INC,DCH_SNACK_AM,24,0,0,0,0,0,0,0,0,0
SAN DIEGO,Feb 2016,DCH,2016,CHICANO FEDERATION OF SAN DIEGO COUNTY INC,DCH_SNACK_AM,22,0,0,0,0,0,0,0,0,0
SAN DIEGO,Feb 2016,DCH,2016,CHICANO FEDERATION OF SAN DIEGO COUNTY INC,DCH_SNACK_AM,,0,0,0,0,0,584,1332,1916,0
SAN DIEGO,Feb 2016,DCH,2016,CHICANO FEDERATION OF SAN DIEGO COUNTY INC,DCH_SNACK_NT,22,0,0,0,0,0,0,0,0,0
SAN DIEGO,Feb 2016,DCH,2016,CHICANO FEDERATION OF SAN DIEGO COUNTY INC,DCH_SNACK_NT,28,0,0,0,0,10505,0,0,10505,375.1786
SAN DIEGO,Feb 2016,DCH,2016,CHICANO FEDERATION OF SAN DIEGO COUNTY INC,DCH_SNACK_NT,,0,0,0,0,0,0,65,65,0
SAN DIEGO,Feb 2016,DCH,2016,CHICANO FEDERATION OF SAN DIEGO COUNTY INC,DCH_SNACK_NT,23,0,0,0,0,0,0,0,0,0
SAN DIEGO,Feb 2016,DCH,2016,CHICANO FEDERATION OF SAN DIEGO COUNTY INC,DCH_SNACK_NT,24,0,0,0,0,0,0,0,0,0
SAN DIEGO,Feb 2016,DCH,2016,CHICANO FEDERATION OF SAN DIEGO COUNTY INC,DCH_SNACK_PM,24,0,0,0,0,0,0,0,0,0
SAN DIEGO,Feb 2016,DCH,2016,CHICANO FEDERATION OF SAN DIEGO COUNTY INC,DCH_SNACK_PM,22,0,0,0,0,0,0,0,0,0
SAN DIEGO,Feb 2016,DCH,2016,CHICANO FEDERATION OF SAN DIEGO COUNTY INC,DCH_SNACK_PM,,0,0,0,0,0,752,2803,3555,0
SAN DIEGO,Feb 2016,DCH,2016,CHICANO FEDERATION OF SAN DIEGO COUNTY INC,DCH_SNACK_PM,28,0,0,0,0,63014,0,0,63014,2250.5
SAN DIEGO,Feb 2016,DCH,2016,CHICANO FEDERATION OF SAN DIEGO COUNTY INC,DCH_SNACK_PM,23,0,0,0,0,0,0,0,0,0
SAN DIEGO,Feb 2016,DCH,2016,CHICANO FEDERATION OF SAN DIEGO COUNTY INC,DCH_SUPPER,28,0,0,0,0,78652,0,0,78652,2809
SAN DIEGO,Feb 2016,DCH,2016,CHICANO FEDERATION OF SAN DIEGO COUNTY INC,DCH_SUPPER,22,0,0,0,0,0,0,0,0,0
SAN DIEGO,Feb 2016,DCH,2016,CHICANO FEDERATION OF SAN DIEGO COUNTY INC,DCH_SUPPER,,0,0,0,0,0,1261,2816,4077,0
SAN DIEGO,Feb 2016,DCH,2016,CHICANO FEDERATION OF SAN DIEGO COUNTY INC,DCH_SUPPER,23,0,0,0,0,0,0,0,0,0
SAN DIEGO,Feb 2016,DCH,2016,CHICANO FEDERATION OF SAN DIEGO COUNTY INC,DCH_SUPPER,24,0,0,0,0,0,0,0,0,0
SAN DIEGO,Mar 2016,CACF,2016,CHICANO FEDERATION OF SAN DIEGO COUNTY INC,CHILD_BREAKFAST,22,48,12,5,65,609,152,64,825,37.5
SAN DIEGO,Mar 2016,CACF,2016,CHICANO FEDERATION OF SAN DIEGO COUNTY INC,CHILD_LUNCH,22,48,12,5,65,760,190,79,1029,46.7727
SAN DIEGO,Mar 2016,CACF,2016,CHICANO FEDERATION OF SAN DIEGO COUNTY INC,CHILD_SNACK_PM,22,48,12,5,65,649,162,68,879,39.9545
SAN DIEGO,Mar 2016,DCH,2016,CHICANO FEDERATION OF SAN DIEGO COUNTY INC,DCH_BREAKFAST,31,0,0,0,0,57054,0,0,57054,1840.4516
SAN DIEGO,Mar 2016,DCH,2016,CHICANO FEDERATION OF SAN DIEGO COUNTY INC,DCH_BREAKFAST,,0,0,0,0,0,494,2133,2627,0
SAN DIEGO,Mar 2016,DCH,2016,CHICANO FEDERATION OF SAN DIEGO COUNTY INC,DCH_BREAKFAST,27,0,0,0,0,0,0,0,0,0
SAN DIEGO,Mar 2016,DCH,2016,CHICANO FEDERATION OF SAN DIEGO COUNTY INC,DCH_BREAKFAST,27,0,0,0,0,0,0,0,0,0
SAN DIEGO,Mar 2016,DCH,2016,CHICANO FEDERATION OF SAN DIEGO COUNTY INC,DCH_BREAKFAST,24,0,0,0,0,0,0,0,0,0
SAN DIEGO,Mar 2016,DCH,2016,CHICANO FEDERATION OF SAN DIEGO COUNTY INC,DCH_LUNCH,31,0,0,0,0,89681,0,0,89681,2892.9355
SAN DIEGO,Mar 2016,DCH,2016,CHICANO FEDERATION OF SAN DIEGO COUNTY INC,DCH_LUNCH,,0,0,0,0,0,1558,4588,6146,0
SAN DIEGO,Mar 2016,DCH,2016,CHICANO FEDERATION OF SAN DIEGO COUNTY INC,DCH_LUNCH,24,0,0,0,0,0,0,0,0,0
SAN DIEGO,Mar 2016,DCH,2016,CHICANO FEDERATION OF SAN DIEGO COUNTY INC,DCH_LUNCH,27,0,0,0,0,0,0,0,0,0
SAN DIEGO,Mar 2016,DCH,2016,CHICANO FEDERATION OF SAN DIEGO COUNTY INC,DCH_LUNCH,27,0,0,0,0,0,0,0,0,0
SAN DIEGO,Mar 2016,DCH,2016,CHICANO FEDERATION OF SAN DIEGO COUNTY INC,DCH_SNACK_AM,24,0,0,0,0,0,0,0,0,0
SAN DIEGO,Mar 2016,DCH,2016,CHICANO FEDERATION OF SAN DIEGO COUNTY INC,DCH_SNACK_AM,,0,0,0,0,0,768,1697,2465,0
SAN DIEGO,Mar 2016,DCH,2016,CHICANO FEDERATION OF SAN DIEGO COUNTY INC,DCH_SNACK_AM,27,0,0,0,0,0,0,0,0,0
SAN DIEGO,Mar 2016,DCH,2016,CHICANO FEDERATION OF SAN DIEGO COUNTY INC,DCH_SNACK_AM,27,0,0,0,0,0,0,0,0,0
SAN DIEGO,Mar 2016,DCH,2016,CHICANO FEDERATION OF SAN DIEGO COUNTY INC,DCH_SNACK_AM,31,0,0,0,0,42829,0,0,42829,1381.5806
SAN DIEGO,Mar 2016,DCH,2016,CHICANO FEDERATION OF SAN DIEGO COUNTY INC,DCH_SNACK_NT,27,0,0,0,0,0,0,0,0,0
SAN DIEGO,Mar 2016,DCH,2016,CHICANO FEDERATION OF SAN DIEGO COUNTY INC,DCH_SNACK_NT,24,0,0,0,0,0,0,0,0,0
SAN DIEGO,Mar 2016,DCH,2016,CHICANO FEDERATION OF SAN DIEGO COUNTY INC,DCH_SNACK_NT,,0,0,0,0,0,0,26,26,0
SAN DIEGO,Mar 2016,DCH,2016,CHICANO FEDERATION OF SAN DIEGO COUNTY INC,DCH_SNACK_NT,31,0,0,0,0,10404,0,0,10404,335.6129
SAN DIEGO,Mar 2016,DCH,2016,CHICANO FEDERATION OF SAN DIEGO COUNTY INC,DCH_SNACK_NT,27,0,0,0,0,0,0,0,0,0
SAN DIEGO,Mar 2016,DCH,2016,CHICANO FEDERATION OF SAN DIEGO COUNTY INC,DCH_SNACK_PM,27,0,0,0,0,0,0,0,0,0
SAN DIEGO,Mar 2016,DCH,2016,CHICANO FEDERATION OF SAN DIEGO COUNTY INC,DCH_SNACK_PM,27,0,0,0,0,0,0,0,0,0
SAN DIEGO,Mar 2016,DCH,2016,CHICANO FEDERATION OF SAN DIEGO COUNTY INC,DCH_SNACK_PM,24,0,0,0,0,0,0,0,0,0
SAN DIEGO,Mar 2016,DCH,2016,CHICANO FEDERATION OF SAN DIEGO COUNTY INC,DCH_SNACK_PM,,0,0,0,0,0,959,3345,4304,0
SAN DIEGO,Mar 2016,DCH,2016,CHICANO FEDERATION OF SAN DIEGO COUNTY INC,DCH_SNACK_PM,31,0,0,0,0,74265,0,0,74265,2395.6452
SAN DIEGO,Mar 2016,DCH,2016,CHICANO FEDERATION OF SAN DIEGO COUNTY INC,DCH_SUPPER,27,0,0,0,0,0,0,0,0,0
SAN DIEGO,Mar 2016,DCH,2016,CHICANO FEDERATION OF SAN DIEGO COUNTY INC,DCH_SUPPER,27,0,0,0,0,0,0,0,0,0
SAN DIEGO,Mar 2016,DCH,2016,CHICANO FEDERATION OF SAN DIEGO COUNTY INC,DCH_SUPPER,24,0,0,0,0,0,0,0,0,0
SAN DIEGO,Mar 2016,DCH,2016,CHICANO FEDERATION OF SAN DIEGO COUNTY INC,DCH_SUPPER,,0,0,0,0,0,1501,3372,4873,0
SAN DIEGO,Mar 2016,DCH,2016,CHICANO FEDERATION OF SAN DIEGO COUNTY INC,DCH_SUPPER,31,0,0,0,0,89160,0,0,89160,2876.129
SAN DIEGO,Apr 2016,CACF,2016,CHICANO FEDERATION OF SAN DIEGO COUNTY INC,CHILD_BREAKFAST,21,45,12,5,62,552,147,61,760,36.1905
SAN DIEGO,Apr 2016,CACF,2016,CHICANO FEDERATION OF SAN DIEGO COUNTY INC,CHILD_LUNCH,21,45,12,5,62,698,186,77,961,45.7619
SAN DIEGO,Apr 2016,CACF,2016,CHICANO FEDERATION OF SAN DIEGO COUNTY INC,CHILD_SNACK_PM,21,45,12,5,62,581,155,65,801,38.1429
SAN DIEGO,Apr 2016,DCH,2016,CHICANO FEDERATION OF SAN DIEGO COUNTY INC,DCH_BREAKFAST,26,0,0,0,0,0,0,0,0,0
SAN DIEGO,Apr 2016,DCH,2016,CHICANO FEDERATION OF SAN DIEGO COUNTY INC,DCH_BREAKFAST,30,0,0,0,0,56143,0,0,56143,1871.4333
SAN DIEGO,Apr 2016,DCH,2016,CHICANO FEDERATION OF SAN DIEGO COUNTY INC,DCH_BREAKFAST,,0,0,0,0,0,604,1948,2552,0
SAN DIEGO,Apr 2016,DCH,2016,CHICANO FEDERATION OF SAN DIEGO COUNTY INC,DCH_BREAKFAST,23,0,0,0,0,0,0,0,0,0
SAN DIEGO,Apr 2016,DCH,2016,CHICANO FEDERATION OF SAN DIEGO COUNTY INC,DCH_BREAKFAST,26,0,0,0,0,0,0,0,0,0
SAN DIEGO,Apr 2016,DCH,2016,CHICANO FEDERATION OF SAN DIEGO COUNTY INC,DCH_LUNCH,23,0,0,0,0,0,0,0,0,0
SAN DIEGO,Apr 2016,DCH,2016,CHICANO FEDERATION OF SAN DIEGO COUNTY INC,DCH_LUNCH,26,0,0,0,0,0,0,0,0,0
SAN DIEGO,Apr 2016,DCH,2016,CHICANO FEDERATION OF SAN DIEGO COUNTY INC,DCH_LUNCH,26,0,0,0,0,0,0,0,0,0
SAN DIEGO,Apr 2016,DCH,2016,CHICANO FEDERATION OF SAN DIEGO COUNTY INC,DCH_LUNCH,30,0,0,0,0,81754,0,0,81754,2725.1333
SAN DIEGO,Apr 2016,DCH,2016,CHICANO FEDERATION OF SAN DIEGO COUNTY INC,DCH_LUNCH,,0,0,0,0,0,1499,4010,5509,0
SAN DIEGO,Apr 2016,DCH,2016,CHICANO FEDERATION OF SAN DIEGO COUNTY INC,DCH_SNACK_AM,30,0,0,0,0,39688,0,0,39688,1322.9333
SAN DIEGO,Apr 2016,DCH,2016,CHICANO FEDERATION OF SAN DIEGO COUNTY INC,DCH_SNACK_AM,,0,0,0,0,0,680,1522,2202,0
SAN DIEGO,Apr 2016,DCH,2016,CHICANO FEDERATION OF SAN DIEGO COUNTY INC,DCH_SNACK_AM,23,0,0,0,0,0,0,0,0,0
SAN DIEGO,Apr 2016,DCH,2016,CHICANO FEDERATION OF SAN DIEGO COUNTY INC,DCH_SNACK_AM,26,0,0,0,0,0,0,0,0,0
SAN DIEGO,Apr 2016,DCH,2016,CHICANO FEDERATION OF SAN DIEGO COUNTY INC,DCH_SNACK_AM,26,0,0,0,0,0,0,0,0,0
SAN DIEGO,Apr 2016,DCH,2016,CHICANO FEDERATION OF SAN DIEGO COUNTY INC,DCH_SNACK_NT,23,0,0,0,0,0,0,0,0,0
SAN DIEGO,Apr 2016,DCH,2016,CHICANO FEDERATION OF SAN DIEGO COUNTY INC,DCH_SNACK_NT,26,0,0,0,0,0,0,0,0,0
SAN DIEGO,Apr 2016,DCH,2016,CHICANO FEDERATION OF SAN DIEGO COUNTY INC,DCH_SNACK_NT,,0,0,0,0,0,0,62,62,0
SAN DIEGO,Apr 2016,DCH,2016,CHICANO FEDERATION OF SAN DIEGO COUNTY INC,DCH_SNACK_NT,30,0,0,0,0,10666,0,0,10666,355.5333
SAN DIEGO,Apr 2016,DCH,2016,CHICANO FEDERATION OF SAN DIEGO COUNTY INC,DCH_SNACK_NT,26,0,0,0,0,0,0,0,0,0
SAN DIEGO,Apr 2016,DCH,2016,CHICANO FEDERATION OF SAN DIEGO COUNTY INC,DCH_SNACK_PM,30,0,0,0,0,69787,0,0,69787,2326.2333
SAN DIEGO,Apr 2016,DCH,2016,CHICANO FEDERATION OF SAN DIEGO COUNTY INC,DCH_SNACK_PM,,0,0,0,0,0,1043,2847,3890,0
SAN DIEGO,Apr 2016,DCH,2016,CHICANO FEDERATION OF SAN DIEGO COUNTY INC,DCH_SNACK_PM,23,0,0,0,0,0,0,0,0,0
SAN DIEGO,Apr 2016,DCH,2016,CHICANO FEDERATION OF SAN DIEGO COUNTY INC,DCH_SNACK_PM,26,0,0,0,0,0,0,0,0,0
SAN DIEGO,Apr 2016,DCH,2016,CHICANO FEDERATION OF SAN DIEGO COUNTY INC,DCH_SNACK_PM,26,0,0,0,0,0,0,0,0,0
SAN DIEGO,Apr 2016,DCH,2016,CHICANO FEDERATION OF SAN DIEGO COUNTY INC,DCH_SUPPER,,0,0,0,0,0,1535,3108,4643,0
SAN DIEGO,Apr 2016,DCH,2016,CHICANO FEDERATION OF SAN DIEGO COUNTY INC,DCH_SUPPER,30,0,0,0,0,85227,0,0,85227,2840.9
SAN DIEGO,Apr 2016,DCH,2016,CHICANO FEDERATION OF SAN DIEGO COUNTY INC,DCH_SUPPER,26,0,0,0,0,0,0,0,0,0
SAN DIEGO,Apr 2016,DCH,2016,CHICANO FEDERATION OF SAN DIEGO COUNTY INC,DCH_SUPPER,26,0,0,0,0,0,0,0,0,0
SAN DIEGO,Apr 2016,DCH,2016,CHICANO FEDERATION OF SAN DIEGO COUNTY INC,DCH_SUPPER,23,0,0,0,0,0,0,0,0,0
SAN DIEGO,May 2016,CACF,2016,CHICANO FEDERATION OF SAN DIEGO COUNTY INC,CHILD_BREAKFAST,21,45,10,4,59,541,120,48,709,33.7619
SAN DIEGO,May 2016,CACF,2016,CHICANO FEDERATION OF SAN DIEGO COUNTY INC,CHILD_LUNCH,21,45,10,4,59,683,152,61,896,42.6667
SAN DIEGO,May 2016,CACF,2016,CHICANO FEDERATION OF SAN DIEGO COUNTY INC,CHILD_SNACK_PM,21,45,10,4,59,598,133,53,784,37.3333
SAN DIEGO,May 2016,DCH,2016,CHICANO FEDERATION OF SAN DIEGO COUNTY INC,DCH_BREAKFAST,25,0,0,0,0,0,0,0,0,0
SAN DIEGO,May 2016,DCH,2016,CHICANO FEDERATION OF SAN DIEGO COUNTY INC,DCH_BREAKFAST,30,0,0,0,0,58298,0,0,58298,1943.2667
SAN DIEGO,May 2016,DCH,2016,CHICANO FEDERATION OF SAN DIEGO COUNTY INC,DCH_BREAKFAST,,0,0,0,0,0,607,1991,2598,0
SAN DIEGO,May 2016,DCH,2016,CHICANO FEDERATION OF SAN DIEGO COUNTY INC,DCH_BREAKFAST,23,0,0,0,0,0,0,0,0,0
SAN DIEGO,May 2016,DCH,2016,CHICANO FEDERATION OF SAN DIEGO COUNTY INC,DCH_BREAKFAST,25,0,0,0,0,0,0,0,0,0
SAN DIEGO,May 2016,DCH,2016,CHICANO FEDERATION OF SAN DIEGO COUNTY INC,DCH_LUNCH,,0,0,0,0,0,1557,4001,5558,0
SAN DIEGO,May 2016,DCH,2016,CHICANO FEDERATION OF SAN DIEGO COUNTY INC,DCH_LUNCH,23,0,0,0,0,0,0,0,0,0
SAN DIEGO,May 2016,DCH,2016,CHICANO FEDERATION OF SAN DIEGO COUNTY INC,DCH_LUNCH,25,0,0,0,0,0,0,0,0,0
SAN DIEGO,May 2016,DCH,2016,CHICANO FEDERATION OF SAN DIEGO COUNTY INC,DCH_LUNCH,25,0,0,0,0,0,0,0,0,0
SAN DIEGO,May 2016,DCH,2016,CHICANO FEDERATION OF SAN DIEGO COUNTY INC,DCH_LUNCH,30,0,0,0,0,79012,0,0,79012,2633.7333
SAN DIEGO,May 2016,DCH,2016,CHICANO FEDERATION OF SAN DIEGO COUNTY INC,DCH_SNACK_AM,30,0,0,0,0,39548,0,0,39548,1318.2667
SAN DIEGO,May 2016,DCH,2016,CHICANO FEDERATION OF SAN DIEGO COUNTY INC,DCH_SNACK_AM,,0,0,0,0,0,674,1531,2205,0
SAN DIEGO,May 2016,DCH,2016,CHICANO FEDERATION OF SAN DIEGO COUNTY INC,DCH_SNACK_AM,23,0,0,0,0,0,0,0,0,0
SAN DIEGO,May 2016,DCH,2016,CHICANO FEDERATION OF SAN DIEGO COUNTY INC,DCH_SNACK_AM,25,0,0,0,0,0,0,0,0,0
SAN DIEGO,May 2016,DCH,2016,CHICANO FEDERATION OF SAN DIEGO COUNTY INC,DCH_SNACK_AM,25,0,0,0,0,0,0,0,0,0
SAN DIEGO,May 2016,DCH,2016,CHICANO FEDERATION OF SAN DIEGO COUNTY INC,DCH_SNACK_NT,25,0,0,0,0,0,0,0,0,0
SAN DIEGO,May 2016,DCH,2016,CHICANO FEDERATION OF SAN DIEGO COUNTY INC,DCH_SNACK_NT,25,0,0,0,0,0,0,0,0,0
SAN DIEGO,May 2016,DCH,2016,CHICANO FEDERATION OF SAN DIEGO COUNTY INC,DCH_SNACK_NT,30,0,0,0,0,10844,0,0,10844,361.4667
SAN DIEGO,May 2016,DCH,2016,CHICANO FEDERATION OF SAN DIEGO COUNTY INC,DCH_SNACK_NT,23,0,0,0,0,0,0,0,0,0
SAN DIEGO,May 2016,DCH,2016,CHICANO FEDERATION OF SAN DIEGO COUNTY INC,DCH_SNACK_NT,,0,0,0,0,0,0,53,53,0
SAN DIEGO,May 2016,DCH,2016,CHICANO FEDERATION OF SAN DIEGO COUNTY INC,DCH_SNACK_PM,25,0,0,0,0,0,0,0,0,0
SAN DIEGO,May 2016,DCH,2016,CHICANO FEDERATION OF SAN DIEGO COUNTY INC,DCH_SNACK_PM,25,0,0,0,0,0,0,0,0,0
SAN DIEGO,May 2016,DCH,2016,CHICANO FEDERATION OF SAN DIEGO COUNTY INC,DCH_SNACK_PM,23,0,0,0,0,0,0,0,0,0
SAN DIEGO,May 2016,DCH,2016,CHICANO FEDERATION OF SAN DIEGO COUNTY INC,DCH_SNACK_PM,,0,0,0,0,0,1115,2898,4013,0
SAN DIEGO,May 2016,DCH,2016,CHICANO FEDERATION OF SAN DIEGO COUNTY INC,DCH_SNACK_PM,30,0,0,0,0,67765,0,0,67765,2258.8333
SAN DIEGO,May 2016,DCH,2016,CHICANO FEDERATION OF SAN DIEGO COUNTY INC,DCH_SUPPER,25,0,0,0,0,0,0,0,0,0
SAN DIEGO,May 2016,DCH,2016,CHICANO FEDERATION OF SAN DIEGO COUNTY INC,DCH_SUPPER,25,0,0,0,0,0,0,0,0,0
SAN DIEGO,May 2016,DCH,2016,CHICANO FEDERATION OF SAN DIEGO COUNTY INC,DCH_SUPPER,23,0,0,0,0,0,0,0,0,0
SAN DIEGO,May 2016,DCH,2016,CHICANO FEDERATION OF SAN DIEGO COUNTY INC,DCH_SUPPER,30,0,0,0,0,84789,0,0,84789,2826.3
SAN DIEGO,May 2016,DCH,2016,CHICANO FEDERATION OF SAN DIEGO COUNTY INC,DCH_SUPPER,,0,0,0,0,0,1649,3044,4693,0
SAN DIEGO,Jun 2016,CACF,2016,CHICANO FEDERATION OF SAN DIEGO COUNTY INC,CHILD_BREAKFAST,21,38,11,3,52,460,133,36,629,29.9524
SAN DIEGO,Jun 2016,CACF,2016,CHICANO FEDERATION OF SAN DIEGO COUNTY INC,CHILD_LUNCH,21,38,11,3,52,595,172,47,814,38.7619
SAN DIEGO,Jun 2016,CACF,2016,CHICANO FEDERATION OF SAN DIEGO COUNTY INC,CHILD_SNACK_PM,21,38,11,3,52,487,141,39,667,31.7619
SAN DIEGO,Jun 2016,DCH,2016,CHICANO FEDERATION OF SAN DIEGO COUNTY INC,DCH_BREAKFAST,,0,0,0,0,0,386,1745,2131,0
SAN DIEGO,Jun 2016,DCH,2016,CHICANO FEDERATION OF SAN DIEGO COUNTY INC,DCH_BREAKFAST,24,0,0,0,0,0,0,0,0,0
SAN DIEGO,Jun 2016,DCH,2016,CHICANO FEDERATION OF SAN DIEGO COUNTY INC,DCH_BREAKFAST,30,0,0,0,0,48563,0,0,48563,1618.7667
SAN DIEGO,Jun 2016,DCH,2016,CHICANO FEDERATION OF SAN DIEGO COUNTY INC,DCH_BREAKFAST,25,0,0,0,0,0,0,0,0,0
SAN DIEGO,Jun 2016,DCH,2016,CHICANO FEDERATION OF SAN DIEGO COUNTY INC,DCH_BREAKFAST,26,0,0,0,0,0,0,0,0,0
SAN DIEGO,Jun 2016,DCH,2016,CHICANO FEDERATION OF SAN DIEGO COUNTY INC,DCH_LUNCH,24,0,0,0,0,0,0,0,0,0
SAN DIEGO,Jun 2016,DCH,2016,CHICANO FEDERATION OF SAN DIEGO COUNTY INC,DCH_LUNCH,25,0,0,0,0,0,0,0,0,0
SAN DIEGO,Jun 2016,DCH,2016,CHICANO FEDERATION OF SAN DIEGO COUNTY INC,DCH_LUNCH,26,0,0,0,0,0,0,0,0,0
SAN DIEGO,Jun 2016,DCH,2016,CHICANO FEDERATION OF SAN DIEGO COUNTY INC,DCH_LUNCH,30,0,0,0,0,96792,0,0,96792,3226.4
SAN DIEGO,Jun 2016,DCH,2016,CHICANO FEDERATION OF SAN DIEGO COUNTY INC,DCH_LUNCH,,0,0,0,0,0,2743,4622,7365,0
SAN DIEGO,Jun 2016,DCH,2016,CHICANO FEDERATION OF SAN DIEGO COUNTY INC,DCH_SNACK_AM,25,0,0,0,0,0,0,0,0,0
SAN DIEGO,Jun 2016,DCH,2016,CHICANO FEDERATION OF SAN DIEGO COUNTY INC,DCH_SNACK_AM,26,0,0,0,0,0,0,0,0,0
SAN DIEGO,Jun 2016,DCH,2016,CHICANO FEDERATION OF SAN DIEGO COUNTY INC,DCH_SNACK_AM,24,0,0,0,0,0,0,0,0,0
SAN DIEGO,Jun 2016,DCH,2016,CHICANO FEDERATION OF SAN DIEGO COUNTY INC,DCH_SNACK_AM,,0,0,0,0,0,912,1834,2746,0
SAN DIEGO,Jun 2016,DCH,2016,CHICANO FEDERATION OF SAN DIEGO COUNTY INC,DCH_SNACK_AM,30,0,0,0,0,45791,0,0,45791,1526.3667
SAN DIEGO,Jun 2016,DCH,2016,CHICANO FEDERATION OF SAN DIEGO COUNTY INC,DCH_SNACK_NT,25,0,0,0,0,0,0,0,0,0
SAN DIEGO,Jun 2016,DCH,2016,CHICANO FEDERATION OF SAN DIEGO COUNTY INC,DCH_SNACK_NT,,0,0,0,0,0,15,6,21,0
SAN DIEGO,Jun 2016,DCH,2016,CHICANO FEDERATION OF SAN DIEGO COUNTY INC,DCH_SNACK_NT,24,0,0,0,0,0,0,0,0,0
SAN DIEGO,Jun 2016,DCH,2016,CHICANO FEDERATION OF SAN DIEGO COUNTY INC,DCH_SNACK_NT,30,0,0,0,0,9246,0,0,9246,308.2
SAN DIEGO,Jun 2016,DCH,2016,CHICANO FEDERATION OF SAN DIEGO COUNTY INC,DCH_SNACK_NT,26,0,0,0,0,0,0,0,0,0
SAN DIEGO,Jun 2016,DCH,2016,CHICANO FEDERATION OF SAN DIEGO COUNTY INC,DCH_SNACK_PM,25,0,0,0,0,0,0,0,0,0
SAN DIEGO,Jun 2016,DCH,2016,CHICANO FEDERATION OF SAN DIEGO COUNTY INC,DCH_SNACK_PM,26,0,0,0,0,0,0,0,0,0
SAN DIEGO,Jun 2016,DCH,2016,CHICANO FEDERATION OF SAN DIEGO COUNTY INC,DCH_SNACK_PM,24,0,0,0,0,0,0,0,0,0
SAN DIEGO,Jun 2016,DCH,2016,CHICANO FEDERATION OF SAN DIEGO COUNTY INC,DCH_SNACK_PM,,0,0,0,0,0,2041,3075,5116,0
SAN DIEGO,Jun 2016,DCH,2016,CHICANO FEDERATION OF SAN DIEGO COUNTY INC,DCH_SNACK_PM,30,0,0,0,0,71649,0,0,71649,2388.3
SAN DIEGO,Jun 2016,DCH,2016,CHICANO FEDERATION OF SAN DIEGO COUNTY INC,DCH_SUPPER,,0,0,0,0,0,2690,3188,5878,0
SAN DIEGO,Jun 2016,DCH,2016,CHICANO FEDERATION OF SAN DIEGO COUNTY INC,DCH_SUPPER,30,0,0,0,0,84946,0,0,84946,2831.5333
SAN DIEGO,Jun 2016,DCH,2016,CHICANO FEDERATION OF SAN DIEGO COUNTY INC,DCH_SUPPER,25,0,0,0,0,0,0,0,0,0
SAN DIEGO,Jun 2016,DCH,2016,CHICANO FEDERATION OF SAN DIEGO COUNTY INC,DCH_SUPPER,24,0,0,0,0,0,0,0,0,0
SAN DIEGO,Jun 2016,DCH,2016,CHICANO FEDERATION OF SAN DIEGO COUNTY INC,DCH_SUPPER,26,0,0,0,0,0,0,0,0,0
SAN DIEGO,Jul 2016,CACF,2016,CHICANO FEDERATION OF SAN DIEGO COUNTY INC,CHILD_BREAKFAST,20,52,12,2,66,607,140,23,770,38.5
SAN DIEGO,Jul 2016,CACF,2016,CHICANO FEDERATION OF SAN DIEGO COUNTY INC,CHILD_LUNCH,20,52,12,2,66,750,173,29,952,47.6
SAN DIEGO,Jul 2016,CACF,2016,CHICANO FEDERATION OF SAN DIEGO COUNTY INC,CHILD_SNACK_PM,20,52,12,2,66,629,145,24,798,39.9
SAN DIEGO,Jul 2016,DCH,2016,CHICANO FEDERATION OF SAN DIEGO COUNTY INC,DCH_BREAKFAST,25,0,0,0,0,0,0,0,0,0
SAN DIEGO,Jul 2016,DCH,2016,CHICANO FEDERATION OF SAN DIEGO COUNTY INC,DCH_BREAKFAST,25,0,0,0,0,0,0,0,0,0
SAN DIEGO,Jul 2016,DCH,2016,CHICANO FEDERATION OF SAN DIEGO COUNTY INC,DCH_BREAKFAST,22,0,0,0,0,0,0,0,0,0
SAN DIEGO,Jul 2016,DCH,2016,CHICANO FEDERATION OF SAN DIEGO COUNTY INC,DCH_BREAKFAST,,0,0,0,0,0,294,1981,2275,0
SAN DIEGO,Jul 2016,DCH,2016,CHICANO FEDERATION OF SAN DIEGO COUNTY INC,DCH_BREAKFAST,30,0,0,0,0,38151,0,0,38151,1271.7
SAN DIEGO,Jul 2016,DCH,2016,CHICANO FEDERATION OF SAN DIEGO COUNTY INC,DCH_LUNCH,,0,0,0,0,0,905,5163,6068,0
SAN DIEGO,Jul 2016,DCH,2016,CHICANO FEDERATION OF SAN DIEGO COUNTY INC,DCH_LUNCH,25,0,0,0,0,0,0,0,0,0
SAN DIEGO,Jul 2016,DCH,2016,CHICANO FEDERATION OF SAN DIEGO COUNTY INC,DCH_LUNCH,25,0,0,0,0,0,0,0,0,0
SAN DIEGO,Jul 2016,DCH,2016,CHICANO FEDERATION OF SAN DIEGO COUNTY INC,DCH_LUNCH,30,0,0,0,0,91697,0,0,91697,3056.5667
SAN DIEGO,Jul 2016,DCH,2016,CHICANO FEDERATION OF SAN DIEGO COUNTY INC,DCH_LUNCH,22,0,0,0,0,0,0,0,0,0
SAN DIEGO,Jul 2016,DCH,2016,CHICANO FEDERATION OF SAN DIEGO COUNTY INC,DCH_SNACK_AM,,0,0,0,0,0,291,2179,2470,0
SAN DIEGO,Jul 2016,DCH,2016,CHICANO FEDERATION OF SAN DIEGO COUNTY INC,DCH_SNACK_AM,22,0,0,0,0,0,0,0,0,0
SAN DIEGO,Jul 2016,DCH,2016,CHICANO FEDERATION OF SAN DIEGO COUNTY INC,DCH_SNACK_AM,25,0,0,0,0,0,0,0,0,0
SAN DIEGO,Jul 2016,DCH,2016,CHICANO FEDERATION OF SAN DIEGO COUNTY INC,DCH_SNACK_AM,25,0,0,0,0,0,0,0,0,0
SAN DIEGO,Jul 2016,DCH,2016,CHICANO FEDERATION OF SAN DIEGO COUNTY INC,DCH_SNACK_AM,30,0,0,0,0,42230,0,0,42230,1407.6667
SAN DIEGO,Jul 2016,DCH,2016,CHICANO FEDERATION OF SAN DIEGO COUNTY INC,DCH_SNACK_NT,25,0,0,0,0,0,0,0,0,0
SAN DIEGO,Jul 2016,DCH,2016,CHICANO FEDERATION OF SAN DIEGO COUNTY INC,DCH_SNACK_NT,30,0,0,0,0,7717,0,0,7717,257.2333
SAN DIEGO,Jul 2016,DCH,2016,CHICANO FEDERATION OF SAN DIEGO COUNTY INC,DCH_SNACK_NT,,0,0,0,0,0,0,15,15,0
SAN DIEGO,Jul 2016,DCH,2016,CHICANO FEDERATION OF SAN DIEGO COUNTY INC,DCH_SNACK_NT,22,0,0,0,0,0,0,0,0,0
SAN DIEGO,Jul 2016,DCH,2016,CHICANO FEDERATION OF SAN DIEGO COUNTY INC,DCH_SNACK_NT,25,0,0,0,0,0,0,0,0,0
SAN DIEGO,Jul 2016,DCH,2016,CHICANO FEDERATION OF SAN DIEGO COUNTY INC,DCH_SNACK_PM,,0,0,0,0,0,772,3438,4210,0
SAN DIEGO,Jul 2016,DCH,2016,CHICANO FEDERATION OF SAN DIEGO COUNTY INC,DCH_SNACK_PM,22,0,0,0,0,0,0,0,0,0
SAN DIEGO,Jul 2016,DCH,2016,CHICANO FEDERATION OF SAN DIEGO COUNTY INC,DCH_SNACK_PM,25,0,0,0,0,0,0,0,0,0
SAN DIEGO,Jul 2016,DCH,2016,CHICANO FEDERATION OF SAN DIEGO COUNTY INC,DCH_SNACK_PM,25,0,0,0,0,0,0,0,0,0
SAN DIEGO,Jul 2016,DCH,2016,CHICANO FEDERATION OF SAN DIEGO COUNTY INC,DCH_SNACK_PM,30,0,0,0,0,63522,0,0,63522,2117.4
SAN DIEGO,Jul 2016,DCH,2016,CHICANO FEDERATION OF SAN DIEGO COUNTY INC,DCH_SUPPER,25,0,0,0,0,0,0,0,0,0
SAN DIEGO,Jul 2016,DCH,2016,CHICANO FEDERATION OF SAN DIEGO COUNTY INC,DCH_SUPPER,30,0,0,0,0,74077,0,0,74077,2469.2333
SAN DIEGO,Jul 2016,DCH,2016,CHICANO FEDERATION OF SAN DIEGO COUNTY INC,DCH_SUPPER,,0,0,0,0,0,956,3752,4708,0
SAN DIEGO,Jul 2016,DCH,2016,CHICANO FEDERATION OF SAN DIEGO COUNTY INC,DCH_SUPPER,22,0,0,0,0,0,0,0,0,0
SAN DIEGO,Jul 2016,DCH,2016,CHICANO FEDERATION OF SAN DIEGO COUNTY INC,DCH_SUPPER,25,0,0,0,0,0,0,0,0,0
SAN DIEGO,Oct 2015,CACF,2016,CHILD DEVELOPMENT ASSOC INC ,CHILD_BREAKFAST,22,140,63,47,250,1746,785,586,3117,141.6818
SAN DIEGO,Oct 2015,CACF,2016,CHILD DEVELOPMENT ASSOC INC ,CHILD_LUNCH,22,140,63,47,250,2180,981,731,3892,176.9091
SAN DIEGO,Oct 2015,CACF,2016,CHILD DEVELOPMENT ASSOC INC ,CHILD_SNACK_PM,22,140,63,47,250,1837,827,617,3281,149.1364
SAN DIEGO,Oct 2015,DCH,2016,CHILD DEVELOPMENT ASSOC INC ,DCH_BREAKFAST,27,0,0,0,0,0,0,0,0,0
SAN DIEGO,Oct 2015,DCH,2016,CHILD DEVELOPMENT ASSOC INC ,DCH_BREAKFAST,,0,0,0,0,0,109,6849,6958,0
SAN DIEGO,Oct 2015,DCH,2016,CHILD DEVELOPMENT ASSOC INC ,DCH_BREAKFAST,23,0,0,0,0,0,0,0,0,0
SAN DIEGO,Oct 2015,DCH,2016,CHILD DEVELOPMENT ASSOC INC ,DCH_BREAKFAST,27,0,0,0,0,104706,0,0,104706,3878
SAN DIEGO,Oct 2015,DCH,2016,CHILD DEVELOPMENT ASSOC INC ,DCH_LUNCH,23,0,0,0,0,0,0,0,0,0
SAN DIEGO,Oct 2015,DCH,2016,CHILD DEVELOPMENT ASSOC INC ,DCH_LUNCH,27,0,0,0,0,118324,0,0,118324,4382.3704
SAN DIEGO,Oct 2015,DCH,2016,CHILD DEVELOPMENT ASSOC INC ,DCH_LUNCH,,0,0,0,0,0,119,11665,11784,0
SAN DIEGO,Oct 2015,DCH,2016,CHILD DEVELOPMENT ASSOC INC ,DCH_LUNCH,27,0,0,0,0,0,0,0,0,0
SAN DIEGO,Oct 2015,DCH,2016,CHILD DEVELOPMENT ASSOC INC ,DCH_SNACK_AM,27,0,0,0,0,51483,0,0,51483,1906.7778
SAN DIEGO,Oct 2015,DCH,2016,CHILD DEVELOPMENT ASSOC INC ,DCH_SNACK_AM,23,0,0,0,0,0,0,0,0,0
SAN DIEGO,Oct 2015,DCH,2016,CHILD DEVELOPMENT ASSOC INC ,DCH_SNACK_AM,27,0,0,0,0,0,0,0,0,0
SAN DIEGO,Oct 2015,DCH,2016,CHILD DEVELOPMENT ASSOC INC ,DCH_SNACK_AM,,0,0,0,0,0,54,6070,6124,0
SAN DIEGO,Oct 2015,DCH,2016,CHILD DEVELOPMENT ASSOC INC ,DCH_SNACK_NT,27,0,0,0,0,0,0,0,0,0
SAN DIEGO,Oct 2015,DCH,2016,CHILD DEVELOPMENT ASSOC INC ,DCH_SNACK_NT,23,0,0,0,0,0,0,0,0,0
SAN DIEGO,Oct 2015,DCH,2016,CHILD DEVELOPMENT ASSOC INC ,DCH_SNACK_NT,27,0,0,0,0,12676,0,0,12676,469.4815
SAN DIEGO,Oct 2015,DCH,2016,CHILD DEVELOPMENT ASSOC INC ,DCH_SNACK_NT,,0,0,0,0,0,0,401,401,0
SAN DIEGO,Oct 2015,DCH,2016,CHILD DEVELOPMENT ASSOC INC ,DCH_SNACK_PM,27,0,0,0,0,119615,0,0,119615,4430.1852
SAN DIEGO,Oct 2015,DCH,2016,CHILD DEVELOPMENT ASSOC INC ,DCH_SNACK_PM,,0,0,0,0,0,235,8742,8977,0
SAN DIEGO,Oct 2015,DCH,2016,CHILD DEVELOPMENT ASSOC INC ,DCH_SNACK_PM,27,0,0,0,0,0,0,0,0,0
SAN DIEGO,Oct 2015,DCH,2016,CHILD DEVELOPMENT ASSOC INC ,DCH_SNACK_PM,23,0,0,0,0,0,0,0,0,0
SAN DIEGO,Oct 2015,DCH,2016,CHILD DEVELOPMENT ASSOC INC ,DCH_SUPPER,,0,0,0,0,0,177,5336,5513,0
SAN DIEGO,Oct 2015,DCH,2016,CHILD DEVELOPMENT ASSOC INC ,DCH_SUPPER,23,0,0,0,0,0,0,0,0,0
SAN DIEGO,Oct 2015,DCH,2016,CHILD DEVELOPMENT ASSOC INC ,DCH_SUPPER,27,0,0,0,0,0,0,0,0,0
SAN DIEGO,Oct 2015,DCH,2016,CHILD DEVELOPMENT ASSOC INC ,DCH_SUPPER,27,0,0,0,0,90217,0,0,90217,3341.3704
SAN DIEGO,Nov 2015,CACF,2016,CHILD DEVELOPMENT ASSOC INC ,CHILD_BREAKFAST,19,140,63,47,250,1441,649,484,2574,135.4737
SAN DIEGO,Nov 2015,CACF,2016,CHILD DEVELOPMENT ASSOC INC ,CHILD_LUNCH,19,140,63,47,250,1777,800,596,3173,167
SAN DIEGO,Nov 2015,CACF,2016,CHILD DEVELOPMENT ASSOC INC ,CHILD_SNACK_PM,19,140,63,47,250,1494,672,501,2667,140.3684
SAN DIEGO,Nov 2015,DCH,2016,CHILD DEVELOPMENT ASSOC INC ,DCH_BREAKFAST,24,0,0,0,0,0,0,0,0,0
SAN DIEGO,Nov 2015,DCH,2016,CHILD DEVELOPMENT ASSOC INC ,DCH_BREAKFAST,20,0,0,0,0,0,0,0,0,0
SAN DIEGO,Nov 2015,DCH,2016,CHILD DEVELOPMENT ASSOC INC ,DCH_BREAKFAST,,0,0,0,0,0,67,5631,5698,0
SAN DIEGO,Nov 2015,DCH,2016,CHILD DEVELOPMENT ASSOC INC ,DCH_BREAKFAST,24,0,0,0,0,88528,0,0,88528,3688.6667
SAN DIEGO,Nov 2015,DCH,2016,CHILD DEVELOPMENT ASSOC INC ,DCH_LUNCH,24,0,0,0,0,109157,0,0,109157,4548.2083
SAN DIEGO,Nov 2015,DCH,2016,CHILD DEVELOPMENT ASSOC INC ,DCH_LUNCH,20,0,0,0,0,0,0,0,0,0
SAN DIEGO,Nov 2015,DCH,2016,CHILD DEVELOPMENT ASSOC INC ,DCH_LUNCH,24,0,0,0,0,0,0,0,0,0
SAN DIEGO,Nov 2015,DCH,2016,CHILD DEVELOPMENT ASSOC INC ,DCH_LUNCH,,0,0,0,0,0,124,10010,10134,0
SAN DIEGO,Nov 2015,DCH,2016,CHILD DEVELOPMENT ASSOC INC ,DCH_SNACK_AM,20,0,0,0,0,0,0,0,0,0
SAN DIEGO,Nov 2015,DCH,2016,CHILD DEVELOPMENT ASSOC INC ,DCH_SNACK_AM,24,0,0,0,0,0,0,0,0,0
SAN DIEGO,Nov 2015,DCH,2016,CHILD DEVELOPMENT ASSOC INC ,DCH_SNACK_AM,,0,0,0,0,0,52,5281,5333,0
SAN DIEGO,Nov 2015,DCH,2016,CHILD DEVELOPMENT ASSOC INC ,DCH_SNACK_AM,24,0,0,0,0,46788,0,0,46788,1949.5
SAN DIEGO,Nov 2015,DCH,2016,CHILD DEVELOPMENT ASSOC INC ,DCH_SNACK_NT,20,0,0,0,0,0,0,0,0,0
SAN DIEGO,Nov 2015,DCH,2016,CHILD DEVELOPMENT ASSOC INC ,DCH_SNACK_NT,24,0,0,0,0,10334,0,0,10334,430.5833
SAN DIEGO,Nov 2015,DCH,2016,CHILD DEVELOPMENT ASSOC INC ,DCH_SNACK_NT,24,0,0,0,0,0,0,0,0,0
SAN DIEGO,Nov 2015,DCH,2016,CHILD DEVELOPMENT ASSOC INC ,DCH_SNACK_NT,,0,0,0,0,0,0,233,233,0
SAN DIEGO,Nov 2015,DCH,2016,CHILD DEVELOPMENT ASSOC INC ,DCH_SNACK_PM,24,0,0,0,0,102611,0,0,102611,4275.4583
SAN DIEGO,Nov 2015,DCH,2016,CHILD DEVELOPMENT ASSOC INC ,DCH_SNACK_PM,20,0,0,0,0,0,0,0,0,0
SAN DIEGO,Nov 2015,DCH,2016,CHILD DEVELOPMENT ASSOC INC ,DCH_SNACK_PM,24,0,0,0,0,0,0,0,0,0
SAN DIEGO,Nov 2015,DCH,2016,CHILD DEVELOPMENT ASSOC INC ,DCH_SNACK_PM,,0,0,0,0,0,202,7139,7341,0
SAN DIEGO,Nov 2015,DCH,2016,CHILD DEVELOPMENT ASSOC INC ,DCH_SUPPER,24,0,0,0,0,78210,0,0,78210,3258.75
SAN DIEGO,Nov 2015,DCH,2016,CHILD DEVELOPMENT ASSOC INC ,DCH_SUPPER,20,0,0,0,0,0,0,0,0,0
SAN DIEGO,Nov 2015,DCH,2016,CHILD DEVELOPMENT ASSOC INC ,DCH_SUPPER,24,0,0,0,0,0,0,0,0,0
SAN DIEGO,Nov 2015,DCH,2016,CHILD DEVELOPMENT ASSOC INC ,DCH_SUPPER,,0,0,0,0,0,184,4583,4767,0
SAN DIEGO,Dec 2015,CACF,2016,CHILD DEVELOPMENT ASSOC INC ,CHILD_BREAKFAST,18,140,63,47,250,1264,569,424,2257,125.3889
SAN DIEGO,Dec 2015,CACF,2016,CHILD DEVELOPMENT ASSOC INC ,CHILD_LUNCH,18,140,63,47,250,1604,722,539,2865,159.1667
SAN DIEGO,Dec 2015,CACF,2016,CHILD DEVELOPMENT ASSOC INC ,CHILD_SNACK_PM,18,140,63,47,250,1333,600,447,2380,132.2222
SAN DIEGO,Dec 2015,DCH,2016,CHILD DEVELOPMENT ASSOC INC ,DCH_BREAKFAST,,0,0,0,0,0,96,5772,5868,0
SAN DIEGO,Dec 2015,DCH,2016,CHILD DEVELOPMENT ASSOC INC ,DCH_BREAKFAST,26,0,0,0,0,93676,0,0,93676,3602.9231
SAN DIEGO,Dec 2015,DCH,2016,CHILD DEVELOPMENT ASSOC INC ,DCH_BREAKFAST,26,0,0,0,0,0,0,0,0,0
SAN DIEGO,Dec 2015,DCH,2016,CHILD DEVELOPMENT ASSOC INC ,DCH_BREAKFAST,22,0,0,0,0,0,0,0,0,0
SAN DIEGO,Dec 2015,DCH,2016,CHILD DEVELOPMENT ASSOC INC ,DCH_LUNCH,26,0,0,0,0,121725,0,0,121725,4681.7308
SAN DIEGO,Dec 2015,DCH,2016,CHILD DEVELOPMENT ASSOC INC ,DCH_LUNCH,,0,0,0,0,0,146,10426,10572,0
SAN DIEGO,Dec 2015,DCH,2016,CHILD DEVELOPMENT ASSOC INC ,DCH_LUNCH,26,0,0,0,0,0,0,0,0,0
SAN DIEGO,Dec 2015,DCH,2016,CHILD DEVELOPMENT ASSOC INC ,DCH_LUNCH,22,0,0,0,0,0,0,0,0,0
SAN DIEGO,Dec 2015,DCH,2016,CHILD DEVELOPMENT ASSOC INC ,DCH_SNACK_AM,22,0,0,0,0,0,0,0,0,0
SAN DIEGO,Dec 2015,DCH,2016,CHILD DEVELOPMENT ASSOC INC ,DCH_SNACK_AM,26,0,0,0,0,53134,0,0,53134,2043.6154
SAN DIEGO,Dec 2015,DCH,2016,CHILD DEVELOPMENT ASSOC INC ,DCH_SNACK_AM,,0,0,0,0,0,68,5496,5564,0
SAN DIEGO,Dec 2015,DCH,2016,CHILD DEVELOPMENT ASSOC INC ,DCH_SNACK_AM,26,0,0,0,0,0,0,0,0,0
SAN DIEGO,Dec 2015,DCH,2016,CHILD DEVELOPMENT ASSOC INC ,DCH_SNACK_NT,22,0,0,0,0,0,0,0,0,0
SAN DIEGO,Dec 2015,DCH,2016,CHILD DEVELOPMENT ASSOC INC ,DCH_SNACK_NT,,0,0,0,0,0,0,261,261,0
SAN DIEGO,Dec 2015,DCH,2016,CHILD DEVELOPMENT ASSOC INC ,DCH_SNACK_NT,26,0,0,0,0,11227,0,0,11227,431.8077
SAN DIEGO,Dec 2015,DCH,2016,CHILD DEVELOPMENT ASSOC INC ,DCH_SNACK_NT,26,0,0,0,0,0,0,0,0,0
SAN DIEGO,Dec 2015,DCH,2016,CHILD DEVELOPMENT ASSOC INC ,DCH_SNACK_PM,22,0,0,0,0,0,0,0,0,0
SAN DIEGO,Dec 2015,DCH,2016,CHILD DEVELOPMENT ASSOC INC ,DCH_SNACK_PM,26,0,0,0,0,0,0,0,0,0
SAN DIEGO,Dec 2015,DCH,2016,CHILD DEVELOPMENT ASSOC INC ,DCH_SNACK_PM,26,0,0,0,0,108892,0,0,108892,4188.1538
SAN DIEGO,Dec 2015,DCH,2016,CHILD DEVELOPMENT ASSOC INC ,DCH_SNACK_PM,,0,0,0,0,0,208,7353,7561,0
SAN DIEGO,Dec 2015,DCH,2016,CHILD DEVELOPMENT ASSOC INC ,DCH_SUPPER,22,0,0,0,0,0,0,0,0,0
SAN DIEGO,Dec 2015,DCH,2016,CHILD DEVELOPMENT ASSOC INC ,DCH_SUPPER,26,0,0,0,0,0,0,0,0,0
SAN DIEGO,Dec 2015,DCH,2016,CHILD DEVELOPMENT ASSOC INC ,DCH_SUPPER,26,0,0,0,0,83074,0,0,83074,3195.1538
SAN DIEGO,Dec 2015,DCH,2016,CHILD DEVELOPMENT ASSOC INC ,DCH_SUPPER,,0,0,0,0,0,180,4806,4986,0
SAN DIEGO,Jan 2016,CACF,2016,CHILD DEVELOPMENT ASSOC INC ,CHILD_BREAKFAST,19,140,63,47,250,1416,637,476,2529,133.1053
SAN DIEGO,Jan 2016,CACF,2016,CHILD DEVELOPMENT ASSOC INC ,CHILD_LUNCH,19,140,63,47,250,1798,809,603,3210,168.9474
SAN DIEGO,Jan 2016,CACF,2016,CHILD DEVELOPMENT ASSOC INC ,CHILD_SNACK_PM,19,140,63,47,250,1509,679,506,2694,141.7895
SAN DIEGO,Jan 2016,DCH,2016,CHILD DEVELOPMENT ASSOC INC ,DCH_BREAKFAST,20,0,0,0,0,0,0,0,0,0
SAN DIEGO,Jan 2016,DCH,2016,CHILD DEVELOPMENT ASSOC INC ,DCH_BREAKFAST,25,0,0,0,0,0,0,0,0,0
SAN DIEGO,Jan 2016,DCH,2016,CHILD DEVELOPMENT ASSOC INC ,DCH_BREAKFAST,,0,0,0,0,0,88,6080,6168,0
SAN DIEGO,Jan 2016,DCH,2016,CHILD DEVELOPMENT ASSOC INC ,DCH_BREAKFAST,25,0,0,0,0,93085,0,0,93085,3723.4
SAN DIEGO,Jan 2016,DCH,2016,CHILD DEVELOPMENT ASSOC INC ,DCH_LUNCH,,0,0,0,0,0,113,10553,10666,0
SAN DIEGO,Jan 2016,DCH,2016,CHILD DEVELOPMENT ASSOC INC ,DCH_LUNCH,25,0,0,0,0,113614,0,0,113614,4544.56
SAN DIEGO,Jan 2016,DCH,2016,CHILD DEVELOPMENT ASSOC INC ,DCH_LUNCH,20,0,0,0,0,0,0,0,0,0
SAN DIEGO,Jan 2016,DCH,2016,CHILD DEVELOPMENT ASSOC INC ,DCH_LUNCH,25,0,0,0,0,0,0,0,0,0
SAN DIEGO,Jan 2016,DCH,2016,CHILD DEVELOPMENT ASSOC INC ,DCH_SNACK_AM,25,0,0,0,0,51147,0,0,51147,2045.88
SAN DIEGO,Jan 2016,DCH,2016,CHILD DEVELOPMENT ASSOC INC ,DCH_SNACK_AM,25,0,0,0,0,0,0,0,0,0
SAN DIEGO,Jan 2016,DCH,2016,CHILD DEVELOPMENT ASSOC INC ,DCH_SNACK_AM,,0,0,0,0,0,54,5562,5616,0
SAN DIEGO,Jan 2016,DCH,2016,CHILD DEVELOPMENT ASSOC INC ,DCH_SNACK_AM,20,0,0,0,0,0,0,0,0,0
SAN DIEGO,Jan 2016,DCH,2016,CHILD DEVELOPMENT ASSOC INC ,DCH_SNACK_NT,25,0,0,0,0,11466,0,0,11466,458.64
SAN DIEGO,Jan 2016,DCH,2016,CHILD DEVELOPMENT ASSOC INC ,DCH_SNACK_NT,,0,0,0,0,0,0,346,346,0
SAN DIEGO,Jan 2016,DCH,2016,CHILD DEVELOPMENT ASSOC INC ,DCH_SNACK_NT,20,0,0,0,0,0,0,0,0,0
SAN DIEGO,Jan 2016,DCH,2016,CHILD DEVELOPMENT ASSOC INC ,DCH_SNACK_NT,25,0,0,0,0,0,0,0,0,0
SAN DIEGO,Jan 2016,DCH,2016,CHILD DEVELOPMENT ASSOC INC ,DCH_SNACK_PM,20,0,0,0,0,0,0,0,0,0
SAN DIEGO,Jan 2016,DCH,2016,CHILD DEVELOPMENT ASSOC INC ,DCH_SNACK_PM,25,0,0,0,0,105978,0,0,105978,4239.12
SAN DIEGO,Jan 2016,DCH,2016,CHILD DEVELOPMENT ASSOC INC ,DCH_SNACK_PM,,0,0,0,0,0,198,7779,7977,0
SAN DIEGO,Jan 2016,DCH,2016,CHILD DEVELOPMENT ASSOC INC ,DCH_SNACK_PM,25,0,0,0,0,0,0,0,0,0
SAN DIEGO,Jan 2016,DCH,2016,CHILD DEVELOPMENT ASSOC INC ,DCH_SUPPER,25,0,0,0,0,80831,0,0,80831,3233.24
SAN DIEGO,Jan 2016,DCH,2016,CHILD DEVELOPMENT ASSOC INC ,DCH_SUPPER,20,0,0,0,0,0,0,0,0,0
SAN DIEGO,Jan 2016,DCH,2016,CHILD DEVELOPMENT ASSOC INC ,DCH_SUPPER,,0,0,0,0,0,177,4631,4808,0
SAN DIEGO,Jan 2016,DCH,2016,CHILD DEVELOPMENT ASSOC INC ,DCH_SUPPER,25,0,0,0,0,0,0,0,0,0
SAN DIEGO,Feb 2016,CACF,2016,CHILD DEVELOPMENT ASSOC INC ,CHILD_BREAKFAST,20,140,63,47,250,1586,714,533,2833,141.65
SAN DIEGO,Feb 2016,CACF,2016,CHILD DEVELOPMENT ASSOC INC ,CHILD_LUNCH,20,140,63,47,250,2027,912,680,3619,180.95
SAN DIEGO,Feb 2016,CACF,2016,CHILD DEVELOPMENT ASSOC INC ,CHILD_SNACK_PM,20,140,63,47,250,1696,763,570,3029,151.45
SAN DIEGO,Feb 2016,DCH,2016,CHILD DEVELOPMENT ASSOC INC ,DCH_BREAKFAST,21,0,0,0,0,0,0,0,0,0
SAN DIEGO,Feb 2016,DCH,2016,CHILD DEVELOPMENT ASSOC INC ,DCH_BREAKFAST,25,0,0,0,0,98834,0,0,98834,3953.36
SAN DIEGO,Feb 2016,DCH,2016,CHILD DEVELOPMENT ASSOC INC ,DCH_BREAKFAST,,0,0,0,0,0,185,5923,6108,0
SAN DIEGO,Feb 2016,DCH,2016,CHILD DEVELOPMENT ASSOC INC ,DCH_BREAKFAST,21,0,0,0,0,0,0,0,0,0
SAN DIEGO,Feb 2016,DCH,2016,CHILD DEVELOPMENT ASSOC INC ,DCH_BREAKFAST,25,0,0,0,0,0,0,0,0,0
SAN DIEGO,Feb 2016,DCH,2016,CHILD DEVELOPMENT ASSOC INC ,DCH_LUNCH,,0,0,0,0,0,208,10626,10834,0
SAN DIEGO,Feb 2016,DCH,2016,CHILD DEVELOPMENT ASSOC INC ,DCH_LUNCH,21,0,0,0,0,0,0,0,0,0
SAN DIEGO,Feb 2016,DCH,2016,CHILD DEVELOPMENT ASSOC INC ,DCH_LUNCH,25,0,0,0,0,0,0,0,0,0
SAN DIEGO,Feb 2016,DCH,2016,CHILD DEVELOPMENT ASSOC INC ,DCH_LUNCH,21,0,0,0,0,0,0,0,0,0
SAN DIEGO,Feb 2016,DCH,2016,CHILD DEVELOPMENT ASSOC INC ,DCH_LUNCH,25,0,0,0,0,116427,0,0,116427,4657.08
SAN DIEGO,Feb 2016,DCH,2016,CHILD DEVELOPMENT ASSOC INC ,DCH_SNACK_AM,25,0,0,0,0,51374,0,0,51374,2054.96
SAN DIEGO,Feb 2016,DCH,2016,CHILD DEVELOPMENT ASSOC INC ,DCH_SNACK_AM,,0,0,0,0,0,123,5750,5873,0
SAN DIEGO,Feb 2016,DCH,2016,CHILD DEVELOPMENT ASSOC INC ,DCH_SNACK_AM,21,0,0,0,0,0,0,0,0,0
SAN DIEGO,Feb 2016,DCH,2016,CHILD DEVELOPMENT ASSOC INC ,DCH_SNACK_AM,25,0,0,0,0,0,0,0,0,0
SAN DIEGO,Feb 2016,DCH,2016,CHILD DEVELOPMENT ASSOC INC ,DCH_SNACK_AM,21,0,0,0,0,0,0,0,0,0
SAN DIEGO,Feb 2016,DCH,2016,CHILD DEVELOPMENT ASSOC INC ,DCH_SNACK_NT,21,0,0,0,0,0,0,0,0,0
SAN DIEGO,Feb 2016,DCH,2016,CHILD DEVELOPMENT ASSOC INC ,DCH_SNACK_NT,25,0,0,0,0,0,0,0,0,0
SAN DIEGO,Feb 2016,DCH,2016,CHILD DEVELOPMENT ASSOC INC ,DCH_SNACK_NT,,0,0,0,0,0,123,329,452,0
SAN DIEGO,Feb 2016,DCH,2016,CHILD DEVELOPMENT ASSOC INC ,DCH_SNACK_NT,25,0,0,0,0,12311,0,0,12311,492.44
SAN DIEGO,Feb 2016,DCH,2016,CHILD DEVELOPMENT ASSOC INC ,DCH_SNACK_NT,21,0,0,0,0,0,0,0,0,0
SAN DIEGO,Feb 2016,DCH,2016,CHILD DEVELOPMENT ASSOC INC ,DCH_SNACK_PM,25,0,0,0,0,111914,0,0,111914,4476.56
SAN DIEGO,Feb 2016,DCH,2016,CHILD DEVELOPMENT ASSOC INC ,DCH_SNACK_PM,,0,0,0,0,0,288,7594,7882,0
SAN DIEGO,Feb 2016,DCH,2016,CHILD DEVELOPMENT ASSOC INC ,DCH_SNACK_PM,21,0,0,0,0,0,0,0,0,0
SAN DIEGO,Feb 2016,DCH,2016,CHILD DEVELOPMENT ASSOC INC ,DCH_SNACK_PM,25,0,0,0,0,0,0,0,0,0
SAN DIEGO,Feb 2016,DCH,2016,CHILD DEVELOPMENT ASSOC INC ,DCH_SNACK_PM,21,0,0,0,0,0,0,0,0,0
SAN DIEGO,Feb 2016,DCH,2016,CHILD DEVELOPMENT ASSOC INC ,DCH_SUPPER,25,0,0,0,0,84835,0,0,84835,3393.4
SAN DIEGO,Feb 2016,DCH,2016,CHILD DEVELOPMENT ASSOC INC ,DCH_SUPPER,,0,0,0,0,0,307,5093,5400,0
SAN DIEGO,Feb 2016,DCH,2016,CHILD DEVELOPMENT ASSOC INC ,DCH_SUPPER,21,0,0,0,0,0,0,0,0,0
SAN DIEGO,Feb 2016,DCH,2016,CHILD DEVELOPMENT ASSOC INC ,DCH_SUPPER,25,0,0,0,0,0,0,0,0,0
SAN DIEGO,Feb 2016,DCH,2016,CHILD DEVELOPMENT ASSOC INC ,DCH_SUPPER,21,0,0,0,0,0,0,0,0,0
SAN DIEGO,Mar 2016,CACF,2016,CHILD DEVELOPMENT ASSOC INC ,CHILD_BREAKFAST,23,140,63,47,250,1707,768,574,3049,132.5652
SAN DIEGO,Mar 2016,CACF,2016,CHILD DEVELOPMENT ASSOC INC ,CHILD_LUNCH,23,140,63,47,250,2200,990,738,3928,170.7826
SAN DIEGO,Mar 2016,CACF,2016,CHILD DEVELOPMENT ASSOC INC ,CHILD_SNACK_PM,23,140,63,47,250,1872,842,629,3343,145.3478
SAN DIEGO,Mar 2016,DCH,2016,CHILD DEVELOPMENT ASSOC INC ,DCH_BREAKFAST,27,0,0,0,0,107980,0,0,107980,3999.2593
SAN DIEGO,Mar 2016,DCH,2016,CHILD DEVELOPMENT ASSOC INC ,DCH_BREAKFAST,23,0,0,0,0,0,0,0,0,0
SAN DIEGO,Mar 2016,DCH,2016,CHILD DEVELOPMENT ASSOC INC ,DCH_BREAKFAST,27,0,0,0,0,0,0,0,0,0
SAN DIEGO,Mar 2016,DCH,2016,CHILD DEVELOPMENT ASSOC INC ,DCH_BREAKFAST,,0,0,0,0,0,111,6532,6643,0
SAN DIEGO,Mar 2016,DCH,2016,CHILD DEVELOPMENT ASSOC INC ,DCH_LUNCH,27,0,0,0,0,0,0,0,0,0
SAN DIEGO,Mar 2016,DCH,2016,CHILD DEVELOPMENT ASSOC INC ,DCH_LUNCH,23,0,0,0,0,0,0,0,0,0
SAN DIEGO,Mar 2016,DCH,2016,CHILD DEVELOPMENT ASSOC INC ,DCH_LUNCH,,0,0,0,0,0,125,11965,12090,0
SAN DIEGO,Mar 2016,DCH,2016,CHILD DEVELOPMENT ASSOC INC ,DCH_LUNCH,27,0,0,0,0,137434,0,0,137434,5090.1481
SAN DIEGO,Mar 2016,DCH,2016,CHILD DEVELOPMENT ASSOC INC ,DCH_SNACK_AM,23,0,0,0,0,0,0,0,0,0
SAN DIEGO,Mar 2016,DCH,2016,CHILD DEVELOPMENT ASSOC INC ,DCH_SNACK_AM,27,0,0,0,0,60818,0,0,60818,2252.5185
SAN DIEGO,Mar 2016,DCH,2016,CHILD DEVELOPMENT ASSOC INC ,DCH_SNACK_AM,27,0,0,0,0,0,0,0,0,0
SAN DIEGO,Mar 2016,DCH,2016,CHILD DEVELOPMENT ASSOC INC ,DCH_SNACK_AM,,0,0,0,0,0,62,6708,6770,0
SAN DIEGO,Mar 2016,DCH,2016,CHILD DEVELOPMENT ASSOC INC ,DCH_SNACK_NT,23,0,0,0,0,0,0,0,0,0
SAN DIEGO,Mar 2016,DCH,2016,CHILD DEVELOPMENT ASSOC INC ,DCH_SNACK_NT,27,0,0,0,0,0,0,0,0,0
SAN DIEGO,Mar 2016,DCH,2016,CHILD DEVELOPMENT ASSOC INC ,DCH_SNACK_NT,27,0,0,0,0,12482,0,0,12482,462.2963
SAN DIEGO,Mar 2016,DCH,2016,CHILD DEVELOPMENT ASSOC INC ,DCH_SNACK_NT,,0,0,0,0,0,13,354,367,0
SAN DIEGO,Mar 2016,DCH,2016,CHILD DEVELOPMENT ASSOC INC ,DCH_SNACK_PM,,0,0,0,0,0,168,8102,8270,0
SAN DIEGO,Mar 2016,DCH,2016,CHILD DEVELOPMENT ASSOC INC ,DCH_SNACK_PM,23,0,0,0,0,0,0,0,0,0
SAN DIEGO,Mar 2016,DCH,2016,CHILD DEVELOPMENT ASSOC INC ,DCH_SNACK_PM,27,0,0,0,0,0,0,0,0,0
SAN DIEGO,Mar 2016,DCH,2016,CHILD DEVELOPMENT ASSOC INC ,DCH_SNACK_PM,27,0,0,0,0,122586,0,0,122586,4540.2222
SAN DIEGO,Mar 2016,DCH,2016,CHILD DEVELOPMENT ASSOC INC ,DCH_SUPPER,27,0,0,0,0,0,0,0,0,0
SAN DIEGO,Mar 2016,DCH,2016,CHILD DEVELOPMENT ASSOC INC ,DCH_SUPPER,,0,0,0,0,0,206,5548,5754,0
SAN DIEGO,Mar 2016,DCH,2016,CHILD DEVELOPMENT ASSOC INC ,DCH_SUPPER,27,0,0,0,0,91485,0,0,91485,3388.3333
SAN DIEGO,Mar 2016,DCH,2016,CHILD DEVELOPMENT ASSOC INC ,DCH_SUPPER,23,0,0,0,0,0,0,0,0,0
SAN DIEGO,Apr 2016,CACF,2016,CHILD DEVELOPMENT ASSOC INC ,CHILD_BREAKFAST,21,140,63,47,250,1701,766,571,3038,144.6667
SAN DIEGO,Apr 2016,CACF,2016,CHILD DEVELOPMENT ASSOC INC ,CHILD_LUNCH,21,140,63,47,250,2182,982,732,3896,185.5238
SAN DIEGO,Apr 2016,CACF,2016,CHILD DEVELOPMENT ASSOC INC ,CHILD_SNACK_PM,21,140,63,47,250,1844,830,619,3293,156.8095
SAN DIEGO,Apr 2016,DCH,2016,CHILD DEVELOPMENT ASSOC INC ,DCH_BREAKFAST,26,0,0,0,0,104359,0,0,104359,4013.8077
SAN DIEGO,Apr 2016,DCH,2016,CHILD DEVELOPMENT ASSOC INC ,DCH_BREAKFAST,,0,0,0,0,0,82,6057,6139,0
SAN DIEGO,Apr 2016,DCH,2016,CHILD DEVELOPMENT ASSOC INC ,DCH_BREAKFAST,21,0,0,0,0,0,0,0,0,0
SAN DIEGO,Apr 2016,DCH,2016,CHILD DEVELOPMENT ASSOC INC ,DCH_BREAKFAST,26,0,0,0,0,0,0,0,0,0
SAN DIEGO,Apr 2016,DCH,2016,CHILD DEVELOPMENT ASSOC INC ,DCH_LUNCH,26,0,0,0,0,124817,0,0,124817,4800.6538
SAN DIEGO,Apr 2016,DCH,2016,CHILD DEVELOPMENT ASSOC INC ,DCH_LUNCH,,0,0,0,0,0,121,11249,11370,0
SAN DIEGO,Apr 2016,DCH,2016,CHILD DEVELOPMENT ASSOC INC ,DCH_LUNCH,26,0,0,0,0,0,0,0,0,0
SAN DIEGO,Apr 2016,DCH,2016,CHILD DEVELOPMENT ASSOC INC ,DCH_LUNCH,21,0,0,0,0,0,0,0,0,0
SAN DIEGO,Apr 2016,DCH,2016,CHILD DEVELOPMENT ASSOC INC ,DCH_SNACK_AM,,0,0,0,0,0,53,6323,6376,0
SAN DIEGO,Apr 2016,DCH,2016,CHILD DEVELOPMENT ASSOC INC ,DCH_SNACK_AM,26,0,0,0,0,0,0,0,0,0
SAN DIEGO,Apr 2016,DCH,2016,CHILD DEVELOPMENT ASSOC INC ,DCH_SNACK_AM,26,0,0,0,0,55832,0,0,55832,2147.3846
SAN DIEGO,Apr 2016,DCH,2016,CHILD DEVELOPMENT ASSOC INC ,DCH_SNACK_AM,21,0,0,0,0,0,0,0,0,0
SAN DIEGO,Apr 2016,DCH,2016,CHILD DEVELOPMENT ASSOC INC ,DCH_SNACK_NT,21,0,0,0,0,0,0,0,0,0
SAN DIEGO,Apr 2016,DCH,2016,CHILD DEVELOPMENT ASSOC INC ,DCH_SNACK_NT,26,0,0,0,0,12643,0,0,12643,486.2692
SAN DIEGO,Apr 2016,DCH,2016,CHILD DEVELOPMENT ASSOC INC ,DCH_SNACK_NT,,0,0,0,0,0,12,336,348,0
SAN DIEGO,Apr 2016,DCH,2016,CHILD DEVELOPMENT ASSOC INC ,DCH_SNACK_NT,26,0,0,0,0,0,0,0,0,0
SAN DIEGO,Apr 2016,DCH,2016,CHILD DEVELOPMENT ASSOC INC ,DCH_SNACK_PM,26,0,0,0,0,0,0,0,0,0
SAN DIEGO,Apr 2016,DCH,2016,CHILD DEVELOPMENT ASSOC INC ,DCH_SNACK_PM,21,0,0,0,0,0,0,0,0,0
SAN DIEGO,Apr 2016,DCH,2016,CHILD DEVELOPMENT ASSOC INC ,DCH_SNACK_PM,26,0,0,0,0,116251,0,0,116251,4471.1923
SAN DIEGO,Apr 2016,DCH,2016,CHILD DEVELOPMENT ASSOC INC ,DCH_SNACK_PM,,0,0,0,0,0,161,7658,7819,0
SAN DIEGO,Apr 2016,DCH,2016,CHILD DEVELOPMENT ASSOC INC ,DCH_SUPPER,26,0,0,0,0,86906,0,0,86906,3342.5385
SAN DIEGO,Apr 2016,DCH,2016,CHILD DEVELOPMENT ASSOC INC ,DCH_SUPPER,,0,0,0,0,0,179,5090,5269,0
SAN DIEGO,Apr 2016,DCH,2016,CHILD DEVELOPMENT ASSOC INC ,DCH_SUPPER,26,0,0,0,0,0,0,0,0,0
SAN DIEGO,Apr 2016,DCH,2016,CHILD DEVELOPMENT ASSOC INC ,DCH_SUPPER,21,0,0,0,0,0,0,0,0,0
SAN DIEGO,May 2016,CACF,2016,CHILD DEVELOPMENT ASSOC INC ,CHILD_BREAKFAST,21,140,63,47,250,1681,756,564,3001,142.9048
SAN DIEGO,May 2016,CACF,2016,CHILD DEVELOPMENT ASSOC INC ,CHILD_LUNCH,21,140,63,47,250,2205,992,740,3937,187.4762
SAN DIEGO,May 2016,CACF,2016,CHILD DEVELOPMENT ASSOC INC ,CHILD_SNACK_PM,21,140,63,47,250,1872,842,628,3342,159.1429
SAN DIEGO,May 2016,DCH,2016,CHILD DEVELOPMENT ASSOC INC ,DCH_BREAKFAST,21,0,0,0,0,0,0,0,0,0
SAN DIEGO,May 2016,DCH,2016,CHILD DEVELOPMENT ASSOC INC ,DCH_BREAKFAST,25,0,0,0,0,0,0,0,0,0
SAN DIEGO,May 2016,DCH,2016,CHILD DEVELOPMENT ASSOC INC ,DCH_BREAKFAST,,0,0,0,0,0,78,6364,6442,0
SAN DIEGO,May 2016,DCH,2016,CHILD DEVELOPMENT ASSOC INC ,DCH_BREAKFAST,25,0,0,0,0,104155,0,0,104155,4166.2
SAN DIEGO,May 2016,DCH,2016,CHILD DEVELOPMENT ASSOC INC ,DCH_LUNCH,21,0,0,0,0,0,0,0,0,0
SAN DIEGO,May 2016,DCH,2016,CHILD DEVELOPMENT ASSOC INC ,DCH_LUNCH,25,0,0,0,0,121780,0,0,121780,4871.2
SAN DIEGO,May 2016,DCH,2016,CHILD DEVELOPMENT ASSOC INC ,DCH_LUNCH,,0,0,0,0,0,136,11546,11682,0
SAN DIEGO,May 2016,DCH,2016,CHILD DEVELOPMENT ASSOC INC ,DCH_LUNCH,25,0,0,0,0,0,0,0,0,0
SAN DIEGO,May 2016,DCH,2016,CHILD DEVELOPMENT ASSOC INC ,DCH_SNACK_AM,25,0,0,0,0,55008,0,0,55008,2200.32
SAN DIEGO,May 2016,DCH,2016,CHILD DEVELOPMENT ASSOC INC ,DCH_SNACK_AM,,0,0,0,0,0,54,6342,6396,0
SAN DIEGO,May 2016,DCH,2016,CHILD DEVELOPMENT ASSOC INC ,DCH_SNACK_AM,25,0,0,0,0,0,0,0,0,0
SAN DIEGO,May 2016,DCH,2016,CHILD DEVELOPMENT ASSOC INC ,DCH_SNACK_AM,21,0,0,0,0,0,0,0,0,0
SAN DIEGO,May 2016,DCH,2016,CHILD DEVELOPMENT ASSOC INC ,DCH_SNACK_NT,25,0,0,0,0,0,0,0,0,0
SAN DIEGO,May 2016,DCH,2016,CHILD DEVELOPMENT ASSOC INC ,DCH_SNACK_NT,,0,0,0,0,0,12,359,371,0
SAN DIEGO,May 2016,DCH,2016,CHILD DEVELOPMENT ASSOC INC ,DCH_SNACK_NT,25,0,0,0,0,12940,0,0,12940,517.6
SAN DIEGO,May 2016,DCH,2016,CHILD DEVELOPMENT ASSOC INC ,DCH_SNACK_NT,21,0,0,0,0,0,0,0,0,0
SAN DIEGO,May 2016,DCH,2016,CHILD DEVELOPMENT ASSOC INC ,DCH_SNACK_PM,25,0,0,0,0,115914,0,0,115914,4636.56
SAN DIEGO,May 2016,DCH,2016,CHILD DEVELOPMENT ASSOC INC ,DCH_SNACK_PM,,0,0,0,0,0,180,8080,8260,0
SAN DIEGO,May 2016,DCH,2016,CHILD DEVELOPMENT ASSOC INC ,DCH_SNACK_PM,25,0,0,0,0,0,0,0,0,0
SAN DIEGO,May 2016,DCH,2016,CHILD DEVELOPMENT ASSOC INC ,DCH_SNACK_PM,21,0,0,0,0,0,0,0,0,0
SAN DIEGO,May 2016,DCH,2016,CHILD DEVELOPMENT ASSOC INC ,DCH_SUPPER,25,0,0,0,0,0,0,0,0,0
SAN DIEGO,May 2016,DCH,2016,CHILD DEVELOPMENT ASSOC INC ,DCH_SUPPER,25,0,0,0,0,87058,0,0,87058,3482.32
SAN DIEGO,May 2016,DCH,2016,CHILD DEVELOPMENT ASSOC INC ,DCH_SUPPER,,0,0,0,0,0,179,5062,5241,0
SAN DIEGO,May 2016,DCH,2016,CHILD DEVELOPMENT ASSOC INC ,DCH_SUPPER,21,0,0,0,0,0,0,0,0,0
SAN DIEGO,Jun 2016,CACF,2016,CHILD DEVELOPMENT ASSOC INC ,CHILD_BREAKFAST,22,140,63,47,250,1446,651,485,2582,117.3636
SAN DIEGO,Jun 2016,CACF,2016,CHILD DEVELOPMENT ASSOC INC ,CHILD_LUNCH,22,140,63,47,250,1991,896,669,3556,161.6364
SAN DIEGO,Jun 2016,CACF,2016,CHILD DEVELOPMENT ASSOC INC ,CHILD_SNACK_PM,22,140,63,47,250,1640,738,551,2929,133.1364
SAN DIEGO,Jun 2016,DCH,2016,CHILD DEVELOPMENT ASSOC INC ,DCH_BREAKFAST,26,0,0,0,0,100546,0,0,100546,3867.1538
SAN DIEGO,Jun 2016,DCH,2016,CHILD DEVELOPMENT ASSOC INC ,DCH_BREAKFAST,,0,0,0,0,0,138,5805,5943,0
SAN DIEGO,Jun 2016,DCH,2016,CHILD DEVELOPMENT ASSOC INC ,DCH_BREAKFAST,22,0,0,0,0,0,0,0,0,0
SAN DIEGO,Jun 2016,DCH,2016,CHILD DEVELOPMENT ASSOC INC ,DCH_BREAKFAST,26,0,0,0,0,0,0,0,0,0
SAN DIEGO,Jun 2016,DCH,2016,CHILD DEVELOPMENT ASSOC INC ,DCH_BREAKFAST,25,0,0,0,0,0,0,0,0,0
SAN DIEGO,Jun 2016,DCH,2016,CHILD DEVELOPMENT ASSOC INC ,DCH_LUNCH,22,0,0,0,0,0,0,0,0,0
SAN DIEGO,Jun 2016,DCH,2016,CHILD DEVELOPMENT ASSOC INC ,DCH_LUNCH,,0,0,0,0,0,224,12071,12295,0
SAN DIEGO,Jun 2016,DCH,2016,CHILD DEVELOPMENT ASSOC INC ,DCH_LUNCH,26,0,0,0,0,0,0,0,0,0
SAN DIEGO,Jun 2016,DCH,2016,CHILD DEVELOPMENT ASSOC INC ,DCH_LUNCH,25,0,0,0,0,0,0,0,0,0
SAN DIEGO,Jun 2016,DCH,2016,CHILD DEVELOPMENT ASSOC INC ,DCH_LUNCH,26,0,0,0,0,149939,0,0,149939,5766.8846
SAN DIEGO,Jun 2016,DCH,2016,CHILD DEVELOPMENT ASSOC INC ,DCH_SNACK_AM,26,0,0,0,0,66234,0,0,66234,2547.4615
SAN DIEGO,Jun 2016,DCH,2016,CHILD DEVELOPMENT ASSOC INC ,DCH_SNACK_AM,,0,0,0,0,0,140,6785,6925,0
SAN DIEGO,Jun 2016,DCH,2016,CHILD DEVELOPMENT ASSOC INC ,DCH_SNACK_AM,22,0,0,0,0,0,0,0,0,0
SAN DIEGO,Jun 2016,DCH,2016,CHILD DEVELOPMENT ASSOC INC ,DCH_SNACK_AM,26,0,0,0,0,0,0,0,0,0
SAN DIEGO,Jun 2016,DCH,2016,CHILD DEVELOPMENT ASSOC INC ,DCH_SNACK_AM,25,0,0,0,0,0,0,0,0,0
SAN DIEGO,Jun 2016,DCH,2016,CHILD DEVELOPMENT ASSOC INC ,DCH_SNACK_NT,22,0,0,0,0,0,0,0,0,0
SAN DIEGO,Jun 2016,DCH,2016,CHILD DEVELOPMENT ASSOC INC ,DCH_SNACK_NT,,0,0,0,0,0,3,192,195,0
SAN DIEGO,Jun 2016,DCH,2016,CHILD DEVELOPMENT ASSOC INC ,DCH_SNACK_NT,26,0,0,0,0,0,0,0,0,0
SAN DIEGO,Jun 2016,DCH,2016,CHILD DEVELOPMENT ASSOC INC ,DCH_SNACK_NT,25,0,0,0,0,0,0,0,0,0
SAN DIEGO,Jun 2016,DCH,2016,CHILD DEVELOPMENT ASSOC INC ,DCH_SNACK_NT,26,0,0,0,0,10598,0,0,10598,407.6154
SAN DIEGO,Jun 2016,DCH,2016,CHILD DEVELOPMENT ASSOC INC ,DCH_SNACK_PM,26,0,0,0,0,114747,0,0,114747,4413.3462
SAN DIEGO,Jun 2016,DCH,2016,CHILD DEVELOPMENT ASSOC INC ,DCH_SNACK_PM,,0,0,0,0,0,224,7222,7446,0
SAN DIEGO,Jun 2016,DCH,2016,CHILD DEVELOPMENT ASSOC INC ,DCH_SNACK_PM,25,0,0,0,0,0,0,0,0,0
SAN DIEGO,Jun 2016,DCH,2016,CHILD DEVELOPMENT ASSOC INC ,DCH_SNACK_PM,22,0,0,0,0,0,0,0,0,0
SAN DIEGO,Jun 2016,DCH,2016,CHILD DEVELOPMENT ASSOC INC ,DCH_SNACK_PM,26,0,0,0,0,0,0,0,0,0
SAN DIEGO,Jun 2016,DCH,2016,CHILD DEVELOPMENT ASSOC INC ,DCH_SUPPER,,0,0,0,0,0,211,5120,5331,0
SAN DIEGO,Jun 2016,DCH,2016,CHILD DEVELOPMENT ASSOC INC ,DCH_SUPPER,25,0,0,0,0,0,0,0,0,0
SAN DIEGO,Jun 2016,DCH,2016,CHILD DEVELOPMENT ASSOC INC ,DCH_SUPPER,22,0,0,0,0,0,0,0,0,0
SAN DIEGO,Jun 2016,DCH,2016,CHILD DEVELOPMENT ASSOC INC ,DCH_SUPPER,26,0,0,0,0,0,0,0,0,0
SAN DIEGO,Jun 2016,DCH,2016,CHILD DEVELOPMENT ASSOC INC ,DCH_SUPPER,26,0,0,0,0,85633,0,0,85633,3293.5769
SAN DIEGO,Jul 2016,CACF,2016,CHILD DEVELOPMENT ASSOC INC ,CHILD_BREAKFAST,20,192,65,60,317,1410,477,441,2328,116.4
SAN DIEGO,Jul 2016,CACF,2016,CHILD DEVELOPMENT ASSOC INC ,CHILD_LUNCH,20,192,65,60,317,1972,667,616,3255,162.75
SAN DIEGO,Jul 2016,CACF,2016,CHILD DEVELOPMENT ASSOC INC ,CHILD_SNACK_PM,20,192,65,60,317,1619,548,506,2673,133.65
SAN DIEGO,Jul 2016,DCH,2016,CHILD DEVELOPMENT ASSOC INC ,DCH_BREAKFAST,25,0,0,0,0,84561,0,0,84561,3382.44
SAN DIEGO,Jul 2016,DCH,2016,CHILD DEVELOPMENT ASSOC INC ,DCH_BREAKFAST,25,0,0,0,0,0,0,0,0,0
SAN DIEGO,Jul 2016,DCH,2016,CHILD DEVELOPMENT ASSOC INC ,DCH_BREAKFAST,22,0,0,0,0,0,0,0,0,0
SAN DIEGO,Jul 2016,DCH,2016,CHILD DEVELOPMENT ASSOC INC ,DCH_BREAKFAST,,0,0,0,0,0,88,4611,4699,0
SAN DIEGO,Jul 2016,DCH,2016,CHILD DEVELOPMENT ASSOC INC ,DCH_LUNCH,22,0,0,0,0,0,0,0,0,0
SAN DIEGO,Jul 2016,DCH,2016,CHILD DEVELOPMENT ASSOC INC ,DCH_LUNCH,25,0,0,0,0,0,0,0,0,0
SAN DIEGO,Jul 2016,DCH,2016,CHILD DEVELOPMENT ASSOC INC ,DCH_LUNCH,,0,0,0,0,0,113,9705,9818,0
SAN DIEGO,Jul 2016,DCH,2016,CHILD DEVELOPMENT ASSOC INC ,DCH_LUNCH,25,0,0,0,0,140418,0,0,140418,5616.72
SAN DIEGO,Jul 2016,DCH,2016,CHILD DEVELOPMENT ASSOC INC ,DCH_SNACK_AM,,0,0,0,0,0,71,5517,5588,0
SAN DIEGO,Jul 2016,DCH,2016,CHILD DEVELOPMENT ASSOC INC ,DCH_SNACK_AM,22,0,0,0,0,0,0,0,0,0
SAN DIEGO,Jul 2016,DCH,2016,CHILD DEVELOPMENT ASSOC INC ,DCH_SNACK_AM,25,0,0,0,0,0,0,0,0,0
SAN DIEGO,Jul 2016,DCH,2016,CHILD DEVELOPMENT ASSOC INC ,DCH_SNACK_AM,25,0,0,0,0,61262,0,0,61262,2450.48
SAN DIEGO,Jul 2016,DCH,2016,CHILD DEVELOPMENT ASSOC INC ,DCH_SNACK_NT,25,0,0,0,0,8281,0,0,8281,331.24
SAN DIEGO,Jul 2016,DCH,2016,CHILD DEVELOPMENT ASSOC INC ,DCH_SNACK_NT,25,0,0,0,0,0,0,0,0,0
SAN DIEGO,Jul 2016,DCH,2016,CHILD DEVELOPMENT ASSOC INC ,DCH_SNACK_NT,,0,0,0,0,0,7,35,42,0
SAN DIEGO,Jul 2016,DCH,2016,CHILD DEVELOPMENT ASSOC INC ,DCH_SNACK_NT,22,0,0,0,0,0,0,0,0,0
SAN DIEGO,Jul 2016,DCH,2016,CHILD DEVELOPMENT ASSOC INC ,DCH_SNACK_PM,,0,0,0,0,0,123,5394,5517,0
SAN DIEGO,Jul 2016,DCH,2016,CHILD DEVELOPMENT ASSOC INC ,DCH_SNACK_PM,25,0,0,0,0,0,0,0,0,0
SAN DIEGO,Jul 2016,DCH,2016,CHILD DEVELOPMENT ASSOC INC ,DCH_SNACK_PM,22,0,0,0,0,0,0,0,0,0
SAN DIEGO,Jul 2016,DCH,2016,CHILD DEVELOPMENT ASSOC INC ,DCH_SNACK_PM,25,0,0,0,0,97737,0,0,97737,3909.48
SAN DIEGO,Jul 2016,DCH,2016,CHILD DEVELOPMENT ASSOC INC ,DCH_SUPPER,22,0,0,0,0,0,0,0,0,0
SAN DIEGO,Jul 2016,DCH,2016,CHILD DEVELOPMENT ASSOC INC ,DCH_SUPPER,25,0,0,0,0,0,0,0,0,0
SAN DIEGO,Jul 2016,DCH,2016,CHILD DEVELOPMENT ASSOC INC ,DCH_SUPPER,,0,0,0,0,0,111,4238,4349,0
SAN DIEGO,Jul 2016,DCH,2016,CHILD DEVELOPMENT ASSOC INC ,DCH_SUPPER,25,0,0,0,0,74301,0,0,74301,2972.04
SAN DIEGO,Oct 2015,DCH,2016,CHILD NUTRITION PROGRAM OF SOUTHERN CALIFORNIA INC ,DCH_BREAKFAST,22,0,0,0,0,0,0,0,0,0
SAN DIEGO,Oct 2015,DCH,2016,CHILD NUTRITION PROGRAM OF SOUTHERN CALIFORNIA INC ,DCH_BREAKFAST,19,0,0,0,0,0,0,0,0,0
SAN DIEGO,Oct 2015,DCH,2016,CHILD NUTRITION PROGRAM OF SOUTHERN CALIFORNIA INC ,DCH_BREAKFAST,,0,0,0,0,0,338,13264,13602,0
SAN DIEGO,Oct 2015,DCH,2016,CHILD NUTRITION PROGRAM OF SOUTHERN CALIFORNIA INC ,DCH_BREAKFAST,22,0,0,0,0,73769,0,0,73769,3353.1364
SAN DIEGO,Oct 2015,DCH,2016,CHILD NUTRITION PROGRAM OF SOUTHERN CALIFORNIA INC ,DCH_BREAKFAST,22,0,0,0,0,0,0,0,0,0
SAN DIEGO,Oct 2015,DCH,2016,CHILD NUTRITION PROGRAM OF SOUTHERN CALIFORNIA INC ,DCH_LUNCH,22,0,0,0,0,0,0,0,0,0
SAN DIEGO,Oct 2015,DCH,2016,CHILD NUTRITION PROGRAM OF SOUTHERN CALIFORNIA INC ,DCH_LUNCH,,0,0,0,0,0,412,16808,17220,0
SAN DIEGO,Oct 2015,DCH,2016,CHILD NUTRITION PROGRAM OF SOUTHERN CALIFORNIA INC ,DCH_LUNCH,22,0,0,0,0,78416,0,0,78416,3564.3636
SAN DIEGO,Oct 2015,DCH,2016,CHILD NUTRITION PROGRAM OF SOUTHERN CALIFORNIA INC ,DCH_LUNCH,22,0,0,0,0,0,0,0,0,0
SAN DIEGO,Oct 2015,DCH,2016,CHILD NUTRITION PROGRAM OF SOUTHERN CALIFORNIA INC ,DCH_LUNCH,19,0,0,0,0,0,0,0,0,0
SAN DIEGO,Oct 2015,DCH,2016,CHILD NUTRITION PROGRAM OF SOUTHERN CALIFORNIA INC ,DCH_SNACK_AM,22,0,0,0,0,33340,0,0,33340,1515.4545
SAN DIEGO,Oct 2015,DCH,2016,CHILD NUTRITION PROGRAM OF SOUTHERN CALIFORNIA INC ,DCH_SNACK_AM,,0,0,0,0,0,234,8123,8357,0
SAN DIEGO,Oct 2015,DCH,2016,CHILD NUTRITION PROGRAM OF SOUTHERN CALIFORNIA INC ,DCH_SNACK_AM,22,0,0,0,0,0,0,0,0,0
SAN DIEGO,Oct 2015,DCH,2016,CHILD NUTRITION PROGRAM OF SOUTHERN CALIFORNIA INC ,DCH_SNACK_AM,22,0,0,0,0,0,0,0,0,0
SAN DIEGO,Oct 2015,DCH,2016,CHILD NUTRITION PROGRAM OF SOUTHERN CALIFORNIA INC ,DCH_SNACK_AM,19,0,0,0,0,0,0,0,0,0
SAN DIEGO,Oct 2015,DCH,2016,CHILD NUTRITION PROGRAM OF SOUTHERN CALIFORNIA INC ,DCH_SNACK_NT,22,0,0,0,0,2374,0,0,2374,107.9091
SAN DIEGO,Oct 2015,DCH,2016,CHILD NUTRITION PROGRAM OF SOUTHERN CALIFORNIA INC ,DCH_SNACK_NT,22,0,0,0,0,0,0,0,0,0
SAN DIEGO,Oct 2015,DCH,2016,CHILD NUTRITION PROGRAM OF SOUTHERN CALIFORNIA INC ,DCH_SNACK_NT,22,0,0,0,0,0,0,0,0,0
SAN DIEGO,Oct 2015,DCH,2016,CHILD NUTRITION PROGRAM OF SOUTHERN CALIFORNIA INC ,DCH_SNACK_NT,19,0,0,0,0,0,0,0,0,0
SAN DIEGO,Oct 2015,DCH,2016,CHILD NUTRITION PROGRAM OF SOUTHERN CALIFORNIA INC ,DCH_SNACK_NT,,0,0,0,0,0,9,93,102,0
SAN DIEGO,Oct 2015,DCH,2016,CHILD NUTRITION PROGRAM OF SOUTHERN CALIFORNIA INC ,DCH_SNACK_PM,19,0,0,0,0,0,0,0,0,0
SAN DIEGO,Oct 2015,DCH,2016,CHILD NUTRITION PROGRAM OF SOUTHERN CALIFORNIA INC ,DCH_SNACK_PM,22,0,0,0,0,0,0,0,0,0
SAN DIEGO,Oct 2015,DCH,2016,CHILD NUTRITION PROGRAM OF SOUTHERN CALIFORNIA INC ,DCH_SNACK_PM,,0,0,0,0,0,284,11387,11671,0
SAN DIEGO,Oct 2015,DCH,2016,CHILD NUTRITION PROGRAM OF SOUTHERN CALIFORNIA INC ,DCH_SNACK_PM,22,0,0,0,0,75476,0,0,75476,3430.7273
SAN DIEGO,Oct 2015,DCH,2016,CHILD NUTRITION PROGRAM OF SOUTHERN CALIFORNIA INC ,DCH_SNACK_PM,22,0,0,0,0,0,0,0,0,0
SAN DIEGO,Oct 2015,DCH,2016,CHILD NUTRITION PROGRAM OF SOUTHERN CALIFORNIA INC ,DCH_SUPPER,22,0,0,0,0,34266,0,0,34266,1557.5455
SAN DIEGO,Oct 2015,DCH,2016,CHILD NUTRITION PROGRAM OF SOUTHERN CALIFORNIA INC ,DCH_SUPPER,22,0,0,0,0,0,0,0,0,0
SAN DIEGO,Oct 2015,DCH,2016,CHILD NUTRITION PROGRAM OF SOUTHERN CALIFORNIA INC ,DCH_SUPPER,22,0,0,0,0,0,0,0,0,0
SAN DIEGO,Oct 2015,DCH,2016,CHILD NUTRITION PROGRAM OF SOUTHERN CALIFORNIA INC ,DCH_SUPPER,,0,0,0,0,0,156,3851,4007,0
SAN DIEGO,Oct 2015,DCH,2016,CHILD NUTRITION PROGRAM OF SOUTHERN CALIFORNIA INC ,DCH_SUPPER,19,0,0,0,0,0,0,0,0,0
SAN DIEGO,Nov 2015,DCH,2016,CHILD NUTRITION PROGRAM OF SOUTHERN CALIFORNIA INC ,DCH_BREAKFAST,,0,0,0,0,0,273,11266,11539,0
SAN DIEGO,Nov 2015,DCH,2016,CHILD NUTRITION PROGRAM OF SOUTHERN CALIFORNIA INC ,DCH_BREAKFAST,16,0,0,0,0,0,0,0,0,0
SAN DIEGO,Nov 2015,DCH,2016,CHILD NUTRITION PROGRAM OF SOUTHERN CALIFORNIA INC ,DCH_BREAKFAST,20,0,0,0,0,0,0,0,0,0
SAN DIEGO,Nov 2015,DCH,2016,CHILD NUTRITION PROGRAM OF SOUTHERN CALIFORNIA INC ,DCH_BREAKFAST,19,0,0,0,0,0,0,0,0,0
SAN DIEGO,Nov 2015,DCH,2016,CHILD NUTRITION PROGRAM OF SOUTHERN CALIFORNIA INC ,DCH_BREAKFAST,20,0,0,0,0,61746,0,0,61746,3087.3
SAN DIEGO,Nov 2015,DCH,2016,CHILD NUTRITION PROGRAM OF SOUTHERN CALIFORNIA INC ,DCH_LUNCH,20,0,0,0,0,70191,0,0,70191,3509.55
SAN DIEGO,Nov 2015,DCH,2016,CHILD NUTRITION PROGRAM OF SOUTHERN CALIFORNIA INC ,DCH_LUNCH,,0,0,0,0,0,332,14373,14705,0
SAN DIEGO,Nov 2015,DCH,2016,CHILD NUTRITION PROGRAM OF SOUTHERN CALIFORNIA INC ,DCH_LUNCH,16,0,0,0,0,0,0,0,0,0
SAN DIEGO,Nov 2015,DCH,2016,CHILD NUTRITION PROGRAM OF SOUTHERN CALIFORNIA INC ,DCH_LUNCH,20,0,0,0,0,0,0,0,0,0
SAN DIEGO,Nov 2015,DCH,2016,CHILD NUTRITION PROGRAM OF SOUTHERN CALIFORNIA INC ,DCH_LUNCH,19,0,0,0,0,0,0,0,0,0
SAN DIEGO,Nov 2015,DCH,2016,CHILD NUTRITION PROGRAM OF SOUTHERN CALIFORNIA INC ,DCH_SNACK_AM,19,0,0,0,0,0,0,0,0,0
SAN DIEGO,Nov 2015,DCH,2016,CHILD NUTRITION PROGRAM OF SOUTHERN CALIFORNIA INC ,DCH_SNACK_AM,20,0,0,0,0,29994,0,0,29994,1499.7
SAN DIEGO,Nov 2015,DCH,2016,CHILD NUTRITION PROGRAM OF SOUTHERN CALIFORNIA INC ,DCH_SNACK_AM,,0,0,0,0,0,190,7131,7321,0
SAN DIEGO,Nov 2015,DCH,2016,CHILD NUTRITION PROGRAM OF SOUTHERN CALIFORNIA INC ,DCH_SNACK_AM,20,0,0,0,0,0,0,0,0,0
SAN DIEGO,Nov 2015,DCH,2016,CHILD NUTRITION PROGRAM OF SOUTHERN CALIFORNIA INC ,DCH_SNACK_AM,16,0,0,0,0,0,0,0,0,0
SAN DIEGO,Nov 2015,DCH,2016,CHILD NUTRITION PROGRAM OF SOUTHERN CALIFORNIA INC ,DCH_SNACK_NT,,0,0,0,0,0,5,50,55,0
SAN DIEGO,Nov 2015,DCH,2016,CHILD NUTRITION PROGRAM OF SOUTHERN CALIFORNIA INC ,DCH_SNACK_NT,20,0,0,0,0,1944,0,0,1944,97.2
SAN DIEGO,Nov 2015,DCH,2016,CHILD NUTRITION PROGRAM OF SOUTHERN CALIFORNIA INC ,DCH_SNACK_NT,20,0,0,0,0,0,0,0,0,0
SAN DIEGO,Nov 2015,DCH,2016,CHILD NUTRITION PROGRAM OF SOUTHERN CALIFORNIA INC ,DCH_SNACK_NT,19,0,0,0,0,0,0,0,0,0
SAN DIEGO,Nov 2015,DCH,2016,CHILD NUTRITION PROGRAM OF SOUTHERN CALIFORNIA INC ,DCH_SNACK_NT,16,0,0,0,0,0,0,0,0,0
SAN DIEGO,Nov 2015,DCH,2016,CHILD NUTRITION PROGRAM OF SOUTHERN CALIFORNIA INC ,DCH_SNACK_PM,,0,0,0,0,0,213,9274,9487,0
SAN DIEGO,Nov 2015,DCH,2016,CHILD NUTRITION PROGRAM OF SOUTHERN CALIFORNIA INC ,DCH_SNACK_PM,20,0,0,0,0,0,0,0,0,0
SAN DIEGO,Nov 2015,DCH,2016,CHILD NUTRITION PROGRAM OF SOUTHERN CALIFORNIA INC ,DCH_SNACK_PM,20,0,0,0,0,61861,0,0,61861,3093.05
SAN DIEGO,Nov 2015,DCH,2016,CHILD NUTRITION PROGRAM OF SOUTHERN CALIFORNIA INC ,DCH_SNACK_PM,16,0,0,0,0,0,0,0,0,0
SAN DIEGO,Nov 2015,DCH,2016,CHILD NUTRITION PROGRAM OF SOUTHERN CALIFORNIA INC ,DCH_SNACK_PM,19,0,0,0,0,0,0,0,0,0
SAN DIEGO,Nov 2015,DCH,2016,CHILD NUTRITION PROGRAM OF SOUTHERN CALIFORNIA INC ,DCH_SUPPER,20,0,0,0,0,0,0,0,0,0
SAN DIEGO,Nov 2015,DCH,2016,CHILD NUTRITION PROGRAM OF SOUTHERN CALIFORNIA INC ,DCH_SUPPER,16,0,0,0,0,0,0,0,0,0
SAN DIEGO,Nov 2015,DCH,2016,CHILD NUTRITION PROGRAM OF SOUTHERN CALIFORNIA INC ,DCH_SUPPER,,0,0,0,0,0,123,3388,3511,0
SAN DIEGO,Nov 2015,DCH,2016,CHILD NUTRITION PROGRAM OF SOUTHERN CALIFORNIA INC ,DCH_SUPPER,19,0,0,0,0,0,0,0,0,0
SAN DIEGO,Nov 2015,DCH,2016,CHILD NUTRITION PROGRAM OF SOUTHERN CALIFORNIA INC ,DCH_SUPPER,20,0,0,0,0,29127,0,0,29127,1456.35
SAN DIEGO,Dec 2015,DCH,2016,CHILD NUTRITION PROGRAM OF SOUTHERN CALIFORNIA INC ,DCH_BREAKFAST,22,0,0,0,0,0,0,0,0,0
SAN DIEGO,Dec 2015,DCH,2016,CHILD NUTRITION PROGRAM OF SOUTHERN CALIFORNIA INC ,DCH_BREAKFAST,13,0,0,0,0,0,0,0,0,0
SAN DIEGO,Dec 2015,DCH,2016,CHILD NUTRITION PROGRAM OF SOUTHERN CALIFORNIA INC ,DCH_BREAKFAST,,0,0,0,0,0,254,11133,11387,0
SAN DIEGO,Dec 2015,DCH,2016,CHILD NUTRITION PROGRAM OF SOUTHERN CALIFORNIA INC ,DCH_BREAKFAST,22,0,0,0,0,63593,0,0,63593,2890.5909
SAN DIEGO,Dec 2015,DCH,2016,CHILD NUTRITION PROGRAM OF SOUTHERN CALIFORNIA INC ,DCH_BREAKFAST,22,0,0,0,0,0,0,0,0,0
SAN DIEGO,Dec 2015,DCH,2016,CHILD NUTRITION PROGRAM OF SOUTHERN CALIFORNIA INC ,DCH_LUNCH,22,0,0,0,0,74227,0,0,74227,3373.9545
SAN DIEGO,Dec 2015,DCH,2016,CHILD NUTRITION PROGRAM OF SOUTHERN CALIFORNIA INC ,DCH_LUNCH,,0,0,0,0,0,303,14327,14630,0
SAN DIEGO,Dec 2015,DCH,2016,CHILD NUTRITION PROGRAM OF SOUTHERN CALIFORNIA INC ,DCH_LUNCH,13,0,0,0,0,0,0,0,0,0
SAN DIEGO,Dec 2015,DCH,2016,CHILD NUTRITION PROGRAM OF SOUTHERN CALIFORNIA INC ,DCH_LUNCH,22,0,0,0,0,0,0,0,0,0
SAN DIEGO,Dec 2015,DCH,2016,CHILD NUTRITION PROGRAM OF SOUTHERN CALIFORNIA INC ,DCH_LUNCH,22,0,0,0,0,0,0,0,0,0
SAN DIEGO,Dec 2015,DCH,2016,CHILD NUTRITION PROGRAM OF SOUTHERN CALIFORNIA INC ,DCH_SNACK_AM,22,0,0,0,0,32179,0,0,32179,1462.6818
SAN DIEGO,Dec 2015,DCH,2016,CHILD NUTRITION PROGRAM OF SOUTHERN CALIFORNIA INC ,DCH_SNACK_AM,13,0,0,0,0,0,0,0,0,0
SAN DIEGO,Dec 2015,DCH,2016,CHILD NUTRITION PROGRAM OF SOUTHERN CALIFORNIA INC ,DCH_SNACK_AM,,0,0,0,0,0,142,7029,7171,0
SAN DIEGO,Dec 2015,DCH,2016,CHILD NUTRITION PROGRAM OF SOUTHERN CALIFORNIA INC ,DCH_SNACK_AM,22,0,0,0,0,0,0,0,0,0
SAN DIEGO,Dec 2015,DCH,2016,CHILD NUTRITION PROGRAM OF SOUTHERN CALIFORNIA INC ,DCH_SNACK_AM,22,0,0,0,0,0,0,0,0,0
SAN DIEGO,Dec 2015,DCH,2016,CHILD NUTRITION PROGRAM OF SOUTHERN CALIFORNIA INC ,DCH_SNACK_NT,22,0,0,0,0,0,0,0,0,0
SAN DIEGO,Dec 2015,DCH,2016,CHILD NUTRITION PROGRAM OF SOUTHERN CALIFORNIA INC ,DCH_SNACK_NT,22,0,0,0,0,2199,0,0,2199,99.9545
SAN DIEGO,Dec 2015,DCH,2016,CHILD NUTRITION PROGRAM OF SOUTHERN CALIFORNIA INC ,DCH_SNACK_NT,,0,0,0,0,0,4,43,47,0
SAN DIEGO,Dec 2015,DCH,2016,CHILD NUTRITION PROGRAM OF SOUTHERN CALIFORNIA INC ,DCH_SNACK_NT,13,0,0,0,0,0,0,0,0,0
SAN DIEGO,Dec 2015,DCH,2016,CHILD NUTRITION PROGRAM OF SOUTHERN CALIFORNIA INC ,DCH_SNACK_NT,22,0,0,0,0,0,0,0,0,0
SAN DIEGO,Dec 2015,DCH,2016,CHILD NUTRITION PROGRAM OF SOUTHERN CALIFORNIA INC ,DCH_SNACK_PM,22,0,0,0,0,0,0,0,0,0
SAN DIEGO,Dec 2015,DCH,2016,CHILD NUTRITION PROGRAM OF SOUTHERN CALIFORNIA INC ,DCH_SNACK_PM,22,0,0,0,0,0,0,0,0,0
SAN DIEGO,Dec 2015,DCH,2016,CHILD NUTRITION PROGRAM OF SOUTHERN CALIFORNIA INC ,DCH_SNACK_PM,13,0,0,0,0,0,0,0,0,0
SAN DIEGO,Dec 2015,DCH,2016,CHILD NUTRITION PROGRAM OF SOUTHERN CALIFORNIA INC ,DCH_SNACK_PM,22,0,0,0,0,62552,0,0,62552,2843.2727
SAN DIEGO,Dec 2015,DCH,2016,CHILD NUTRITION PROGRAM OF SOUTHERN CALIFORNIA INC ,DCH_SNACK_PM,,0,0,0,0,0,244,9300,9544,0
SAN DIEGO,Dec 2015,DCH,2016,CHILD NUTRITION PROGRAM OF SOUTHERN CALIFORNIA INC ,DCH_SUPPER,22,0,0,0,0,30664,0,0,30664,1393.8182
SAN DIEGO,Dec 2015,DCH,2016,CHILD NUTRITION PROGRAM OF SOUTHERN CALIFORNIA INC ,DCH_SUPPER,22,0,0,0,0,0,0,0,0,0
SAN DIEGO,Dec 2015,DCH,2016,CHILD NUTRITION PROGRAM OF SOUTHERN CALIFORNIA INC ,DCH_SUPPER,,0,0,0,0,0,174,3415,3589,0
SAN DIEGO,Dec 2015,DCH,2016,CHILD NUTRITION PROGRAM OF SOUTHERN CALIFORNIA INC ,DCH_SUPPER,22,0,0,0,0,0,0,0,0,0
SAN DIEGO,Dec 2015,DCH,2016,CHILD NUTRITION PROGRAM OF SOUTHERN CALIFORNIA INC ,DCH_SUPPER,13,0,0,0,0,0,0,0,0,0
SAN DIEGO,Jan 2016,DCH,2016,CHILD NUTRITION PROGRAM OF SOUTHERN CALIFORNIA INC ,DCH_BREAKFAST,,0,0,0,0,0,294,12099,12393,0
SAN DIEGO,Jan 2016,DCH,2016,CHILD NUTRITION PROGRAM OF SOUTHERN CALIFORNIA INC ,DCH_BREAKFAST,12,0,0,0,0,0,0,0,0,0
SAN DIEGO,Jan 2016,DCH,2016,CHILD NUTRITION PROGRAM OF SOUTHERN CALIFORNIA INC ,DCH_BREAKFAST,20,0,0,0,0,0,0,0,0,0
SAN DIEGO,Jan 2016,DCH,2016,CHILD NUTRITION PROGRAM OF SOUTHERN CALIFORNIA INC ,DCH_BREAKFAST,20,0,0,0,0,0,0,0,0,0
SAN DIEGO,Jan 2016,DCH,2016,CHILD NUTRITION PROGRAM OF SOUTHERN CALIFORNIA INC ,DCH_BREAKFAST,20,0,0,0,0,64105,0,0,64105,3205.25
SAN DIEGO,Jan 2016,DCH,2016,CHILD NUTRITION PROGRAM OF SOUTHERN CALIFORNIA INC ,DCH_LUNCH,20,0,0,0,0,72701,0,0,72701,3635.05
SAN DIEGO,Jan 2016,DCH,2016,CHILD NUTRITION PROGRAM OF SOUTHERN CALIFORNIA INC ,DCH_LUNCH,,0,0,0,0,0,353,15439,15792,0
SAN DIEGO,Jan 2016,DCH,2016,CHILD NUTRITION PROGRAM OF SOUTHERN CALIFORNIA INC ,DCH_LUNCH,12,0,0,0,0,0,0,0,0,0
SAN DIEGO,Jan 2016,DCH,2016,CHILD NUTRITION PROGRAM OF SOUTHERN CALIFORNIA INC ,DCH_LUNCH,20,0,0,0,0,0,0,0,0,0
SAN DIEGO,Jan 2016,DCH,2016,CHILD NUTRITION PROGRAM OF SOUTHERN CALIFORNIA INC ,DCH_LUNCH,20,0,0,0,0,0,0,0,0,0
SAN DIEGO,Jan 2016,DCH,2016,CHILD NUTRITION PROGRAM OF SOUTHERN CALIFORNIA INC ,DCH_SNACK_AM,20,0,0,0,0,0,0,0,0,0
SAN DIEGO,Jan 2016,DCH,2016,CHILD NUTRITION PROGRAM OF SOUTHERN CALIFORNIA INC ,DCH_SNACK_AM,20,0,0,0,0,0,0,0,0,0
SAN DIEGO,Jan 2016,DCH,2016,CHILD NUTRITION PROGRAM OF SOUTHERN CALIFORNIA INC ,DCH_SNACK_AM,12,0,0,0,0,0,0,0,0,0
SAN DIEGO,Jan 2016,DCH,2016,CHILD NUTRITION PROGRAM OF SOUTHERN CALIFORNIA INC ,DCH_SNACK_AM,20,0,0,0,0,31739,0,0,31739,1586.95
SAN DIEGO,Jan 2016,DCH,2016,CHILD NUTRITION PROGRAM OF SOUTHERN CALIFORNIA INC ,DCH_SNACK_AM,,0,0,0,0,0,178,7741,7919,0
SAN DIEGO,Jan 2016,DCH,2016,CHILD NUTRITION PROGRAM OF SOUTHERN CALIFORNIA INC ,DCH_SNACK_NT,,0,0,0,0,0,1,46,47,0
SAN DIEGO,Jan 2016,DCH,2016,CHILD NUTRITION PROGRAM OF SOUTHERN CALIFORNIA INC ,DCH_SNACK_NT,20,0,0,0,0,2081,0,0,2081,104.05
SAN DIEGO,Jan 2016,DCH,2016,CHILD NUTRITION PROGRAM OF SOUTHERN CALIFORNIA INC ,DCH_SNACK_NT,12,0,0,0,0,0,0,0,0,0
SAN DIEGO,Jan 2016,DCH,2016,CHILD NUTRITION PROGRAM OF SOUTHERN CALIFORNIA INC ,DCH_SNACK_NT,20,0,0,0,0,0,0,0,0,0
SAN DIEGO,Jan 2016,DCH,2016,CHILD NUTRITION PROGRAM OF SOUTHERN CALIFORNIA INC ,DCH_SNACK_NT,20,0,0,0,0,0,0,0,0,0
SAN DIEGO,Jan 2016,DCH,2016,CHILD NUTRITION PROGRAM OF SOUTHERN CALIFORNIA INC ,DCH_SNACK_PM,12,0,0,0,0,0,0,0,0,0
SAN DIEGO,Jan 2016,DCH,2016,CHILD NUTRITION PROGRAM OF SOUTHERN CALIFORNIA INC ,DCH_SNACK_PM,,0,0,0,0,0,268,9852,10120,0
SAN DIEGO,Jan 2016,DCH,2016,CHILD NUTRITION PROGRAM OF SOUTHERN CALIFORNIA INC ,DCH_SNACK_PM,20,0,0,0,0,64213,0,0,64213,3210.65
SAN DIEGO,Jan 2016,DCH,2016,CHILD NUTRITION PROGRAM OF SOUTHERN CALIFORNIA INC ,DCH_SNACK_PM,20,0,0,0,0,0,0,0,0,0
SAN DIEGO,Jan 2016,DCH,2016,CHILD NUTRITION PROGRAM OF SOUTHERN CALIFORNIA INC ,DCH_SNACK_PM,20,0,0,0,0,0,0,0,0,0
SAN DIEGO,Jan 2016,DCH,2016,CHILD NUTRITION PROGRAM OF SOUTHERN CALIFORNIA INC ,DCH_SUPPER,20,0,0,0,0,30882,0,0,30882,1544.1
SAN DIEGO,Jan 2016,DCH,2016,CHILD NUTRITION PROGRAM OF SOUTHERN CALIFORNIA INC ,DCH_SUPPER,,0,0,0,0,0,215,3506,3721,0
SAN DIEGO,Jan 2016,DCH,2016,CHILD NUTRITION PROGRAM OF SOUTHERN CALIFORNIA INC ,DCH_SUPPER,12,0,0,0,0,0,0,0,0,0
SAN DIEGO,Jan 2016,DCH,2016,CHILD NUTRITION PROGRAM OF SOUTHERN CALIFORNIA INC ,DCH_SUPPER,20,0,0,0,0,0,0,0,0,0
SAN DIEGO,Jan 2016,DCH,2016,CHILD NUTRITION PROGRAM OF SOUTHERN CALIFORNIA INC ,DCH_SUPPER,20,0,0,0,0,0,0,0,0,0
SAN DIEGO,Feb 2016,DCH,2016,CHILD NUTRITION PROGRAM OF SOUTHERN CALIFORNIA INC ,DCH_BREAKFAST,21,0,0,0,0,0,0,0,0,0
SAN DIEGO,Feb 2016,DCH,2016,CHILD NUTRITION PROGRAM OF SOUTHERN CALIFORNIA INC ,DCH_BREAKFAST,21,0,0,0,0,68589,0,0,68589,3266.1429
SAN DIEGO,Feb 2016,DCH,2016,CHILD NUTRITION PROGRAM OF SOUTHERN CALIFORNIA INC ,DCH_BREAKFAST,17,0,0,0,0,0,0,0,0,0
SAN DIEGO,Feb 2016,DCH,2016,CHILD NUTRITION PROGRAM OF SOUTHERN CALIFORNIA INC ,DCH_BREAKFAST,,0,0,0,0,0,374,12669,13043,0
SAN DIEGO,Feb 2016,DCH,2016,CHILD NUTRITION PROGRAM OF SOUTHERN CALIFORNIA INC ,DCH_BREAKFAST,21,0,0,0,0,0,0,0,0,0
SAN DIEGO,Feb 2016,DCH,2016,CHILD NUTRITION PROGRAM OF SOUTHERN CALIFORNIA INC ,DCH_LUNCH,21,0,0,0,0,0,0,0,0,0
SAN DIEGO,Feb 2016,DCH,2016,CHILD NUTRITION PROGRAM OF SOUTHERN CALIFORNIA INC ,DCH_LUNCH,17,0,0,0,0,0,0,0,0,0
SAN DIEGO,Feb 2016,DCH,2016,CHILD NUTRITION PROGRAM OF SOUTHERN CALIFORNIA INC ,DCH_LUNCH,,0,0,0,0,0,460,16352,16812,0
SAN DIEGO,Feb 2016,DCH,2016,CHILD NUTRITION PROGRAM OF SOUTHERN CALIFORNIA INC ,DCH_LUNCH,21,0,0,0,0,76449,0,0,76449,3640.4286
SAN DIEGO,Feb 2016,DCH,2016,CHILD NUTRITION PROGRAM OF SOUTHERN CALIFORNIA INC ,DCH_LUNCH,21,0,0,0,0,0,0,0,0,0
SAN DIEGO,Feb 2016,DCH,2016,CHILD NUTRITION PROGRAM OF SOUTHERN CALIFORNIA INC ,DCH_SNACK_AM,21,0,0,0,0,33633,0,0,33633,1601.5714
SAN DIEGO,Feb 2016,DCH,2016,CHILD NUTRITION PROGRAM OF SOUTHERN CALIFORNIA INC ,DCH_SNACK_AM,17,0,0,0,0,0,0,0,0,0
SAN DIEGO,Feb 2016,DCH,2016,CHILD NUTRITION PROGRAM OF SOUTHERN CALIFORNIA INC ,DCH_SNACK_AM,21,0,0,0,0,0,0,0,0,0
SAN DIEGO,Feb 2016,DCH,2016,CHILD NUTRITION PROGRAM OF SOUTHERN CALIFORNIA INC ,DCH_SNACK_AM,21,0,0,0,0,0,0,0,0,0
SAN DIEGO,Feb 2016,DCH,2016,CHILD NUTRITION PROGRAM OF SOUTHERN CALIFORNIA INC ,DCH_SNACK_AM,,0,0,0,0,0,249,8218,8467,0
SAN DIEGO,Feb 2016,DCH,2016,CHILD NUTRITION PROGRAM OF SOUTHERN CALIFORNIA INC ,DCH_SNACK_NT,21,0,0,0,0,0,0,0,0,0
SAN DIEGO,Feb 2016,DCH,2016,CHILD NUTRITION PROGRAM OF SOUTHERN CALIFORNIA INC ,DCH_SNACK_NT,,0,0,0,0,0,2,56,58,0
SAN DIEGO,Feb 2016,DCH,2016,CHILD NUTRITION PROGRAM OF SOUTHERN CALIFORNIA INC ,DCH_SNACK_NT,17,0,0,0,0,0,0,0,0,0
SAN DIEGO,Feb 2016,DCH,2016,CHILD NUTRITION PROGRAM OF SOUTHERN CALIFORNIA INC ,DCH_SNACK_NT,21,0,0,0,0,2215,0,0,2215,105.4762
SAN DIEGO,Feb 2016,DCH,2016,CHILD NUTRITION PROGRAM OF SOUTHERN CALIFORNIA INC ,DCH_SNACK_NT,21,0,0,0,0,0,0,0,0,0
SAN DIEGO,Feb 2016,DCH,2016,CHILD NUTRITION PROGRAM OF SOUTHERN CALIFORNIA INC ,DCH_SNACK_PM,17,0,0,0,0,0,0,0,0,0
SAN DIEGO,Feb 2016,DCH,2016,CHILD NUTRITION PROGRAM OF SOUTHERN CALIFORNIA INC ,DCH_SNACK_PM,21,0,0,0,0,0,0,0,0,0
SAN DIEGO,Feb 2016,DCH,2016,CHILD NUTRITION PROGRAM OF SOUTHERN CALIFORNIA INC ,DCH_SNACK_PM,,0,0,0,0,0,303,10602,10905,0
SAN DIEGO,Feb 2016,DCH,2016,CHILD NUTRITION PROGRAM OF SOUTHERN CALIFORNIA INC ,DCH_SNACK_PM,21,0,0,0,0,68384,0,0,68384,3256.381
SAN DIEGO,Feb 2016,DCH,2016,CHILD NUTRITION PROGRAM OF SOUTHERN CALIFORNIA INC ,DCH_SNACK_PM,21,0,0,0,0,0,0,0,0,0
SAN DIEGO,Feb 2016,DCH,2016,CHILD NUTRITION PROGRAM OF SOUTHERN CALIFORNIA INC ,DCH_SUPPER,21,0,0,0,0,32135,0,0,32135,1530.2381
SAN DIEGO,Feb 2016,DCH,2016,CHILD NUTRITION PROGRAM OF SOUTHERN CALIFORNIA INC ,DCH_SUPPER,,0,0,0,0,0,265,3577,3842,0
SAN DIEGO,Feb 2016,DCH,2016,CHILD NUTRITION PROGRAM OF SOUTHERN CALIFORNIA INC ,DCH_SUPPER,17,0,0,0,0,0,0,0,0,0
SAN DIEGO,Feb 2016,DCH,2016,CHILD NUTRITION PROGRAM OF SOUTHERN CALIFORNIA INC ,DCH_SUPPER,21,0,0,0,0,0,0,0,0,0
SAN DIEGO,Feb 2016,DCH,2016,CHILD NUTRITION PROGRAM OF SOUTHERN CALIFORNIA INC ,DCH_SUPPER,21,0,0,0,0,0,0,0,0,0
SAN DIEGO,Mar 2016,DCH,2016,CHILD NUTRITION PROGRAM OF SOUTHERN CALIFORNIA INC ,DCH_BREAKFAST,23,0,0,0,0,77041,0,0,77041,3349.6087
SAN DIEGO,Mar 2016,DCH,2016,CHILD NUTRITION PROGRAM OF SOUTHERN CALIFORNIA INC ,DCH_BREAKFAST,,0,0,0,0,0,411,14474,14885,0
SAN DIEGO,Mar 2016,DCH,2016,CHILD NUTRITION PROGRAM OF SOUTHERN CALIFORNIA INC ,DCH_BREAKFAST,23,0,0,0,0,0,0,0,0,0
SAN DIEGO,Mar 2016,DCH,2016,CHILD NUTRITION PROGRAM OF SOUTHERN CALIFORNIA INC ,DCH_BREAKFAST,23,0,0,0,0,0,0,0,0,0
SAN DIEGO,Mar 2016,DCH,2016,CHILD NUTRITION PROGRAM OF SOUTHERN CALIFORNIA INC ,DCH_LUNCH,23,0,0,0,0,0,0,0,0,0
SAN DIEGO,Mar 2016,DCH,2016,CHILD NUTRITION PROGRAM OF SOUTHERN CALIFORNIA INC ,DCH_LUNCH,,0,0,0,0,0,519,18747,19266,0
SAN DIEGO,Mar 2016,DCH,2016,CHILD NUTRITION PROGRAM OF SOUTHERN CALIFORNIA INC ,DCH_LUNCH,23,0,0,0,0,0,0,0,0,0
SAN DIEGO,Mar 2016,DCH,2016,CHILD NUTRITION PROGRAM OF SOUTHERN CALIFORNIA INC ,DCH_LUNCH,23,0,0,0,0,91131,0,0,91131,3962.2174
SAN DIEGO,Mar 2016,DCH,2016,CHILD NUTRITION PROGRAM OF SOUTHERN CALIFORNIA INC ,DCH_SNACK_AM,23,0,0,0,0,40181,0,0,40181,1747
SAN DIEGO,Mar 2016,DCH,2016,CHILD NUTRITION PROGRAM OF SOUTHERN CALIFORNIA INC ,DCH_SNACK_AM,,0,0,0,0,0,278,9310,9588,0
SAN DIEGO,Mar 2016,DCH,2016,CHILD NUTRITION PROGRAM OF SOUTHERN CALIFORNIA INC ,DCH_SNACK_AM,23,0,0,0,0,0,0,0,0,0
SAN DIEGO,Mar 2016,DCH,2016,CHILD NUTRITION PROGRAM OF SOUTHERN CALIFORNIA INC ,DCH_SNACK_AM,23,0,0,0,0,0,0,0,0,0
SAN DIEGO,Mar 2016,DCH,2016,CHILD NUTRITION PROGRAM OF SOUTHERN CALIFORNIA INC ,DCH_SNACK_NT,23,0,0,0,0,0,0,0,0,0
SAN DIEGO,Mar 2016,DCH,2016,CHILD NUTRITION PROGRAM OF SOUTHERN CALIFORNIA INC ,DCH_SNACK_NT,23,0,0,0,0,0,0,0,0,0
SAN DIEGO,Mar 2016,DCH,2016,CHILD NUTRITION PROGRAM OF SOUTHERN CALIFORNIA INC ,DCH_SNACK_NT,,0,0,0,0,0,7,75,82,0
SAN DIEGO,Mar 2016,DCH,2016,CHILD NUTRITION PROGRAM OF SOUTHERN CALIFORNIA INC ,DCH_SNACK_NT,23,0,0,0,0,2383,0,0,2383,103.6087
SAN DIEGO,Mar 2016,DCH,2016,CHILD NUTRITION PROGRAM OF SOUTHERN CALIFORNIA INC ,DCH_SNACK_PM,23,0,0,0,0,0,0,0,0,0
SAN DIEGO,Mar 2016,DCH,2016,CHILD NUTRITION PROGRAM OF SOUTHERN CALIFORNIA INC ,DCH_SNACK_PM,23,0,0,0,0,0,0,0,0,0
SAN DIEGO,Mar 2016,DCH,2016,CHILD NUTRITION PROGRAM OF SOUTHERN CALIFORNIA INC ,DCH_SNACK_PM,,0,0,0,0,0,330,11957,12287,0
SAN DIEGO,Mar 2016,DCH,2016,CHILD NUTRITION PROGRAM OF SOUTHERN CALIFORNIA INC ,DCH_SNACK_PM,23,0,0,0,0,75986,0,0,75986,3303.7391
SAN DIEGO,Mar 2016,DCH,2016,CHILD NUTRITION PROGRAM OF SOUTHERN CALIFORNIA INC ,DCH_SUPPER,,0,0,0,0,0,266,3832,4098,0
SAN DIEGO,Mar 2016,DCH,2016,CHILD NUTRITION PROGRAM OF SOUTHERN CALIFORNIA INC ,DCH_SUPPER,23,0,0,0,0,0,0,0,0,0
SAN DIEGO,Mar 2016,DCH,2016,CHILD NUTRITION PROGRAM OF SOUTHERN CALIFORNIA INC ,DCH_SUPPER,23,0,0,0,0,35686,0,0,35686,1551.5652
SAN DIEGO,Mar 2016,DCH,2016,CHILD NUTRITION PROGRAM OF SOUTHERN CALIFORNIA INC ,DCH_SUPPER,23,0,0,0,0,0,0,0,0,0
SAN DIEGO,Apr 2016,DCH,2016,CHILD NUTRITION PROGRAM OF SOUTHERN CALIFORNIA INC ,DCH_BREAKFAST,20,0,0,0,0,0,0,0,0,0
SAN DIEGO,Apr 2016,DCH,2016,CHILD NUTRITION PROGRAM OF SOUTHERN CALIFORNIA INC ,DCH_BREAKFAST,21,0,0,0,0,72203,0,0,72203,3438.2381
SAN DIEGO,Apr 2016,DCH,2016,CHILD NUTRITION PROGRAM OF SOUTHERN CALIFORNIA INC ,DCH_BREAKFAST,,0,0,0,0,0,398,13462,13860,0
SAN DIEGO,Apr 2016,DCH,2016,CHILD NUTRITION PROGRAM OF SOUTHERN CALIFORNIA INC ,DCH_BREAKFAST,21,0,0,0,0,0,0,0,0,0
SAN DIEGO,Apr 2016,DCH,2016,CHILD NUTRITION PROGRAM OF SOUTHERN CALIFORNIA INC ,DCH_BREAKFAST,21,0,0,0,0,0,0,0,0,0
SAN DIEGO,Apr 2016,DCH,2016,CHILD NUTRITION PROGRAM OF SOUTHERN CALIFORNIA INC ,DCH_LUNCH,,0,0,0,0,0,441,17208,17649,0
SAN DIEGO,Apr 2016,DCH,2016,CHILD NUTRITION PROGRAM OF SOUTHERN CALIFORNIA INC ,DCH_LUNCH,21,0,0,0,0,0,0,0,0,0
SAN DIEGO,Apr 2016,DCH,2016,CHILD NUTRITION PROGRAM OF SOUTHERN CALIFORNIA INC ,DCH_LUNCH,20,0,0,0,0,0,0,0,0,0
SAN DIEGO,Apr 2016,DCH,2016,CHILD NUTRITION PROGRAM OF SOUTHERN CALIFORNIA INC ,DCH_LUNCH,21,0,0,0,0,0,0,0,0,0
SAN DIEGO,Apr 2016,DCH,2016,CHILD NUTRITION PROGRAM OF SOUTHERN CALIFORNIA INC ,DCH_LUNCH,21,0,0,0,0,81192,0,0,81192,3866.2857
SAN DIEGO,Apr 2016,DCH,2016,CHILD NUTRITION PROGRAM OF SOUTHERN CALIFORNIA INC ,DCH_SNACK_AM,21,0,0,0,0,0,0,0,0,0
SAN DIEGO,Apr 2016,DCH,2016,CHILD NUTRITION PROGRAM OF SOUTHERN CALIFORNIA INC ,DCH_SNACK_AM,20,0,0,0,0,0,0,0,0,0
SAN DIEGO,Apr 2016,DCH,2016,CHILD NUTRITION PROGRAM OF SOUTHERN CALIFORNIA INC ,DCH_SNACK_AM,21,0,0,0,0,0,0,0,0,0
SAN DIEGO,Apr 2016,DCH,2016,CHILD NUTRITION PROGRAM OF SOUTHERN CALIFORNIA INC ,DCH_SNACK_AM,,0,0,0,0,0,233,8785,9018,0
SAN DIEGO,Apr 2016,DCH,2016,CHILD NUTRITION PROGRAM OF SOUTHERN CALIFORNIA INC ,DCH_SNACK_AM,21,0,0,0,0,36009,0,0,36009,1714.7143
SAN DIEGO,Apr 2016,DCH,2016,CHILD NUTRITION PROGRAM OF SOUTHERN CALIFORNIA INC ,DCH_SNACK_NT,21,0,0,0,0,2205,0,0,2205,105
SAN DIEGO,Apr 2016,DCH,2016,CHILD NUTRITION PROGRAM OF SOUTHERN CALIFORNIA INC ,DCH_SNACK_NT,,0,0,0,0,0,1,105,106,0
SAN DIEGO,Apr 2016,DCH,2016,CHILD NUTRITION PROGRAM OF SOUTHERN CALIFORNIA INC ,DCH_SNACK_NT,20,0,0,0,0,0,0,0,0,0
SAN DIEGO,Apr 2016,DCH,2016,CHILD NUTRITION PROGRAM OF SOUTHERN CALIFORNIA INC ,DCH_SNACK_NT,21,0,0,0,0,0,0,0,0,0
SAN DIEGO,Apr 2016,DCH,2016,CHILD NUTRITION PROGRAM OF SOUTHERN CALIFORNIA INC ,DCH_SNACK_NT,21,0,0,0,0,0,0,0,0,0
SAN DIEGO,Apr 2016,DCH,2016,CHILD NUTRITION PROGRAM OF SOUTHERN CALIFORNIA INC ,DCH_SNACK_PM,21,0,0,0,0,0,0,0,0,0
SAN DIEGO,Apr 2016,DCH,2016,CHILD NUTRITION PROGRAM OF SOUTHERN CALIFORNIA INC ,DCH_SNACK_PM,,0,0,0,0,0,310,11147,11457,0
SAN DIEGO,Apr 2016,DCH,2016,CHILD NUTRITION PROGRAM OF SOUTHERN CALIFORNIA INC ,DCH_SNACK_PM,20,0,0,0,0,0,0,0,0,0
SAN DIEGO,Apr 2016,DCH,2016,CHILD NUTRITION PROGRAM OF SOUTHERN CALIFORNIA INC ,DCH_SNACK_PM,21,0,0,0,0,0,0,0,0,0
SAN DIEGO,Apr 2016,DCH,2016,CHILD NUTRITION PROGRAM OF SOUTHERN CALIFORNIA INC ,DCH_SNACK_PM,21,0,0,0,0,71022,0,0,71022,3382
SAN DIEGO,Apr 2016,DCH,2016,CHILD NUTRITION PROGRAM OF SOUTHERN CALIFORNIA INC ,DCH_SUPPER,21,0,0,0,0,0,0,0,0,0
SAN DIEGO,Apr 2016,DCH,2016,CHILD NUTRITION PROGRAM OF SOUTHERN CALIFORNIA INC ,DCH_SUPPER,,0,0,0,0,0,224,3656,3880,0
SAN DIEGO,Apr 2016,DCH,2016,CHILD NUTRITION PROGRAM OF SOUTHERN CALIFORNIA INC ,DCH_SUPPER,21,0,0,0,0,0,0,0,0,0
SAN DIEGO,Apr 2016,DCH,2016,CHILD NUTRITION PROGRAM OF SOUTHERN CALIFORNIA INC ,DCH_SUPPER,20,0,0,0,0,0,0,0,0,0
SAN DIEGO,Apr 2016,DCH,2016,CHILD NUTRITION PROGRAM OF SOUTHERN CALIFORNIA INC ,DCH_SUPPER,21,0,0,0,0,33016,0,0,33016,1572.1905
SAN DIEGO,May 2016,DCH,2016,CHILD NUTRITION PROGRAM OF SOUTHERN CALIFORNIA INC ,DCH_BREAKFAST,,0,0,0,0,0,405,13850,14255,0
SAN DIEGO,May 2016,DCH,2016,CHILD NUTRITION PROGRAM OF SOUTHERN CALIFORNIA INC ,DCH_BREAKFAST,21,0,0,0,0,0,0,0,0,0
SAN DIEGO,May 2016,DCH,2016,CHILD NUTRITION PROGRAM OF SOUTHERN CALIFORNIA INC ,DCH_BREAKFAST,20,0,0,0,0,0,0,0,0,0
SAN DIEGO,May 2016,DCH,2016,CHILD NUTRITION PROGRAM OF SOUTHERN CALIFORNIA INC ,DCH_BREAKFAST,21,0,0,0,0,73250,0,0,73250,3488.0952
SAN DIEGO,May 2016,DCH,2016,CHILD NUTRITION PROGRAM OF SOUTHERN CALIFORNIA INC ,DCH_BREAKFAST,21,0,0,0,0,0,0,0,0,0
SAN DIEGO,May 2016,DCH,2016,CHILD NUTRITION PROGRAM OF SOUTHERN CALIFORNIA INC ,DCH_LUNCH,21,0,0,0,0,81662,0,0,81662,3888.6667
SAN DIEGO,May 2016,DCH,2016,CHILD NUTRITION PROGRAM OF SOUTHERN CALIFORNIA INC ,DCH_LUNCH,21,0,0,0,0,0,0,0,0,0
SAN DIEGO,May 2016,DCH,2016,CHILD NUTRITION PROGRAM OF SOUTHERN CALIFORNIA INC ,DCH_LUNCH,21,0,0,0,0,0,0,0,0,0
SAN DIEGO,May 2016,DCH,2016,CHILD NUTRITION PROGRAM OF SOUTHERN CALIFORNIA INC ,DCH_LUNCH,20,0,0,0,0,0,0,0,0,0
SAN DIEGO,May 2016,DCH,2016,CHILD NUTRITION PROGRAM OF SOUTHERN CALIFORNIA INC ,DCH_LUNCH,,0,0,0,0,0,443,17275,17718,0
SAN DIEGO,May 2016,DCH,2016,CHILD NUTRITION PROGRAM OF SOUTHERN CALIFORNIA INC ,DCH_SNACK_AM,21,0,0,0,0,37136,0,0,37136,1768.381
SAN DIEGO,May 2016,DCH,2016,CHILD NUTRITION PROGRAM OF SOUTHERN CALIFORNIA INC ,DCH_SNACK_AM,20,0,0,0,0,0,0,0,0,0
SAN DIEGO,May 2016,DCH,2016,CHILD NUTRITION PROGRAM OF SOUTHERN CALIFORNIA INC ,DCH_SNACK_AM,21,0,0,0,0,0,0,0,0,0
SAN DIEGO,May 2016,DCH,2016,CHILD NUTRITION PROGRAM OF SOUTHERN CALIFORNIA INC ,DCH_SNACK_AM,21,0,0,0,0,0,0,0,0,0
SAN DIEGO,May 2016,DCH,2016,CHILD NUTRITION PROGRAM OF SOUTHERN CALIFORNIA INC ,DCH_SNACK_AM,,0,0,0,0,0,257,8689,8946,0
SAN DIEGO,May 2016,DCH,2016,CHILD NUTRITION PROGRAM OF SOUTHERN CALIFORNIA INC ,DCH_SNACK_NT,21,0,0,0,0,2211,0,0,2211,105.2857
SAN DIEGO,May 2016,DCH,2016,CHILD NUTRITION PROGRAM OF SOUTHERN CALIFORNIA INC ,DCH_SNACK_NT,21,0,0,0,0,0,0,0,0,0
SAN DIEGO,May 2016,DCH,2016,CHILD NUTRITION PROGRAM OF SOUTHERN CALIFORNIA INC ,DCH_SNACK_NT,21,0,0,0,0,0,0,0,0,0
SAN DIEGO,May 2016,DCH,2016,CHILD NUTRITION PROGRAM OF SOUTHERN CALIFORNIA INC ,DCH_SNACK_NT,20,0,0,0,0,0,0,0,0,0
SAN DIEGO,May 2016,DCH,2016,CHILD NUTRITION PROGRAM OF SOUTHERN CALIFORNIA INC ,DCH_SNACK_NT,,0,0,0,0,0,2,97,99,0
SAN DIEGO,May 2016,DCH,2016,CHILD NUTRITION PROGRAM OF SOUTHERN CALIFORNIA INC ,DCH_SNACK_PM,21,0,0,0,0,0,0,0,0,0
SAN DIEGO,May 2016,DCH,2016,CHILD NUTRITION PROGRAM OF SOUTHERN CALIFORNIA INC ,DCH_SNACK_PM,21,0,0,0,0,0,0,0,0,0
SAN DIEGO,May 2016,DCH,2016,CHILD NUTRITION PROGRAM OF SOUTHERN CALIFORNIA INC ,DCH_SNACK_PM,20,0,0,0,0,0,0,0,0,0
SAN DIEGO,May 2016,DCH,2016,CHILD NUTRITION PROGRAM OF SOUTHERN CALIFORNIA INC ,DCH_SNACK_PM,,0,0,0,0,0,300,11198,11498,0
SAN DIEGO,May 2016,DCH,2016,CHILD NUTRITION PROGRAM OF SOUTHERN CALIFORNIA INC ,DCH_SNACK_PM,21,0,0,0,0,72351,0,0,72351,3445.2857
SAN DIEGO,May 2016,DCH,2016,CHILD NUTRITION PROGRAM OF SOUTHERN CALIFORNIA INC ,DCH_SUPPER,21,0,0,0,0,0,0,0,0,0
SAN DIEGO,May 2016,DCH,2016,CHILD NUTRITION PROGRAM OF SOUTHERN CALIFORNIA INC ,DCH_SUPPER,,0,0,0,0,0,212,3754,3966,0
SAN DIEGO,May 2016,DCH,2016,CHILD NUTRITION PROGRAM OF SOUTHERN CALIFORNIA INC ,DCH_SUPPER,21,0,0,0,0,33842,0,0,33842,1611.5238
SAN DIEGO,May 2016,DCH,2016,CHILD NUTRITION PROGRAM OF SOUTHERN CALIFORNIA INC ,DCH_SUPPER,20,0,0,0,0,0,0,0,0,0
SAN DIEGO,May 2016,DCH,2016,CHILD NUTRITION PROGRAM OF SOUTHERN CALIFORNIA INC ,DCH_SUPPER,21,0,0,0,0,0,0,0,0,0
SAN DIEGO,Jun 2016,DCH,2016,CHILD NUTRITION PROGRAM OF SOUTHERN CALIFORNIA INC ,DCH_BREAKFAST,22,0,0,0,0,0,0,0,0,0
SAN DIEGO,Jun 2016,DCH,2016,CHILD NUTRITION PROGRAM OF SOUTHERN CALIFORNIA INC ,DCH_BREAKFAST,22,0,0,0,0,0,0,0,0,0
SAN DIEGO,Jun 2016,DCH,2016,CHILD NUTRITION PROGRAM OF SOUTHERN CALIFORNIA INC ,DCH_BREAKFAST,17,0,0,0,0,0,0,0,0,0
SAN DIEGO,Jun 2016,DCH,2016,CHILD NUTRITION PROGRAM OF SOUTHERN CALIFORNIA INC ,DCH_BREAKFAST,22,0,0,0,0,70468,0,0,70468,3203.0909
SAN DIEGO,Jun 2016,DCH,2016,CHILD NUTRITION PROGRAM OF SOUTHERN CALIFORNIA INC ,DCH_BREAKFAST,,0,0,0,0,0,312,12751,13063,0
SAN DIEGO,Jun 2016,DCH,2016,CHILD NUTRITION PROGRAM OF SOUTHERN CALIFORNIA INC ,DCH_LUNCH,22,0,0,0,0,95867,0,0,95867,4357.5909
SAN DIEGO,Jun 2016,DCH,2016,CHILD NUTRITION PROGRAM OF SOUTHERN CALIFORNIA INC ,DCH_LUNCH,,0,0,0,0,0,511,16801,17312,0
SAN DIEGO,Jun 2016,DCH,2016,CHILD NUTRITION PROGRAM OF SOUTHERN CALIFORNIA INC ,DCH_LUNCH,22,0,0,0,0,0,0,0,0,0
SAN DIEGO,Jun 2016,DCH,2016,CHILD NUTRITION PROGRAM OF SOUTHERN CALIFORNIA INC ,DCH_LUNCH,22,0,0,0,0,0,0,0,0,0
SAN DIEGO,Jun 2016,DCH,2016,CHILD NUTRITION PROGRAM OF SOUTHERN CALIFORNIA INC ,DCH_LUNCH,17,0,0,0,0,0,0,0,0,0
SAN DIEGO,Jun 2016,DCH,2016,CHILD NUTRITION PROGRAM OF SOUTHERN CALIFORNIA INC ,DCH_SNACK_AM,22,0,0,0,0,0,0,0,0,0
SAN DIEGO,Jun 2016,DCH,2016,CHILD NUTRITION PROGRAM OF SOUTHERN CALIFORNIA INC ,DCH_SNACK_AM,22,0,0,0,0,42109,0,0,42109,1914.0455
SAN DIEGO,Jun 2016,DCH,2016,CHILD NUTRITION PROGRAM OF SOUTHERN CALIFORNIA INC ,DCH_SNACK_AM,,0,0,0,0,0,276,8475,8751,0
SAN DIEGO,Jun 2016,DCH,2016,CHILD NUTRITION PROGRAM OF SOUTHERN CALIFORNIA INC ,DCH_SNACK_AM,17,0,0,0,0,0,0,0,0,0
SAN DIEGO,Jun 2016,DCH,2016,CHILD NUTRITION PROGRAM OF SOUTHERN CALIFORNIA INC ,DCH_SNACK_AM,22,0,0,0,0,0,0,0,0,0
SAN DIEGO,Jun 2016,DCH,2016,CHILD NUTRITION PROGRAM OF SOUTHERN CALIFORNIA INC ,DCH_SNACK_NT,22,0,0,0,0,0,0,0,0,0
SAN DIEGO,Jun 2016,DCH,2016,CHILD NUTRITION PROGRAM OF SOUTHERN CALIFORNIA INC ,DCH_SNACK_NT,22,0,0,0,0,0,0,0,0,0
SAN DIEGO,Jun 2016,DCH,2016,CHILD NUTRITION PROGRAM OF SOUTHERN CALIFORNIA INC ,DCH_SNACK_NT,17,0,0,0,0,0,0,0,0,0
SAN DIEGO,Jun 2016,DCH,2016,CHILD NUTRITION PROGRAM OF SOUTHERN CALIFORNIA INC ,DCH_SNACK_NT,,0,0,0,0,0,1,76,77,0
SAN DIEGO,Jun 2016,DCH,2016,CHILD NUTRITION PROGRAM OF SOUTHERN CALIFORNIA INC ,DCH_SNACK_NT,22,0,0,0,0,1826,0,0,1826,83
SAN DIEGO,Jun 2016,DCH,2016,CHILD NUTRITION PROGRAM OF SOUTHERN CALIFORNIA INC ,DCH_SNACK_PM,22,0,0,0,0,0,0,0,0,0
SAN DIEGO,Jun 2016,DCH,2016,CHILD NUTRITION PROGRAM OF SOUTHERN CALIFORNIA INC ,DCH_SNACK_PM,17,0,0,0,0,0,0,0,0,0
SAN DIEGO,Jun 2016,DCH,2016,CHILD NUTRITION PROGRAM OF SOUTHERN CALIFORNIA INC ,DCH_SNACK_PM,22,0,0,0,0,68133,0,0,68133,3096.9545
SAN DIEGO,Jun 2016,DCH,2016,CHILD NUTRITION PROGRAM OF SOUTHERN CALIFORNIA INC ,DCH_SNACK_PM,,0,0,0,0,0,249,9712,9961,0
SAN DIEGO,Jun 2016,DCH,2016,CHILD NUTRITION PROGRAM OF SOUTHERN CALIFORNIA INC ,DCH_SNACK_PM,22,0,0,0,0,0,0,0,0,0
SAN DIEGO,Jun 2016,DCH,2016,CHILD NUTRITION PROGRAM OF SOUTHERN CALIFORNIA INC ,DCH_SUPPER,17,0,0,0,0,0,0,0,0,0
SAN DIEGO,Jun 2016,DCH,2016,CHILD NUTRITION PROGRAM OF SOUTHERN CALIFORNIA INC ,DCH_SUPPER,22,0,0,0,0,0,0,0,0,0
SAN DIEGO,Jun 2016,DCH,2016,CHILD NUTRITION PROGRAM OF SOUTHERN CALIFORNIA INC ,DCH_SUPPER,,0,0,0,0,0,201,3602,3803,0
SAN DIEGO,Jun 2016,DCH,2016,CHILD NUTRITION PROGRAM OF SOUTHERN CALIFORNIA INC ,DCH_SUPPER,22,0,0,0,0,32964,0,0,32964,1498.3636
SAN DIEGO,Jun 2016,DCH,2016,CHILD NUTRITION PROGRAM OF SOUTHERN CALIFORNIA INC ,DCH_SUPPER,22,0,0,0,0,0,0,0,0,0
SAN DIEGO,Jul 2016,DCH,2016,CHILD NUTRITION PROGRAM OF SOUTHERN CALIFORNIA INC ,DCH_BREAKFAST,,0,0,0,0,0,312,10840,11152,0
SAN DIEGO,Jul 2016,DCH,2016,CHILD NUTRITION PROGRAM OF SOUTHERN CALIFORNIA INC ,DCH_BREAKFAST,17,0,0,0,0,0,0,0,0,0
SAN DIEGO,Jul 2016,DCH,2016,CHILD NUTRITION PROGRAM OF SOUTHERN CALIFORNIA INC ,DCH_BREAKFAST,20,0,0,0,0,0,0,0,0,0
SAN DIEGO,Jul 2016,DCH,2016,CHILD NUTRITION PROGRAM OF SOUTHERN CALIFORNIA INC ,DCH_BREAKFAST,20,0,0,0,0,59531,0,0,59531,2976.55
SAN DIEGO,Jul 2016,DCH,2016,CHILD NUTRITION PROGRAM OF SOUTHERN CALIFORNIA INC ,DCH_BREAKFAST,20,0,0,0,0,0,0,0,0,0
SAN DIEGO,Jul 2016,DCH,2016,CHILD NUTRITION PROGRAM OF SOUTHERN CALIFORNIA INC ,DCH_LUNCH,20,0,0,0,0,0,0,0,0,0
SAN DIEGO,Jul 2016,DCH,2016,CHILD NUTRITION PROGRAM OF SOUTHERN CALIFORNIA INC ,DCH_LUNCH,17,0,0,0,0,0,0,0,0,0
SAN DIEGO,Jul 2016,DCH,2016,CHILD NUTRITION PROGRAM OF SOUTHERN CALIFORNIA INC ,DCH_LUNCH,20,0,0,0,0,0,0,0,0,0
SAN DIEGO,Jul 2016,DCH,2016,CHILD NUTRITION PROGRAM OF SOUTHERN CALIFORNIA INC ,DCH_LUNCH,,0,0,0,0,0,488,14356,14844,0
SAN DIEGO,Jul 2016,DCH,2016,CHILD NUTRITION PROGRAM OF SOUTHERN CALIFORNIA INC ,DCH_LUNCH,20,0,0,0,0,86970,0,0,86970,4348.5
SAN DIEGO,Jul 2016,DCH,2016,CHILD NUTRITION PROGRAM OF SOUTHERN CALIFORNIA INC ,DCH_SNACK_AM,20,0,0,0,0,37883,0,0,37883,1894.15
SAN DIEGO,Jul 2016,DCH,2016,CHILD NUTRITION PROGRAM OF SOUTHERN CALIFORNIA INC ,DCH_SNACK_AM,20,0,0,0,0,0,0,0,0,0
SAN DIEGO,Jul 2016,DCH,2016,CHILD NUTRITION PROGRAM OF SOUTHERN CALIFORNIA INC ,DCH_SNACK_AM,20,0,0,0,0,0,0,0,0,0
SAN DIEGO,Jul 2016,DCH,2016,CHILD NUTRITION PROGRAM OF SOUTHERN CALIFORNIA INC ,DCH_SNACK_AM,17,0,0,0,0,0,0,0,0,0
SAN DIEGO,Jul 2016,DCH,2016,CHILD NUTRITION PROGRAM OF SOUTHERN CALIFORNIA INC ,DCH_SNACK_AM,,0,0,0,0,0,220,7297,7517,0
SAN DIEGO,Jul 2016,DCH,2016,CHILD NUTRITION PROGRAM OF SOUTHERN CALIFORNIA INC ,DCH_SNACK_NT,20,0,0,0,0,0,0,0,0,0
SAN DIEGO,Jul 2016,DCH,2016,CHILD NUTRITION PROGRAM OF SOUTHERN CALIFORNIA INC ,DCH_SNACK_NT,,0,0,0,0,0,0,193,193,0
SAN DIEGO,Jul 2016,DCH,2016,CHILD NUTRITION PROGRAM OF SOUTHERN CALIFORNIA INC ,DCH_SNACK_NT,20,0,0,0,0,0,0,0,0,0
SAN DIEGO,Jul 2016,DCH,2016,CHILD NUTRITION PROGRAM OF SOUTHERN CALIFORNIA INC ,DCH_SNACK_NT,17,0,0,0,0,0,0,0,0,0
SAN DIEGO,Jul 2016,DCH,2016,CHILD NUTRITION PROGRAM OF SOUTHERN CALIFORNIA INC ,DCH_SNACK_NT,20,0,0,0,0,1396,0,0,1396,69.8
SAN DIEGO,Jul 2016,DCH,2016,CHILD NUTRITION PROGRAM OF SOUTHERN CALIFORNIA INC ,DCH_SNACK_PM,20,0,0,0,0,57270,0,0,57270,2863.5
SAN DIEGO,Jul 2016,DCH,2016,CHILD NUTRITION PROGRAM OF SOUTHERN CALIFORNIA INC ,DCH_SNACK_PM,,0,0,0,0,0,306,7935,8241,0
SAN DIEGO,Jul 2016,DCH,2016,CHILD NUTRITION PROGRAM OF SOUTHERN CALIFORNIA INC ,DCH_SNACK_PM,17,0,0,0,0,0,0,0,0,0
SAN DIEGO,Jul 2016,DCH,2016,CHILD NUTRITION PROGRAM OF SOUTHERN CALIFORNIA INC ,DCH_SNACK_PM,20,0,0,0,0,0,0,0,0,0
SAN DIEGO,Jul 2016,DCH,2016,CHILD NUTRITION PROGRAM OF SOUTHERN CALIFORNIA INC ,DCH_SNACK_PM,20,0,0,0,0,0,0,0,0,0
SAN DIEGO,Jul 2016,DCH,2016,CHILD NUTRITION PROGRAM OF SOUTHERN CALIFORNIA INC ,DCH_SUPPER,17,0,0,0,0,0,0,0,0,0
SAN DIEGO,Jul 2016,DCH,2016,CHILD NUTRITION PROGRAM OF SOUTHERN CALIFORNIA INC ,DCH_SUPPER,20,0,0,0,0,28100,0,0,28100,1405
SAN DIEGO,Jul 2016,DCH,2016,CHILD NUTRITION PROGRAM OF SOUTHERN CALIFORNIA INC ,DCH_SUPPER,,0,0,0,0,0,167,3717,3884,0
SAN DIEGO,Jul 2016,DCH,2016,CHILD NUTRITION PROGRAM OF SOUTHERN CALIFORNIA INC ,DCH_SUPPER,20,0,0,0,0,0,0,0,0,0
SAN DIEGO,Jul 2016,DCH,2016,CHILD NUTRITION PROGRAM OF SOUTHERN CALIFORNIA INC ,DCH_SUPPER,20,0,0,0,0,0,0,0,0,0
SAN DIEGO,Oct 2015,CACF,2016,CHILDREN OF THE RAINBOW INC,CHILD_BREAKFAST,21,126,19,15,160,1652,249,197,2098,99.9048
SAN DIEGO,Oct 2015,CACF,2016,CHILDREN OF THE RAINBOW INC,CHILD_LUNCH,21,126,19,15,160,2051,309,245,2605,124.0476
SAN DIEGO,Oct 2015,CACF,2016,CHILDREN OF THE RAINBOW INC,CHILD_SNACK_AM,21,126,19,15,160,1937,292,231,2460,117.1429
SAN DIEGO,Oct 2015,CACF,2016,CHILDREN OF THE RAINBOW INC,CHILD_SNACK_PM,21,126,19,15,160,393,59,47,499,23.7619
SAN DIEGO,Oct 2015,CACF,2016,CHILDREN OF THE RAINBOW INC,CHILD_SUPPER,21,126,19,15,160,83,12,10,105,5
SAN DIEGO,Nov 2015,CACF,2016,CHILDREN OF THE RAINBOW INC,CHILD_BREAKFAST,18,126,19,15,160,1449,219,172,1840,102.2222
SAN DIEGO,Nov 2015,CACF,2016,CHILDREN OF THE RAINBOW INC,CHILD_LUNCH,18,126,19,15,160,1795,271,213,2279,126.6111
SAN DIEGO,Nov 2015,CACF,2016,CHILDREN OF THE RAINBOW INC,CHILD_SNACK_AM,18,126,19,15,160,1690,255,201,2146,119.2222
SAN DIEGO,Nov 2015,CACF,2016,CHILDREN OF THE RAINBOW INC,CHILD_SNACK_PM,18,126,19,15,160,337,51,40,428,23.7778
SAN DIEGO,Nov 2015,CACF,2016,CHILDREN OF THE RAINBOW INC,CHILD_SUPPER,18,126,19,15,160,66,10,8,84,4.6667
SAN DIEGO,Dec 2015,CACF,2016,CHILDREN OF THE RAINBOW INC,CHILD_BREAKFAST,20,126,19,15,160,1458,220,174,1852,92.6
SAN DIEGO,Dec 2015,CACF,2016,CHILDREN OF THE RAINBOW INC,CHILD_LUNCH,20,126,19,15,160,1834,277,218,2329,116.45
SAN DIEGO,Dec 2015,CACF,2016,CHILDREN OF THE RAINBOW INC,CHILD_SNACK_AM,20,126,19,15,160,1704,257,203,2164,108.2
SAN DIEGO,Dec 2015,CACF,2016,CHILDREN OF THE RAINBOW INC,CHILD_SNACK_PM,20,126,19,15,160,365,55,43,463,23.15
SAN DIEGO,Dec 2015,CACF,2016,CHILDREN OF THE RAINBOW INC,CHILD_SUPPER,20,126,19,15,160,92,14,11,117,5.85
SAN DIEGO,Jan 2016,CACF,2016,CHILDREN OF THE RAINBOW INC,CHILD_BREAKFAST,23,126,19,15,160,1519,229,181,1929,83.8696
SAN DIEGO,Jan 2016,CACF,2016,CHILDREN OF THE RAINBOW INC,CHILD_LUNCH,23,126,19,15,160,1914,289,227,2430,105.6522
SAN DIEGO,Jan 2016,CACF,2016,CHILDREN OF THE RAINBOW INC,CHILD_SNACK_AM,23,126,19,15,160,1772,267,211,2250,97.8261
SAN DIEGO,Jan 2016,CACF,2016,CHILDREN OF THE RAINBOW INC,CHILD_SNACK_PM,23,126,19,15,160,390,59,46,495,21.5217
SAN DIEGO,Jan 2016,CACF,2016,CHILDREN OF THE RAINBOW INC,CHILD_SUPPER,23,126,19,15,160,102,15,13,130,5.6522
SAN DIEGO,Feb 2016,CACF,2016,CHILDREN OF THE RAINBOW INC,CHILD_BREAKFAST,24,126,19,15,160,1574,237,188,1999,83.2917
SAN DIEGO,Feb 2016,CACF,2016,CHILDREN OF THE RAINBOW INC,CHILD_LUNCH,24,126,19,15,160,2018,304,240,2562,106.75
SAN DIEGO,Feb 2016,CACF,2016,CHILDREN OF THE RAINBOW INC,CHILD_SNACK_AM,24,126,19,15,160,1862,281,221,2364,98.5
SAN DIEGO,Feb 2016,CACF,2016,CHILDREN OF THE RAINBOW INC,CHILD_SNACK_PM,24,126,19,15,160,437,66,52,555,23.125
SAN DIEGO,Feb 2016,CACF,2016,CHILDREN OF THE RAINBOW INC,CHILD_SUPPER,24,126,19,15,160,94,14,11,119,4.9583
SAN DIEGO,Mar 2016,CACF,2016,CHILDREN OF THE RAINBOW INC,CHILD_BREAKFAST,26,126,19,15,160,1676,253,199,2128,81.8462
SAN DIEGO,Mar 2016,CACF,2016,CHILDREN OF THE RAINBOW INC,CHILD_LUNCH,26,126,19,15,160,2238,338,266,2842,109.3077
SAN DIEGO,Mar 2016,CACF,2016,CHILDREN OF THE RAINBOW INC,CHILD_SNACK_AM,26,126,19,15,160,2053,310,244,2607,100.2692
SAN DIEGO,Mar 2016,CACF,2016,CHILDREN OF THE RAINBOW INC,CHILD_SNACK_PM,26,126,19,15,160,528,80,62,670,25.7692
SAN DIEGO,Mar 2016,CACF,2016,CHILDREN OF THE RAINBOW INC,CHILD_SUPPER,26,126,19,15,160,125,19,15,159,6.1154
SAN DIEGO,Apr 2016,CACF,2016,CHILDREN OF THE RAINBOW INC,CHILD_BREAKFAST,26,126,19,15,160,1733,261,206,2200,84.6154
SAN DIEGO,Apr 2016,CACF,2016,CHILDREN OF THE RAINBOW INC,CHILD_LUNCH,26,126,19,15,160,2221,335,264,2820,108.4615
SAN DIEGO,Apr 2016,CACF,2016,CHILDREN OF THE RAINBOW INC,CHILD_SNACK_AM,26,126,19,15,160,2046,309,243,2598,99.9231
SAN DIEGO,Apr 2016,CACF,2016,CHILDREN OF THE RAINBOW INC,CHILD_SNACK_PM,26,126,19,15,160,463,70,55,588,22.6154
SAN DIEGO,Apr 2016,CACF,2016,CHILDREN OF THE RAINBOW INC,CHILD_SUPPER,26,126,19,15,160,96,14,12,122,4.6923
SAN DIEGO,May 2016,CACF,2016,CHILDREN OF THE RAINBOW INC,CHILD_BREAKFAST,25,126,19,15,160,1733,261,207,2201,88.04
SAN DIEGO,May 2016,CACF,2016,CHILDREN OF THE RAINBOW INC,CHILD_LUNCH,25,126,19,15,160,2207,333,262,2802,112.08
SAN DIEGO,May 2016,CACF,2016,CHILDREN OF THE RAINBOW INC,CHILD_SNACK_AM,25,126,19,15,160,2046,309,243,2598,103.92
SAN DIEGO,May 2016,CACF,2016,CHILDREN OF THE RAINBOW INC,CHILD_SNACK_PM,25,126,19,15,160,447,67,53,567,22.68
SAN DIEGO,May 2016,CACF,2016,CHILDREN OF THE RAINBOW INC,CHILD_SUPPER,25,126,19,15,160,95,14,11,120,4.8
SAN DIEGO,Jun 2016,CACF,2016,CHILDREN OF THE RAINBOW INC,CHILD_BREAKFAST,26,126,19,15,160,1806,272,215,2293,88.1923
SAN DIEGO,Jun 2016,CACF,2016,CHILDREN OF THE RAINBOW INC,CHILD_LUNCH,26,126,19,15,160,2170,327,258,2755,105.9615
SAN DIEGO,Jun 2016,CACF,2016,CHILDREN OF THE RAINBOW INC,CHILD_SNACK_AM,26,126,19,15,160,2045,309,243,2597,99.8846
SAN DIEGO,Jun 2016,CACF,2016,CHILDREN OF THE RAINBOW INC,CHILD_SNACK_PM,26,126,19,15,160,390,59,46,495,19.0385
SAN DIEGO,Jun 2016,CACF,2016,CHILDREN OF THE RAINBOW INC,CHILD_SUPPER,26,126,19,15,160,80,12,10,102,3.9231
SAN DIEGO,Jul 2016,CACF,2016,CHILDREN OF THE RAINBOW INC,CHILD_BREAKFAST,24,120,17,23,160,1400,198,268,1866,77.75
SAN DIEGO,Jul 2016,CACF,2016,CHILDREN OF THE RAINBOW INC,CHILD_LUNCH,24,120,17,23,160,1713,243,328,2284,95.1667
SAN DIEGO,Jul 2016,CACF,2016,CHILDREN OF THE RAINBOW INC,CHILD_SNACK_AM,24,120,17,23,160,1616,229,309,2154,89.75
SAN DIEGO,Jul 2016,CACF,2016,CHILDREN OF THE RAINBOW INC,CHILD_SNACK_PM,24,120,17,23,160,331,47,63,441,18.375
SAN DIEGO,Jul 2016,CACF,2016,CHILDREN OF THE RAINBOW INC,CHILD_SUPPER,24,120,17,23,160,77,11,15,103,4.2917
SAN DIEGO,Oct 2015,CACF,2016,CHILDRENS PARADISE INC,CHILD_BREAKFAST,22,252,10,88,350,1411,56,493,1960,89.0909
SAN DIEGO,Oct 2015,CACF,2016,CHILDRENS PARADISE INC,CHILD_LUNCH,22,252,10,88,350,1620,64,566,2250,102.2727
SAN DIEGO,Oct 2015,CACF,2016,CHILDRENS PARADISE INC,CHILD_SNACK_PM,22,252,10,88,350,1482,59,517,2058,93.5455
SAN DIEGO,Oct 2015,CACF,2016,CHILDRENS PARADISE INC,HS_CHILD_BREAKFAST,22,273,0,0,273,4311,0,0,4311,195.9545
SAN DIEGO,Oct 2015,CACF,2016,CHILDRENS PARADISE INC,HS_CHILD_LUNCH,22,273,0,0,273,4907,0,0,4907,223.0455
SAN DIEGO,Oct 2015,CACF,2016,CHILDRENS PARADISE INC,HS_CHILD_SNACK_PM,22,273,0,0,273,3423,0,0,3423,155.5909
SAN DIEGO,Oct 2015,CACF,2016,CHILDRENS PARADISE INC,OSCH_CHILD_BREAKFAST,22,85,3,21,109,398,14,98,510,23.1818
SAN DIEGO,Oct 2015,CACF,2016,CHILDRENS PARADISE INC,OSCH_CHILD_LUNCH,22,85,3,21,109,233,8,58,299,13.5909
SAN DIEGO,Oct 2015,CACF,2016,CHILDRENS PARADISE INC,OSCH_CHILD_SNACK_PM,22,85,3,21,109,1109,39,274,1422,64.6364
SAN DIEGO,Nov 2015,CACF,2016,CHILDRENS PARADISE INC,CHILD_BREAKFAST,19,252,10,88,350,1323,53,461,1837,96.6842
SAN DIEGO,Nov 2015,CACF,2016,CHILDRENS PARADISE INC,CHILD_LUNCH,19,252,10,88,350,1495,59,522,2076,109.2632
SAN DIEGO,Nov 2015,CACF,2016,CHILDRENS PARADISE INC,CHILD_SNACK_PM,19,252,10,88,350,1240,49,433,1722,90.6316
SAN DIEGO,Nov 2015,CACF,2016,CHILDRENS PARADISE INC,HS_CHILD_BREAKFAST,19,287,0,0,287,3461,0,0,3461,182.1579
SAN DIEGO,Nov 2015,CACF,2016,CHILDRENS PARADISE INC,HS_CHILD_LUNCH,19,287,0,0,287,3951,0,0,3951,207.9474
SAN DIEGO,Nov 2015,CACF,2016,CHILDRENS PARADISE INC,HS_CHILD_SNACK_PM,19,287,0,0,287,2878,0,0,2878,151.4737
SAN DIEGO,Nov 2015,CACF,2016,CHILDRENS PARADISE INC,OSCH_CHILD_BREAKFAST,19,85,3,21,109,467,16,116,599,31.5263
SAN DIEGO,Nov 2015,CACF,2016,CHILDRENS PARADISE INC,OSCH_CHILD_LUNCH,19,85,3,21,109,442,16,109,567,29.8421
SAN DIEGO,Nov 2015,CACF,2016,CHILDRENS PARADISE INC,OSCH_CHILD_SNACK_PM,19,85,3,21,109,1001,35,248,1284,67.5789
SAN DIEGO,Dec 2015,CACF,2016,CHILDRENS PARADISE INC,CHILD_BREAKFAST,20,270,21,105,396,1292,100,503,1895,94.75
SAN DIEGO,Dec 2015,CACF,2016,CHILDRENS PARADISE INC,CHILD_LUNCH,20,270,21,105,396,1468,114,571,2153,107.65
SAN DIEGO,Dec 2015,CACF,2016,CHILDRENS PARADISE INC,CHILD_SNACK_PM,20,270,21,105,396,1184,92,461,1737,86.85
SAN DIEGO,Dec 2015,CACF,2016,CHILDRENS PARADISE INC,HS_CHILD_BREAKFAST,20,286,0,0,286,3388,0,0,3388,169.4
SAN DIEGO,Dec 2015,CACF,2016,CHILDRENS PARADISE INC,HS_CHILD_LUNCH,20,286,0,0,286,3972,0,0,3972,198.6
SAN DIEGO,Dec 2015,CACF,2016,CHILDRENS PARADISE INC,HS_CHILD_SNACK_PM,20,286,0,0,286,2946,0,0,2946,147.3
SAN DIEGO,Dec 2015,CACF,2016,CHILDRENS PARADISE INC,OSCH_CHILD_BREAKFAST,20,90,4,23,117,478,21,122,621,31.05
SAN DIEGO,Dec 2015,CACF,2016,CHILDRENS PARADISE INC,OSCH_CHILD_LUNCH,20,90,4,23,117,412,18,106,536,26.8
SAN DIEGO,Dec 2015,CACF,2016,CHILDRENS PARADISE INC,OSCH_CHILD_SNACK_PM,20,90,4,23,117,1001,44,256,1301,65.05
SAN DIEGO,Jan 2016,CACF,2016,CHILDRENS PARADISE INC,CHILD_BREAKFAST,20,272,24,103,399,1368,121,518,2007,100.35
SAN DIEGO,Jan 2016,CACF,2016,CHILDRENS PARADISE INC,CHILD_LUNCH,20,272,24,103,399,1565,138,593,2296,114.8
SAN DIEGO,Jan 2016,CACF,2016,CHILDRENS PARADISE INC,CHILD_SNACK_PM,20,272,24,103,399,1272,112,482,1866,93.3
SAN DIEGO,Jan 2016,CACF,2016,CHILDRENS PARADISE INC,HS_CHILD_BREAKFAST,20,287,0,0,287,3850,0,0,3850,192.5
SAN DIEGO,Jan 2016,CACF,2016,CHILDRENS PARADISE INC,HS_CHILD_LUNCH,20,287,0,0,287,4563,0,0,4563,228.15
SAN DIEGO,Jan 2016,CACF,2016,CHILDRENS PARADISE INC,HS_CHILD_SNACK_PM,20,287,0,0,287,3082,0,0,3082,154.1
SAN DIEGO,Jan 2016,CACF,2016,CHILDRENS PARADISE INC,OSCH_CHILD_BREAKFAST,20,90,4,23,117,394,18,100,512,25.6
SAN DIEGO,Jan 2016,CACF,2016,CHILDRENS PARADISE INC,OSCH_CHILD_LUNCH,20,90,4,23,117,295,13,75,383,19.15
SAN DIEGO,Jan 2016,CACF,2016,CHILDRENS PARADISE INC,OSCH_CHILD_SNACK_PM,20,90,4,23,117,984,44,251,1279,63.95
SAN DIEGO,Feb 2016,CACF,2016,CHILDRENS PARADISE INC,CHILD_BREAKFAST,19,279,30,103,412,1453,156,536,2145,112.8947
SAN DIEGO,Feb 2016,CACF,2016,CHILDRENS PARADISE INC,CHILD_LUNCH,19,279,30,103,412,1654,178,611,2443,128.5789
SAN DIEGO,Feb 2016,CACF,2016,CHILDRENS PARADISE INC,CHILD_SNACK_PM,19,279,30,103,412,1306,140,483,1929,101.5263
SAN DIEGO,Feb 2016,CACF,2016,CHILDRENS PARADISE INC,HS_CHILD_BREAKFAST,19,288,0,0,288,3794,0,0,3794,199.6842
SAN DIEGO,Feb 2016,CACF,2016,CHILDRENS PARADISE INC,HS_CHILD_LUNCH,19,288,0,0,288,4424,0,0,4424,232.8421
SAN DIEGO,Feb 2016,CACF,2016,CHILDRENS PARADISE INC,HS_CHILD_SNACK_PM,19,288,0,0,288,3152,0,0,3152,165.8947
SAN DIEGO,Feb 2016,CACF,2016,CHILDRENS PARADISE INC,OSCH_CHILD_BREAKFAST,19,95,4,23,122,301,13,72,386,20.3158
SAN DIEGO,Feb 2016,CACF,2016,CHILDRENS PARADISE INC,OSCH_CHILD_LUNCH,19,95,4,23,122,184,8,44,236,12.4211
SAN DIEGO,Feb 2016,CACF,2016,CHILDRENS PARADISE INC,OSCH_CHILD_SNACK_PM,19,95,4,23,122,983,41,239,1263,66.4737
SAN DIEGO,Mar 2016,CACF,2016,CHILDRENS PARADISE INC,CHILD_BREAKFAST,23,279,30,103,412,1735,187,640,2562,111.3913
SAN DIEGO,Mar 2016,CACF,2016,CHILDRENS PARADISE INC,CHILD_LUNCH,23,279,30,103,412,2034,219,751,3004,130.6087
SAN DIEGO,Mar 2016,CACF,2016,CHILDRENS PARADISE INC,CHILD_SNACK_PM,23,279,30,103,412,1584,170,585,2339,101.6957
SAN DIEGO,Mar 2016,CACF,2016,CHILDRENS PARADISE INC,HS_CHILD_BREAKFAST,23,284,0,0,284,3984,0,0,3984,173.2174
SAN DIEGO,Mar 2016,CACF,2016,CHILDRENS PARADISE INC,HS_CHILD_LUNCH,23,284,0,0,284,4714,0,0,4714,204.9565
SAN DIEGO,Mar 2016,CACF,2016,CHILDRENS PARADISE INC,HS_CHILD_SNACK_PM,23,284,0,0,284,3632,0,0,3632,157.913
SAN DIEGO,Mar 2016,CACF,2016,CHILDRENS PARADISE INC,OSCH_CHILD_BREAKFAST,23,95,4,23,122,500,21,121,642,27.913
SAN DIEGO,Mar 2016,CACF,2016,CHILDRENS PARADISE INC,OSCH_CHILD_LUNCH,23,95,4,23,122,416,18,100,534,23.2174
SAN DIEGO,Mar 2016,CACF,2016,CHILDRENS PARADISE INC,OSCH_CHILD_SNACK_PM,23,95,4,23,122,1190,50,288,1528,66.4348
SAN DIEGO,Apr 2016,CACF,2016,CHILDRENS PARADISE INC,CHILD_BREAKFAST,21,279,30,103,412,1757,189,649,2595,123.5714
SAN DIEGO,Apr 2016,CACF,2016,CHILDRENS PARADISE INC,CHILD_LUNCH,21,279,30,103,412,2068,222,764,3054,145.4286
SAN DIEGO,Apr 2016,CACF,2016,CHILDRENS PARADISE INC,CHILD_SNACK_PM,21,279,30,103,412,1670,180,616,2466,117.4286
SAN DIEGO,Apr 2016,CACF,2016,CHILDRENS PARADISE INC,HS_CHILD_BREAKFAST,21,287,0,0,287,4007,0,0,4007,190.8095
SAN DIEGO,Apr 2016,CACF,2016,CHILDRENS PARADISE INC,HS_CHILD_LUNCH,21,287,0,0,287,4837,0,0,4837,230.3333
SAN DIEGO,Apr 2016,CACF,2016,CHILDRENS PARADISE INC,HS_CHILD_SNACK_PM,21,287,0,0,287,3831,0,0,3831,182.4286
SAN DIEGO,Apr 2016,CACF,2016,CHILDRENS PARADISE INC,OSCH_CHILD_BREAKFAST,21,95,4,23,122,543,23,131,697,33.1905
SAN DIEGO,Apr 2016,CACF,2016,CHILDRENS PARADISE INC,OSCH_CHILD_LUNCH,21,95,4,23,122,540,23,131,694,33.0476
SAN DIEGO,Apr 2016,CACF,2016,CHILDRENS PARADISE INC,OSCH_CHILD_SNACK_PM,21,95,4,23,122,1290,54,312,1656,78.8571
SAN DIEGO,May 2016,CACF,2016,CHILDRENS PARADISE INC,CHILD_BREAKFAST,22,279,30,103,412,1886,203,696,2785,126.5909
SAN DIEGO,May 2016,CACF,2016,CHILDRENS PARADISE INC,CHILD_LUNCH,22,279,30,103,412,2140,230,790,3160,143.6364
SAN DIEGO,May 2016,CACF,2016,CHILDRENS PARADISE INC,CHILD_SNACK_PM,22,279,30,103,412,1655,178,611,2444,111.0909
SAN DIEGO,May 2016,CACF,2016,CHILDRENS PARADISE INC,HS_CHILD_BREAKFAST,22,288,0,0,288,4206,0,0,4206,191.1818
SAN DIEGO,May 2016,CACF,2016,CHILDRENS PARADISE INC,HS_CHILD_LUNCH,22,288,0,0,288,4983,0,0,4983,226.5
SAN DIEGO,May 2016,CACF,2016,CHILDRENS PARADISE INC,HS_CHILD_SNACK_PM,22,288,0,0,288,4066,0,0,4066,184.8182
SAN DIEGO,May 2016,CACF,2016,CHILDRENS PARADISE INC,OSCH_CHILD_BREAKFAST,22,95,4,23,122,640,27,155,822,37.3636
SAN DIEGO,May 2016,CACF,2016,CHILDRENS PARADISE INC,OSCH_CHILD_LUNCH,22,95,4,23,122,690,29,167,886,40.2727
SAN DIEGO,May 2016,CACF,2016,CHILDRENS PARADISE INC,OSCH_CHILD_SNACK_PM,22,95,4,23,122,1307,55,316,1678,76.2727
SAN DIEGO,Jun 2016,CACF,2016,CHILDRENS PARADISE INC,CHILD_BREAKFAST,22,279,30,103,412,1623,175,599,2397,108.9545
SAN DIEGO,Jun 2016,CACF,2016,CHILDRENS PARADISE INC,CHILD_LUNCH,22,279,30,103,412,1988,214,734,2936,133.4545
SAN DIEGO,Jun 2016,CACF,2016,CHILDRENS PARADISE INC,CHILD_SNACK_PM,22,279,30,103,412,1547,166,571,2284,103.8182
SAN DIEGO,Jun 2016,CACF,2016,CHILDRENS PARADISE INC,HS_CHILD_BREAKFAST,22,288,0,0,288,3349,0,0,3349,152.2273
SAN DIEGO,Jun 2016,CACF,2016,CHILDRENS PARADISE INC,HS_CHILD_LUNCH,22,288,0,0,288,4123,0,0,4123,187.4091
SAN DIEGO,Jun 2016,CACF,2016,CHILDRENS PARADISE INC,HS_CHILD_SNACK_PM,22,288,0,0,288,3016,0,0,3016,137.0909
SAN DIEGO,Jun 2016,CACF,2016,CHILDRENS PARADISE INC,OSCH_CHILD_BREAKFAST,22,96,5,16,117,993,52,165,1210,55
SAN DIEGO,Jun 2016,CACF,2016,CHILDRENS PARADISE INC,OSCH_CHILD_LUNCH,22,96,5,16,117,1093,57,182,1332,60.5455
SAN DIEGO,Jun 2016,CACF,2016,CHILDRENS PARADISE INC,OSCH_CHILD_SNACK_PM,22,96,5,16,117,1195,62,200,1457,66.2273
SAN DIEGO,Jul 2016,CACF,2016,CHILDRENS PARADISE INC,CHILD_BREAKFAST,20,279,30,103,412,2112,227,779,3118,155.9
SAN DIEGO,Jul 2016,CACF,2016,CHILDRENS PARADISE INC,CHILD_LUNCH,20,279,30,103,412,2596,279,958,3833,191.65
SAN DIEGO,Jul 2016,CACF,2016,CHILDRENS PARADISE INC,CHILD_SNACK_PM,20,279,30,103,412,2300,247,849,3396,169.8
SAN DIEGO,Jul 2016,CACF,2016,CHILDRENS PARADISE INC,HS_CHILD_BREAKFAST,20,292,0,0,292,1098,0,0,1098,54.9
SAN DIEGO,Jul 2016,CACF,2016,CHILDRENS PARADISE INC,HS_CHILD_LUNCH,20,292,0,0,292,1341,0,0,1341,67.05
SAN DIEGO,Jul 2016,CACF,2016,CHILDRENS PARADISE INC,HS_CHILD_SNACK_PM,20,292,0,0,292,1395,0,0,1395,69.75
SAN DIEGO,Jul 2016,CACF,2016,CHILDRENS PARADISE INC,OSCH_CHILD_BREAKFAST,20,96,5,16,117,1163,61,194,1418,70.9
SAN DIEGO,Jul 2016,CACF,2016,CHILDRENS PARADISE INC,OSCH_CHILD_LUNCH,20,96,5,16,117,1293,67,216,1576,78.8
SAN DIEGO,Jul 2016,CACF,2016,CHILDRENS PARADISE INC,OSCH_CHILD_SNACK_PM,20,96,5,16,117,1236,64,207,1507,75.35
SAN DIEGO,Oct 2015,CACF,2016,Chula Vista Elementary School District,CHILD_BREAKFAST,19,527,156,120,803,4176,1236,951,6363,334.8947
SAN DIEGO,Oct 2015,CACF,2016,Chula Vista Elementary School District,CHILD_LUNCH,19,527,156,120,803,3912,1158,890,5960,313.6842
SAN DIEGO,Nov 2015,CACF,2016,Chula Vista Elementary School District,CHILD_BREAKFAST,15,527,156,120,803,3270,968,745,4983,332.2
SAN DIEGO,Nov 2015,CACF,2016,Chula Vista Elementary School District,CHILD_LUNCH,15,527,156,120,803,3046,902,693,4641,309.4
SAN DIEGO,Dec 2015,Cacf,2016,Chula Vista Elementary School District,CHILD_BREAKFAST,14,527,156,120,803,3014,892,686,4592,328
SAN DIEGO,Dec 2015,Cacf,2016,Chula Vista Elementary School District,CHILD_LUNCH,14,527,156,120,803,2831,838,644,4313,308.0714
SAN DIEGO,Jan 2016,Cacf,2016,Chula Vista Elementary School District,CHILD_BREAKFAST,14,527,156,120,803,2795,827,636,4258,304.1429
SAN DIEGO,Jan 2016,Cacf,2016,Chula Vista Elementary School District,CHILD_LUNCH,14,527,156,120,803,2745,813,624,4182,298.7143
SAN DIEGO,Feb 2016,Cacf,2016,Chula Vista Elementary School District,CHILD_BREAKFAST,19,527,156,120,803,4090,1211,931,6232,328
SAN DIEGO,Feb 2016,Cacf,2016,Chula Vista Elementary School District,CHILD_LUNCH,19,527,156,120,803,3965,1174,902,6041,317.9474
SAN DIEGO,Mar 2016,CACF,2016,Chula Vista Elementary School District,CHILD_BREAKFAST,15,527,156,120,803,3062,907,697,4666,311.0667
SAN DIEGO,Mar 2016,CACF,2016,Chula Vista Elementary School District,CHILD_LUNCH,15,527,156,120,803,2930,867,667,4464,297.6
SAN DIEGO,Apr 2016,CACF,2016,Chula Vista Elementary School District,CHILD_BREAKFAST,20,527,156,120,803,4371,1294,995,6660,333
SAN DIEGO,Apr 2016,CACF,2016,Chula Vista Elementary School District,CHILD_LUNCH,20,527,156,120,803,4108,1216,935,6259,312.95
SAN DIEGO,May 2016,Cacf,2016,Chula Vista Elementary School District,CHILD_BREAKFAST,21,527,156,120,803,4509,1335,1026,6870,327.1429
SAN DIEGO,May 2016,Cacf,2016,Chula Vista Elementary School District,CHILD_LUNCH,21,527,156,120,803,4326,1281,985,6592,313.9048
SAN DIEGO,Jun 2016,Cacf,2016,Chula Vista Elementary School District,CHILD_BREAKFAST,9,527,156,120,803,696,206,159,1061,117.8889
SAN DIEGO,Jun 2016,Cacf,2016,Chula Vista Elementary School District,CHILD_LUNCH,9,527,156,120,803,644,191,146,981,109
SAN DIEGO,Jul 2016,CACF,2016,Chula Vista Elementary School District,CHILD_BREAKFAST,8,527,156,120,803,1261,373,287,1921,240.125
SAN DIEGO,Jul 2016,CACF,2016,Chula Vista Elementary School District,CHILD_LUNCH,8,527,156,120,803,996,295,226,1517,189.625
SAN DIEGO,Oct 2015,CACF,2016,CHURCH OF COMPASSION DAYSPRING CHRISTIAN LRNING CTR,CHILD_BREAKFAST,22,28,1,25,54,370,13,331,714,32.4545
SAN DIEGO,Oct 2015,CACF,2016,CHURCH OF COMPASSION DAYSPRING CHRISTIAN LRNING CTR,CHILD_LUNCH,22,28,1,25,54,528,19,472,1019,46.3182
SAN DIEGO,Oct 2015,CACF,2016,CHURCH OF COMPASSION DAYSPRING CHRISTIAN LRNING CTR,CHILD_SNACK_PM,22,28,1,25,54,439,16,391,846,38.4545
SAN DIEGO,Oct 2015,CACF,2016,CHURCH OF COMPASSION DAYSPRING CHRISTIAN LRNING CTR,OSCH_CHILD_BREAKFAST,22,27,2,7,36,230,17,60,307,13.9545
SAN DIEGO,Oct 2015,CACF,2016,CHURCH OF COMPASSION DAYSPRING CHRISTIAN LRNING CTR,OSCH_CHILD_LUNCH,22,27,2,7,36,128,9,33,170,7.7273
SAN DIEGO,Oct 2015,CACF,2016,CHURCH OF COMPASSION DAYSPRING CHRISTIAN LRNING CTR,OSCH_CHILD_SNACK_PM,22,27,2,7,36,302,22,79,403,18.3182
SAN DIEGO,Nov 2015,CACF,2016,CHURCH OF COMPASSION DAYSPRING CHRISTIAN LRNING CTR,CHILD_BREAKFAST,18,28,1,25,54,307,11,274,592,32.8889
SAN DIEGO,Nov 2015,CACF,2016,CHURCH OF COMPASSION DAYSPRING CHRISTIAN LRNING CTR,CHILD_LUNCH,18,28,1,25,54,432,15,386,833,46.2778
SAN DIEGO,Nov 2015,CACF,2016,CHURCH OF COMPASSION DAYSPRING CHRISTIAN LRNING CTR,CHILD_SNACK_PM,18,28,1,25,54,371,13,332,716,39.7778
SAN DIEGO,Nov 2015,CACF,2016,CHURCH OF COMPASSION DAYSPRING CHRISTIAN LRNING CTR,OSCH_CHILD_BREAKFAST,18,27,2,7,36,183,14,47,244,13.5556
SAN DIEGO,Nov 2015,CACF,2016,CHURCH OF COMPASSION DAYSPRING CHRISTIAN LRNING CTR,OSCH_CHILD_LUNCH,18,27,2,7,36,132,10,34,176,9.7778
SAN DIEGO,Nov 2015,CACF,2016,CHURCH OF COMPASSION DAYSPRING CHRISTIAN LRNING CTR,OSCH_CHILD_SNACK_PM,18,27,2,7,36,244,18,63,325,18.0556
SAN DIEGO,Dec 2015,CACF,2016,CHURCH OF COMPASSION DAYSPRING CHRISTIAN LRNING CTR,CHILD_BREAKFAST,18,28,1,25,54,289,10,259,558,31
SAN DIEGO,Dec 2015,CACF,2016,CHURCH OF COMPASSION DAYSPRING CHRISTIAN LRNING CTR,CHILD_LUNCH,18,28,1,25,54,426,15,380,821,45.6111
SAN DIEGO,Dec 2015,CACF,2016,CHURCH OF COMPASSION DAYSPRING CHRISTIAN LRNING CTR,CHILD_SNACK_PM,18,28,1,25,54,368,13,329,710,39.4444
SAN DIEGO,Dec 2015,CACF,2016,CHURCH OF COMPASSION DAYSPRING CHRISTIAN LRNING CTR,OSCH_CHILD_BREAKFAST,18,27,2,7,36,189,14,49,252,14
SAN DIEGO,Dec 2015,CACF,2016,CHURCH OF COMPASSION DAYSPRING CHRISTIAN LRNING CTR,OSCH_CHILD_LUNCH,18,27,2,7,36,128,9,33,170,9.4444
SAN DIEGO,Dec 2015,CACF,2016,CHURCH OF COMPASSION DAYSPRING CHRISTIAN LRNING CTR,OSCH_CHILD_SNACK_PM,18,27,2,7,36,238,18,61,317,17.6111
SAN DIEGO,Jan 2016,CACF,2016,CHURCH OF COMPASSION DAYSPRING CHRISTIAN LRNING CTR,CHILD_BREAKFAST,19,28,1,25,54,302,11,269,582,30.6316
SAN DIEGO,Jan 2016,CACF,2016,CHURCH OF COMPASSION DAYSPRING CHRISTIAN LRNING CTR,CHILD_LUNCH,19,28,1,25,54,416,15,371,802,42.2105
SAN DIEGO,Jan 2016,CACF,2016,CHURCH OF COMPASSION DAYSPRING CHRISTIAN LRNING CTR,CHILD_SNACK_PM,19,28,1,25,54,354,13,315,682,35.8947
SAN DIEGO,Jan 2016,CACF,2016,CHURCH OF COMPASSION DAYSPRING CHRISTIAN LRNING CTR,OSCH_CHILD_BREAKFAST,19,27,2,7,36,192,14,50,256,13.4737
SAN DIEGO,Jan 2016,CACF,2016,CHURCH OF COMPASSION DAYSPRING CHRISTIAN LRNING CTR,OSCH_CHILD_LUNCH,19,27,2,7,36,127,9,33,169,8.8947
SAN DIEGO,Jan 2016,CACF,2016,CHURCH OF COMPASSION DAYSPRING CHRISTIAN LRNING CTR,OSCH_CHILD_SNACK_PM,19,27,2,7,36,272,20,70,362,19.0526
SAN DIEGO,Feb 2016,CACF,2016,CHURCH OF COMPASSION DAYSPRING CHRISTIAN LRNING CTR,CHILD_BREAKFAST,20,28,1,25,54,357,13,318,688,34.4
SAN DIEGO,Feb 2016,CACF,2016,CHURCH OF COMPASSION DAYSPRING CHRISTIAN LRNING CTR,CHILD_LUNCH,20,28,1,25,54,479,17,428,924,46.2
SAN DIEGO,Feb 2016,CACF,2016,CHURCH OF COMPASSION DAYSPRING CHRISTIAN LRNING CTR,CHILD_SNACK_PM,20,28,1,25,54,415,15,371,801,40.05
SAN DIEGO,Feb 2016,CACF,2016,CHURCH OF COMPASSION DAYSPRING CHRISTIAN LRNING CTR,OSCH_CHILD_BREAKFAST,20,27,2,7,36,180,13,47,240,12
SAN DIEGO,Feb 2016,CACF,2016,CHURCH OF COMPASSION DAYSPRING CHRISTIAN LRNING CTR,OSCH_CHILD_LUNCH,20,27,2,7,36,117,9,30,156,7.8
SAN DIEGO,Feb 2016,CACF,2016,CHURCH OF COMPASSION DAYSPRING CHRISTIAN LRNING CTR,OSCH_CHILD_SNACK_PM,20,27,2,7,36,297,22,77,396,19.8
SAN DIEGO,Mar 2016,CACF,2016,CHURCH OF COMPASSION DAYSPRING CHRISTIAN LRNING CTR,CHILD_BREAKFAST,23,28,1,25,54,435,16,387,838,36.4348
SAN DIEGO,Mar 2016,CACF,2016,CHURCH OF COMPASSION DAYSPRING CHRISTIAN LRNING CTR,CHILD_LUNCH,23,28,1,25,54,559,20,500,1079,46.913
SAN DIEGO,Mar 2016,CACF,2016,CHURCH OF COMPASSION DAYSPRING CHRISTIAN LRNING CTR,CHILD_SNACK_PM,23,28,1,25,54,514,18,460,992,43.1304
SAN DIEGO,Mar 2016,CACF,2016,CHURCH OF COMPASSION DAYSPRING CHRISTIAN LRNING CTR,OSCH_CHILD_BREAKFAST,23,27,2,7,36,218,16,57,291,12.6522
SAN DIEGO,Mar 2016,CACF,2016,CHURCH OF COMPASSION DAYSPRING CHRISTIAN LRNING CTR,OSCH_CHILD_LUNCH,23,27,2,7,36,199,15,51,265,11.5217
SAN DIEGO,Mar 2016,CACF,2016,CHURCH OF COMPASSION DAYSPRING CHRISTIAN LRNING CTR,OSCH_CHILD_SNACK_PM,23,27,2,7,36,337,25,87,449,19.5217
SAN DIEGO,Apr 2016,CACF,2016,CHURCH OF COMPASSION DAYSPRING CHRISTIAN LRNING CTR,CHILD_BREAKFAST,21,28,1,25,54,397,14,354,765,36.4286
SAN DIEGO,Apr 2016,CACF,2016,CHURCH OF COMPASSION DAYSPRING CHRISTIAN LRNING CTR,CHILD_LUNCH,21,28,1,25,54,526,19,470,1015,48.3333
SAN DIEGO,Apr 2016,CACF,2016,CHURCH OF COMPASSION DAYSPRING CHRISTIAN LRNING CTR,CHILD_SNACK_PM,21,28,1,25,54,482,17,431,930,44.2857
SAN DIEGO,Apr 2016,CACF,2016,CHURCH OF COMPASSION DAYSPRING CHRISTIAN LRNING CTR,OSCH_CHILD_BREAKFAST,21,27,2,7,36,131,10,33,174,8.2857
SAN DIEGO,Apr 2016,CACF,2016,CHURCH OF COMPASSION DAYSPRING CHRISTIAN LRNING CTR,OSCH_CHILD_LUNCH,21,27,2,7,36,116,9,30,155,7.381
SAN DIEGO,Apr 2016,CACF,2016,CHURCH OF COMPASSION DAYSPRING CHRISTIAN LRNING CTR,OSCH_CHILD_SNACK_PM,21,27,2,7,36,260,19,68,347,16.5238
SAN DIEGO,May 2016,CACF,2016,CHURCH OF COMPASSION DAYSPRING CHRISTIAN LRNING CTR,CHILD_BREAKFAST,21,28,1,25,54,411,15,366,792,37.7143
SAN DIEGO,May 2016,CACF,2016,CHURCH OF COMPASSION DAYSPRING CHRISTIAN LRNING CTR,CHILD_LUNCH,21,28,1,25,54,538,19,480,1037,49.381
SAN DIEGO,May 2016,CACF,2016,CHURCH OF COMPASSION DAYSPRING CHRISTIAN LRNING CTR,CHILD_SNACK_PM,21,28,1,25,54,487,17,435,939,44.7143
SAN DIEGO,May 2016,CACF,2016,CHURCH OF COMPASSION DAYSPRING CHRISTIAN LRNING CTR,OSCH_CHILD_BREAKFAST,21,27,2,7,36,110,8,28,146,6.9524
SAN DIEGO,May 2016,CACF,2016,CHURCH OF COMPASSION DAYSPRING CHRISTIAN LRNING CTR,OSCH_CHILD_LUNCH,21,27,2,7,36,101,7,26,134,6.381
SAN DIEGO,May 2016,CACF,2016,CHURCH OF COMPASSION DAYSPRING CHRISTIAN LRNING CTR,OSCH_CHILD_SNACK_PM,21,27,2,7,36,235,17,61,313,14.9048
SAN DIEGO,Jun 2016,CACF,2016,CHURCH OF COMPASSION DAYSPRING CHRISTIAN LRNING CTR,CHILD_BREAKFAST,22,28,1,25,54,427,15,381,823,37.4091
SAN DIEGO,Jun 2016,CACF,2016,CHURCH OF COMPASSION DAYSPRING CHRISTIAN LRNING CTR,CHILD_LUNCH,22,28,1,25,54,530,19,474,1023,46.5
SAN DIEGO,Jun 2016,CACF,2016,CHURCH OF COMPASSION DAYSPRING CHRISTIAN LRNING CTR,CHILD_SNACK_PM,22,28,1,25,54,475,17,425,917,41.6818
SAN DIEGO,Jun 2016,CACF,2016,CHURCH OF COMPASSION DAYSPRING CHRISTIAN LRNING CTR,OSCH_CHILD_BREAKFAST,22,27,2,7,36,174,13,45,232,10.5455
SAN DIEGO,Jun 2016,CACF,2016,CHURCH OF COMPASSION DAYSPRING CHRISTIAN LRNING CTR,OSCH_CHILD_LUNCH,22,27,2,7,36,195,14,51,260,11.8182
SAN DIEGO,Jun 2016,CACF,2016,CHURCH OF COMPASSION DAYSPRING CHRISTIAN LRNING CTR,OSCH_CHILD_SNACK_PM,22,27,2,7,36,277,21,71,369,16.7727
SAN DIEGO,Jul 2016,CACF,2016,CHURCH OF COMPASSION DAYSPRING CHRISTIAN LRNING CTR,CHILD_BREAKFAST,20,28,1,25,54,357,13,318,688,34.4
SAN DIEGO,Jul 2016,CACF,2016,CHURCH OF COMPASSION DAYSPRING CHRISTIAN LRNING CTR,CHILD_LUNCH,20,28,1,25,54,487,17,436,940,47
SAN DIEGO,Jul 2016,CACF,2016,CHURCH OF COMPASSION DAYSPRING CHRISTIAN LRNING CTR,CHILD_SNACK_PM,20,28,1,25,54,452,16,403,871,43.55
SAN DIEGO,Jul 2016,CACF,2016,CHURCH OF COMPASSION DAYSPRING CHRISTIAN LRNING CTR,OSCH_CHILD_BREAKFAST,20,27,2,7,36,227,17,59,303,15.15
SAN DIEGO,Jul 2016,CACF,2016,CHURCH OF COMPASSION DAYSPRING CHRISTIAN LRNING CTR,OSCH_CHILD_LUNCH,20,27,2,7,36,314,23,81,418,20.9
SAN DIEGO,Jul 2016,CACF,2016,CHURCH OF COMPASSION DAYSPRING CHRISTIAN LRNING CTR,OSCH_CHILD_SNACK_PM,20,27,2,7,36,296,22,76,394,19.7
SAN DIEGO,Oct 2015,CACF,2016,CLAIREMONT VILLA ADHC INC ,ADULT_BREAKFAST,22,102,0,0,102,1327,0,0,1327,60.3182
SAN DIEGO,Oct 2015,CACF,2016,CLAIREMONT VILLA ADHC INC ,ADULT_LUNCH,22,102,0,0,102,1325,0,0,1325,60.2273
SAN DIEGO,Nov 2015,CACF,2016,CLAIREMONT VILLA ADHC INC ,ADULT_BREAKFAST,20,109,0,0,109,1199,0,0,1199,59.95
SAN DIEGO,Nov 2015,CACF,2016,CLAIREMONT VILLA ADHC INC ,ADULT_LUNCH,20,109,0,0,109,1199,0,0,1199,59.95
SAN DIEGO,Dec 2015,CACF,2016,CLAIREMONT VILLA ADHC INC ,ADULT_BREAKFAST,22,109,0,0,109,1333,0,0,1333,60.5909
SAN DIEGO,Dec 2015,CACF,2016,CLAIREMONT VILLA ADHC INC ,ADULT_LUNCH,22,109,0,0,109,1331,0,0,1331,60.5
SAN DIEGO,Jan 2016,CACF,2016,CLAIREMONT VILLA ADHC INC ,ADULT_BREAKFAST,20,109,0,0,109,1212,0,0,1212,60.6
SAN DIEGO,Jan 2016,CACF,2016,CLAIREMONT VILLA ADHC INC ,ADULT_LUNCH,20,109,0,0,109,1211,0,0,1211,60.55
SAN DIEGO,Feb 2016,CACF,2016,CLAIREMONT VILLA ADHC INC ,ADULT_BREAKFAST,21,109,0,0,109,1213,0,0,1213,57.7619
SAN DIEGO,Feb 2016,CACF,2016,CLAIREMONT VILLA ADHC INC ,ADULT_LUNCH,21,109,0,0,109,1211,0,0,1211,57.6667
SAN DIEGO,Mar 2016,CACF,2016,CLAIREMONT VILLA ADHC INC ,ADULT_BREAKFAST,23,107,0,2,109,1376,0,26,1402,60.9565
SAN DIEGO,Mar 2016,CACF,2016,CLAIREMONT VILLA ADHC INC ,ADULT_LUNCH,23,107,0,2,109,1376,0,26,1402,60.9565
SAN DIEGO,Apr 2016,CACF,2016,CLAIREMONT VILLA ADHC INC ,ADULT_BREAKFAST,21,107,0,2,109,1307,0,24,1331,63.381
SAN DIEGO,Apr 2016,CACF,2016,CLAIREMONT VILLA ADHC INC ,ADULT_LUNCH,21,107,0,2,109,1307,0,24,1331,63.381
SAN DIEGO,May 2016,CACF,2016,CLAIREMONT VILLA ADHC INC ,ADULT_BREAKFAST,22,107,0,2,109,1323,0,25,1348,61.2727
SAN DIEGO,May 2016,CACF,2016,CLAIREMONT VILLA ADHC INC ,ADULT_LUNCH,22,107,0,2,109,1323,0,25,1348,61.2727
SAN DIEGO,Jun 2016,CACF,2016,CLAIREMONT VILLA ADHC INC ,ADULT_BREAKFAST,22,107,0,2,109,1316,0,25,1341,60.9545
SAN DIEGO,Jun 2016,CACF,2016,CLAIREMONT VILLA ADHC INC ,ADULT_LUNCH,22,107,0,2,109,1316,0,25,1341,60.9545
SAN DIEGO,Jul 2016,CACF,2016,CLAIREMONT VILLA ADHC INC ,ADULT_BREAKFAST,20,107,0,2,109,1201,0,22,1223,61.15
SAN DIEGO,Jul 2016,CACF,2016,CLAIREMONT VILLA ADHC INC ,ADULT_LUNCH,20,107,0,2,109,1200,0,22,1222,61.1
SAN DIEGO,Nov 2015,CACF,2016,COLES COTTAGE CHILD CENTER INC,CHILD_BREAKFAST,18,9,2,24,35,139,31,370,540,30
SAN DIEGO,Nov 2015,CACF,2016,COLES COTTAGE CHILD CENTER INC,CHILD_LUNCH,18,9,2,24,35,162,36,432,630,35
SAN DIEGO,Nov 2015,CACF,2016,COLES COTTAGE CHILD CENTER INC,CHILD_SNACK_PM,18,9,2,24,35,153,34,407,594,33
SAN DIEGO,Dec 2015,CACF,2016,COLES COTTAGE CHILD CENTER INC,CHILD_BREAKFAST,20,8,2,25,35,131,33,409,573,28.65
SAN DIEGO,Dec 2015,CACF,2016,COLES COTTAGE CHILD CENTER INC,CHILD_LUNCH,20,8,2,25,35,152,38,475,665,33.25
SAN DIEGO,Dec 2015,CACF,2016,COLES COTTAGE CHILD CENTER INC,CHILD_SNACK_PM,20,8,2,25,35,142,35,443,620,31
SAN DIEGO,Feb 2016,CACF,2016,COLES COTTAGE CHILD CENTER INC,CHILD_BREAKFAST,20,8,2,25,35,132,33,413,578,28.9
SAN DIEGO,Feb 2016,CACF,2016,COLES COTTAGE CHILD CENTER INC,CHILD_LUNCH,20,8,2,25,35,153,38,479,670,33.5
SAN DIEGO,Feb 2016,CACF,2016,COLES COTTAGE CHILD CENTER INC,CHILD_SNACK_PM,20,8,2,25,35,143,36,446,625,31.25
SAN DIEGO,Mar 2016,CACF,2016,COLES COTTAGE CHILD CENTER INC,CHILD_BREAKFAST,23,8,2,25,35,140,35,438,613,26.6522
SAN DIEGO,Mar 2016,CACF,2016,COLES COTTAGE CHILD CENTER INC,CHILD_LUNCH,23,8,2,25,35,161,40,504,705,30.6522
SAN DIEGO,Mar 2016,CACF,2016,COLES COTTAGE CHILD CENTER INC,CHILD_SNACK_PM,23,8,2,25,35,151,38,471,660,28.6957
SAN DIEGO,Apr 2016,CACF,2016,COLES COTTAGE CHILD CENTER INC,CHILD_BREAKFAST,20,7,2,26,35,122,35,453,610,30.5
SAN DIEGO,Apr 2016,CACF,2016,COLES COTTAGE CHILD CENTER INC,CHILD_LUNCH,20,7,2,26,35,140,40,518,698,34.9
SAN DIEGO,Apr 2016,CACF,2016,COLES COTTAGE CHILD CENTER INC,CHILD_SNACK_PM,20,7,2,26,35,131,38,488,657,32.85
SAN DIEGO,Jun 2016,CACF,2016,COLES COTTAGE CHILD CENTER INC,CHILD_BREAKFAST,22,8,2,29,39,157,39,569,765,34.7727
SAN DIEGO,Jun 2016,CACF,2016,COLES COTTAGE CHILD CENTER INC,CHILD_LUNCH,22,8,2,29,39,175,44,635,854,38.8182
SAN DIEGO,Jun 2016,CACF,2016,COLES COTTAGE CHILD CENTER INC,CHILD_SNACK_PM,22,8,2,29,39,167,42,605,814,37
SAN DIEGO,Jul 2016,CACF,2016,COLES COTTAGE CHILD CENTER INC,CHILD_BREAKFAST,20,8,2,29,39,143,36,518,697,34.85
SAN DIEGO,Jul 2016,CACF,2016,COLES COTTAGE CHILD CENTER INC,CHILD_LUNCH,20,8,2,29,39,156,39,568,763,38.15
SAN DIEGO,Jul 2016,CACF,2016,COLES COTTAGE CHILD CENTER INC,CHILD_SNACK_PM,20,8,2,29,39,148,37,538,723,36.15
SAN DIEGO,Oct 2015,CACF,2016,DINO DAY CARE INC,CHILD_BREAKFAST,22,32,2,11,45,243,15,84,342,15.5455
SAN DIEGO,Oct 2015,CACF,2016,DINO DAY CARE INC,CHILD_LUNCH,22,32,2,11,45,447,28,153,628,28.5455
SAN DIEGO,Oct 2015,CACF,2016,DINO DAY CARE INC,CHILD_SNACK_PM,22,32,2,11,45,345,22,118,485,22.0455
SAN DIEGO,Nov 2015,CACF,2016,DINO DAY CARE INC,CHILD_BREAKFAST,19,32,2,11,45,220,14,76,310,16.3158
SAN DIEGO,Nov 2015,CACF,2016,DINO DAY CARE INC,CHILD_LUNCH,19,32,2,11,45,404,25,139,568,29.8947
SAN DIEGO,Nov 2015,CACF,2016,DINO DAY CARE INC,CHILD_SNACK_PM,19,32,2,11,45,348,22,120,490,25.7895
SAN DIEGO,Dec 2015,CACF,2016,DINO DAY CARE INC,CHILD_BREAKFAST,20,33,1,12,46,227,7,83,317,15.85
SAN DIEGO,Dec 2015,CACF,2016,DINO DAY CARE INC,CHILD_LUNCH,20,33,1,12,46,402,12,146,560,28
SAN DIEGO,Dec 2015,CACF,2016,DINO DAY CARE INC,CHILD_SNACK_PM,20,33,1,12,46,334,10,122,466,23.3
SAN DIEGO,Jan 2016,CACF,2016,DINO DAY CARE INC,CHILD_BREAKFAST,20,27,1,8,36,251,9,74,334,16.7
SAN DIEGO,Jan 2016,CACF,2016,DINO DAY CARE INC,CHILD_LUNCH,20,27,1,8,36,398,15,117,530,26.5
SAN DIEGO,Jan 2016,CACF,2016,DINO DAY CARE INC,CHILD_SNACK_PM,20,27,1,8,36,332,12,98,442,22.1
SAN DIEGO,Feb 2016,CACF,2016,DINO DAY CARE INC,CHILD_BREAKFAST,20,27,1,8,36,228,8,68,304,15.2
SAN DIEGO,Feb 2016,CACF,2016,DINO DAY CARE INC,CHILD_LUNCH,20,27,1,8,36,382,14,113,509,25.45
SAN DIEGO,Feb 2016,CACF,2016,DINO DAY CARE INC,CHILD_SNACK_PM,20,27,1,8,36,328,12,97,437,21.85
SAN DIEGO,Mar 2016,CACF,2016,DINO DAY CARE INC,CHILD_BREAKFAST,23,27,1,8,36,278,10,83,371,16.1304
SAN DIEGO,Mar 2016,CACF,2016,DINO DAY CARE INC,CHILD_LUNCH,23,27,1,8,36,452,17,134,603,26.2174
SAN DIEGO,Mar 2016,CACF,2016,DINO DAY CARE INC,CHILD_SNACK_PM,23,27,1,8,36,411,15,122,548,23.8261
SAN DIEGO,Apr 2016,CACF,2016,DINO DAY CARE INC,CHILD_BREAKFAST,21,31,1,7,39,281,9,64,354,16.8571
SAN DIEGO,Apr 2016,CACF,2016,DINO DAY CARE INC,CHILD_LUNCH,21,31,1,7,39,491,16,111,618,29.4286
SAN DIEGO,Apr 2016,CACF,2016,DINO DAY CARE INC,CHILD_SNACK_PM,21,31,1,7,39,399,13,90,502,23.9048
SAN DIEGO,May 2016,CACF,2016,DINO DAY CARE INC,CHILD_BREAKFAST,21,32,2,6,40,346,22,64,432,20.5714
SAN DIEGO,May 2016,CACF,2016,DINO DAY CARE INC,CHILD_LUNCH,21,32,2,6,40,529,33,99,661,31.4762
SAN DIEGO,May 2016,CACF,2016,DINO DAY CARE INC,CHILD_SNACK_PM,21,32,2,6,40,429,27,80,536,25.5238
SAN DIEGO,Jun 2016,CACF,2016,DINO DAY CARE INC,CHILD_BREAKFAST,22,33,2,7,42,293,18,62,373,16.9545
SAN DIEGO,Jun 2016,CACF,2016,DINO DAY CARE INC,CHILD_LUNCH,22,33,2,7,42,484,29,103,616,28
SAN DIEGO,Jun 2016,CACF,2016,DINO DAY CARE INC,CHILD_SNACK_PM,22,33,2,7,42,383,23,82,488,22.1818
SAN DIEGO,Jul 2016,CACF,2016,DINO DAY CARE INC,CHILD_BREAKFAST,20,31,1,5,37,236,8,38,282,14.1
SAN DIEGO,Jul 2016,CACF,2016,DINO DAY CARE INC,CHILD_LUNCH,20,31,1,5,37,419,14,67,500,25
SAN DIEGO,Jul 2016,CACF,2016,DINO DAY CARE INC,CHILD_SNACK_PM,20,31,1,5,37,344,11,56,411,20.55
SAN DIEGO,Oct 2015,CACF,2016,EAST SAN DIEGO ASSEMBLY OF GOD,ATRISK_CHILD_LUNCH,25,116,0,0,116,1774,0,0,1774,70.96
SAN DIEGO,Nov 2015,CACF,2016,EAST SAN DIEGO ASSEMBLY OF GOD,ATRISK_CHILD_LUNCH,22,108,0,0,108,1407,0,0,1407,63.9545
SAN DIEGO,Dec 2015,CACF,2016,EAST SAN DIEGO ASSEMBLY OF GOD,ATRISK_CHILD_LUNCH,21,80,0,0,80,1340,0,0,1340,63.8095
SAN DIEGO,Jan 2016,CACF,2016,EAST SAN DIEGO ASSEMBLY OF GOD,ATRISK_CHILD_LUNCH,19,100,0,0,100,907,0,0,907,47.7368
SAN DIEGO,Feb 2016,CACF,2016,EAST SAN DIEGO ASSEMBLY OF GOD,ATRISK_CHILD_LUNCH,25,103,0,0,103,1821,0,0,1821,72.84
SAN DIEGO,Mar 2016,CACF,2016,EAST SAN DIEGO ASSEMBLY OF GOD,ATRISK_CHILD_LUNCH,24,102,0,0,102,1879,0,0,1879,78.2917
SAN DIEGO,Apr 2016,CACF,2016,EAST SAN DIEGO ASSEMBLY OF GOD,ATRISK_CHILD_LUNCH,20,72,0,0,72,1054,0,0,1054,52.7
SAN DIEGO,May 2016,CACF,2016,EAST SAN DIEGO ASSEMBLY OF GOD,ATRISK_CHILD_LUNCH,26,102,0,0,102,2054,0,0,2054,79
SAN DIEGO,Jun 2016,CACF,2016,EAST SAN DIEGO ASSEMBLY OF GOD,ATRISK_CHILD_LUNCH,25,102,0,0,102,2132,0,0,2132,85.28
SAN DIEGO,Jul 2016,CACF,2016,EAST SAN DIEGO ASSEMBLY OF GOD,ATRISK_CHILD_LUNCH,24,92,0,0,92,1615,0,0,1615,67.2917
SAN DIEGO,Oct 2015,CACF,2016,EDUCATIONAL ENRICHMENT SYSTEMS INC ,CHILD_BREAKFAST,21,681,199,83,963,7781,2273,949,11003,523.9524
SAN DIEGO,Oct 2015,CACF,2016,EDUCATIONAL ENRICHMENT SYSTEMS INC ,CHILD_LUNCH,21,681,199,83,963,7650,2235,933,10818,515.1429
SAN DIEGO,Oct 2015,CACF,2016,EDUCATIONAL ENRICHMENT SYSTEMS INC ,CHILD_SNACK_AM,21,681,199,83,963,4810,1405,586,6801,323.8571
SAN DIEGO,Oct 2015,CACF,2016,EDUCATIONAL ENRICHMENT SYSTEMS INC ,CHILD_SNACK_PM,21,681,199,83,963,6607,1930,805,9342,444.8571
SAN DIEGO,Nov 2015,CACF,2016,EDUCATIONAL ENRICHMENT SYSTEMS INC ,CHILD_BREAKFAST,19,681,199,83,963,6223,1818,759,8800,463.1579
SAN DIEGO,Nov 2015,CACF,2016,EDUCATIONAL ENRICHMENT SYSTEMS INC ,CHILD_LUNCH,19,681,199,83,963,5902,1724,719,8345,439.2105
SAN DIEGO,Nov 2015,CACF,2016,EDUCATIONAL ENRICHMENT SYSTEMS INC ,CHILD_SNACK_AM,19,681,199,83,963,3346,978,408,4732,249.0526
SAN DIEGO,Nov 2015,CACF,2016,EDUCATIONAL ENRICHMENT SYSTEMS INC ,CHILD_SNACK_PM,19,681,199,83,963,5248,1533,640,7421,390.5789
SAN DIEGO,Dec 2015,CACF,2016,EDUCATIONAL ENRICHMENT SYSTEMS INC ,CHILD_BREAKFAST,22,681,199,83,963,6039,1764,737,8540,388.1818
SAN DIEGO,Dec 2015,CACF,2016,EDUCATIONAL ENRICHMENT SYSTEMS INC ,CHILD_LUNCH,22,681,199,83,963,5920,1729,722,8371,380.5
SAN DIEGO,Dec 2015,CACF,2016,EDUCATIONAL ENRICHMENT SYSTEMS INC ,CHILD_SNACK_AM,22,681,199,83,963,3074,898,375,4347,197.5909
SAN DIEGO,Dec 2015,CACF,2016,EDUCATIONAL ENRICHMENT SYSTEMS INC ,CHILD_SNACK_PM,22,681,199,83,963,5171,1511,630,7312,332.3636
SAN DIEGO,Jan 2016,CACF,2016,EDUCATIONAL ENRICHMENT SYSTEMS INC ,CHILD_BREAKFAST,19,681,199,83,963,6332,1850,771,8953,471.2105
SAN DIEGO,Jan 2016,CACF,2016,EDUCATIONAL ENRICHMENT SYSTEMS INC ,CHILD_LUNCH,19,681,199,83,963,6192,1809,755,8756,460.8421
SAN DIEGO,Jan 2016,CACF,2016,EDUCATIONAL ENRICHMENT SYSTEMS INC ,CHILD_SNACK_AM,19,681,199,83,963,3421,999,417,4837,254.5789
SAN DIEGO,Jan 2016,CACF,2016,EDUCATIONAL ENRICHMENT SYSTEMS INC ,CHILD_SNACK_PM,19,681,199,83,963,5639,1647,688,7974,419.6842
SAN DIEGO,Feb 2016,CACF,2016,EDUCATIONAL ENRICHMENT SYSTEMS INC ,CHILD_BREAKFAST,20,681,199,83,963,7454,2178,908,10540,527
SAN DIEGO,Feb 2016,CACF,2016,EDUCATIONAL ENRICHMENT SYSTEMS INC ,CHILD_LUNCH,20,681,199,83,963,7416,2167,904,10487,524.35
SAN DIEGO,Feb 2016,CACF,2016,EDUCATIONAL ENRICHMENT SYSTEMS INC ,CHILD_SNACK_AM,20,681,199,83,963,4105,1199,500,5804,290.2
SAN DIEGO,Feb 2016,CACF,2016,EDUCATIONAL ENRICHMENT SYSTEMS INC ,CHILD_SNACK_PM,20,681,199,83,963,6899,2015,841,9755,487.75
SAN DIEGO,Mar 2016,CACF,2016,EDUCATIONAL ENRICHMENT SYSTEMS INC ,CHILD_BREAKFAST,23,681,199,83,963,7994,2335,975,11304,491.4783
SAN DIEGO,Mar 2016,CACF,2016,EDUCATIONAL ENRICHMENT SYSTEMS INC ,CHILD_LUNCH,23,681,199,83,963,7982,2332,973,11287,490.7391
SAN DIEGO,Mar 2016,CACF,2016,EDUCATIONAL ENRICHMENT SYSTEMS INC ,CHILD_SNACK_AM,23,681,199,83,963,3910,1142,477,5529,240.3913
SAN DIEGO,Mar 2016,CACF,2016,EDUCATIONAL ENRICHMENT SYSTEMS INC ,CHILD_SNACK_PM,23,681,199,83,963,6888,2012,840,9740,423.4783
SAN DIEGO,Apr 2016,CACF,2016,EDUCATIONAL ENRICHMENT SYSTEMS INC ,CHILD_BREAKFAST,21,681,199,83,963,8190,2393,998,11581,551.4762
SAN DIEGO,Apr 2016,CACF,2016,EDUCATIONAL ENRICHMENT SYSTEMS INC ,CHILD_LUNCH,21,681,199,83,963,8010,2340,976,11326,539.3333
SAN DIEGO,Apr 2016,CACF,2016,EDUCATIONAL ENRICHMENT SYSTEMS INC ,CHILD_SNACK_AM,21,681,199,83,963,4442,1298,541,6281,299.0952
SAN DIEGO,Apr 2016,CACF,2016,EDUCATIONAL ENRICHMENT SYSTEMS INC ,CHILD_SNACK_PM,21,681,199,83,963,7290,2130,888,10308,490.8571
SAN DIEGO,May 2016,CACF,2016,EDUCATIONAL ENRICHMENT SYSTEMS INC ,CHILD_BREAKFAST,21,681,199,83,963,8119,2372,989,11480,546.6667
SAN DIEGO,May 2016,CACF,2016,EDUCATIONAL ENRICHMENT SYSTEMS INC ,CHILD_LUNCH,21,681,199,83,963,8113,2370,989,11472,546.2857
SAN DIEGO,May 2016,CACF,2016,EDUCATIONAL ENRICHMENT SYSTEMS INC ,CHILD_SNACK_AM,21,681,199,83,963,4541,1327,553,6421,305.7619
SAN DIEGO,May 2016,CACF,2016,EDUCATIONAL ENRICHMENT SYSTEMS INC ,CHILD_SNACK_PM,21,681,199,83,963,7075,2067,862,10004,476.381
SAN DIEGO,Jun 2016,CACF,2016,EDUCATIONAL ENRICHMENT SYSTEMS INC ,CHILD_BREAKFAST,22,681,199,83,963,4472,1306,545,6323,287.4091
SAN DIEGO,Jun 2016,CACF,2016,EDUCATIONAL ENRICHMENT SYSTEMS INC ,CHILD_LUNCH,22,681,199,83,963,4717,1378,575,6670,303.1818
SAN DIEGO,Jun 2016,CACF,2016,EDUCATIONAL ENRICHMENT SYSTEMS INC ,CHILD_SNACK_AM,22,681,199,83,963,1733,506,211,2450,111.3636
SAN DIEGO,Jun 2016,CACF,2016,EDUCATIONAL ENRICHMENT SYSTEMS INC ,CHILD_SNACK_PM,22,681,199,83,963,4177,1220,509,5906,268.4545
SAN DIEGO,Jul 2016,CACF,2016,EDUCATIONAL ENRICHMENT SYSTEMS INC ,CHILD_BREAKFAST,20,681,199,83,963,3190,932,389,4511,225.55
SAN DIEGO,Jul 2016,CACF,2016,EDUCATIONAL ENRICHMENT SYSTEMS INC ,CHILD_LUNCH,20,681,199,83,963,3718,1086,453,5257,262.85
SAN DIEGO,Jul 2016,CACF,2016,EDUCATIONAL ENRICHMENT SYSTEMS INC ,CHILD_SNACK_AM,20,681,199,83,963,440,129,53,622,31.1
SAN DIEGO,Jul 2016,CACF,2016,EDUCATIONAL ENRICHMENT SYSTEMS INC ,CHILD_SNACK_PM,20,681,199,83,963,2915,852,355,4122,206.1
SAN DIEGO,Oct 2015,CACF,2016,EJE Academies,ATRISK_CHILD_SUPPER,14,708,0,0,708,1969,0,0,1969,140.6429
SAN DIEGO,Nov 2015,CACF,2016,EJE Academies,ATRISK_CHILD_SUPPER,15,709,0,0,709,2069,0,0,2069,137.9333
SAN DIEGO,Dec 2015,CACF,2016,EJE Academies,ATRISK_CHILD_SUPPER,14,708,0,0,708,1895,0,0,1895,135.3571
SAN DIEGO,Jan 2016,CACF,2016,EJE Academies,ATRISK_CHILD_SUPPER,13,707,0,0,707,1909,0,0,1909,146.8462
SAN DIEGO,Feb 2016,CACF,2016,EJE Academies,ATRISK_CHILD_SUPPER,19,704,0,0,704,2667,0,0,2667,140.3684
SAN DIEGO,Mar 2016,CACF,2016,EJE Academies,ATRISK_CHILD_SUPPER,13,703,0,0,703,1766,0,0,1766,135.8462
SAN DIEGO,Apr 2016,CACF,2016,EJE Academies,ATRISK_CHILD_SUPPER,20,703,0,0,703,2609,0,0,2609,130.45
SAN DIEGO,May 2016,CACF,2016,EJE Academies,ATRISK_CHILD_SUPPER,21,702,0,0,702,2683,0,0,2683,127.7619
SAN DIEGO,Jun 2016,CACF,2016,EJE Academies,ATRISK_CHILD_SUPPER,13,701,0,0,701,1416,0,0,1416,108.9231
SAN DIEGO,Oct 2015,CACF,2016,EL CAJON WESLEYAN CHURCH ,CHILD_BREAKFAST,22,5,2,57,64,79,32,904,1015,46.1364
SAN DIEGO,Oct 2015,CACF,2016,EL CAJON WESLEYAN CHURCH ,CHILD_LUNCH,22,5,2,57,64,82,33,930,1045,47.5
SAN DIEGO,Oct 2015,CACF,2016,EL CAJON WESLEYAN CHURCH ,CHILD_SNACK_PM,22,5,2,57,64,73,29,832,934,42.4545
SAN DIEGO,Nov 2015,CACF,2016,EL CAJON WESLEYAN CHURCH ,CHILD_BREAKFAST,18,5,2,57,64,61,25,697,783,43.5
SAN DIEGO,Nov 2015,CACF,2016,EL CAJON WESLEYAN CHURCH ,CHILD_LUNCH,18,5,2,57,64,65,26,743,834,46.3333
SAN DIEGO,Nov 2015,CACF,2016,EL CAJON WESLEYAN CHURCH ,CHILD_SNACK_PM,18,5,2,57,64,56,23,641,720,40
SAN DIEGO,Dec 2015,CACF,2016,EL CAJON WESLEYAN CHURCH ,CHILD_BREAKFAST,20,5,2,57,64,63,25,724,812,40.6
SAN DIEGO,Dec 2015,CACF,2016,EL CAJON WESLEYAN CHURCH ,CHILD_LUNCH,20,5,2,57,64,69,28,790,887,44.35
SAN DIEGO,Dec 2015,CACF,2016,EL CAJON WESLEYAN CHURCH ,CHILD_SNACK_PM,20,5,2,57,64,58,23,658,739,36.95
SAN DIEGO,Jan 2016,CACF,2016,EL CAJON WESLEYAN CHURCH ,CHILD_BREAKFAST,19,5,2,57,64,60,24,688,772,40.6316
SAN DIEGO,Jan 2016,CACF,2016,EL CAJON WESLEYAN CHURCH ,CHILD_LUNCH,19,5,2,57,64,65,26,746,837,44.0526
SAN DIEGO,Jan 2016,CACF,2016,EL CAJON WESLEYAN CHURCH ,CHILD_SNACK_PM,19,5,2,57,64,54,22,621,697,36.6842
SAN DIEGO,Feb 2016,CACF,2016,EL CAJON WESLEYAN CHURCH ,CHILD_BREAKFAST,20,5,2,57,64,70,28,802,900,45
SAN DIEGO,Feb 2016,CACF,2016,EL CAJON WESLEYAN CHURCH ,CHILD_LUNCH,20,5,2,57,64,74,30,846,950,47.5
SAN DIEGO,Feb 2016,CACF,2016,EL CAJON WESLEYAN CHURCH ,CHILD_SNACK_PM,20,5,2,57,64,62,25,701,788,39.4
SAN DIEGO,Mar 2016,CACF,2016,EL CAJON WESLEYAN CHURCH ,CHILD_BREAKFAST,23,5,2,57,64,72,29,822,923,40.1304
SAN DIEGO,Mar 2016,CACF,2016,EL CAJON WESLEYAN CHURCH ,CHILD_LUNCH,23,5,2,57,64,74,30,848,952,41.3913
SAN DIEGO,Mar 2016,CACF,2016,EL CAJON WESLEYAN CHURCH ,CHILD_SNACK_PM,23,5,2,57,64,63,25,725,813,35.3478
SAN DIEGO,Apr 2016,CACF,2016,EL CAJON WESLEYAN CHURCH ,CHILD_BREAKFAST,20,5,2,57,64,70,28,800,898,44.9
SAN DIEGO,Apr 2016,CACF,2016,EL CAJON WESLEYAN CHURCH ,CHILD_LUNCH,20,5,2,57,64,74,30,844,948,47.4
SAN DIEGO,Apr 2016,CACF,2016,EL CAJON WESLEYAN CHURCH ,CHILD_SNACK_PM,20,5,2,57,64,63,25,723,811,40.55
SAN DIEGO,May 2016,CACF,2016,EL CAJON WESLEYAN CHURCH ,CHILD_BREAKFAST,21,5,2,57,64,73,29,832,934,44.4762
SAN DIEGO,May 2016,CACF,2016,EL CAJON WESLEYAN CHURCH ,CHILD_LUNCH,21,5,2,57,64,79,32,897,1008,48
SAN DIEGO,May 2016,CACF,2016,EL CAJON WESLEYAN CHURCH ,CHILD_SNACK_PM,21,5,2,57,64,70,28,792,890,42.381
SAN DIEGO,Jun 2016,CACF,2016,EL CAJON WESLEYAN CHURCH ,CHILD_BREAKFAST,22,5,2,57,64,73,29,830,932,42.3636
SAN DIEGO,Jun 2016,CACF,2016,EL CAJON WESLEYAN CHURCH ,CHILD_LUNCH,22,5,2,57,64,78,31,896,1005,45.6818
SAN DIEGO,Jun 2016,CACF,2016,EL CAJON WESLEYAN CHURCH ,CHILD_SNACK_PM,22,5,2,57,64,71,29,815,915,41.5909
SAN DIEGO,Jul 2016,CACF,2016,EL CAJON WESLEYAN CHURCH ,CHILD_BREAKFAST,20,5,2,57,64,56,23,640,719,35.95
SAN DIEGO,Jul 2016,CACF,2016,EL CAJON WESLEYAN CHURCH ,CHILD_LUNCH,20,5,2,57,64,62,25,711,798,39.9
SAN DIEGO,Jul 2016,CACF,2016,EL CAJON WESLEYAN CHURCH ,CHILD_SNACK_PM,20,5,2,57,64,55,22,627,704,35.2
SAN DIEGO,Oct 2015,CACF,2016,EPISCOPAL COMMUNITY SERVICES ,CHILD_BREAKFAST,20,100,0,0,100,917,0,0,917,45.85
SAN DIEGO,Oct 2015,CACF,2016,EPISCOPAL COMMUNITY SERVICES ,CHILD_LUNCH,20,100,0,0,100,1129,0,0,1129,56.45
SAN DIEGO,Oct 2015,CACF,2016,EPISCOPAL COMMUNITY SERVICES ,CHILD_SNACK_PM,20,100,0,0,100,612,0,0,612,30.6
SAN DIEGO,Oct 2015,CACF,2016,EPISCOPAL COMMUNITY SERVICES ,HS_CHILD_BREAKFAST,20,1033,0,0,1033,8648,0,0,8648,432.4
SAN DIEGO,Oct 2015,CACF,2016,EPISCOPAL COMMUNITY SERVICES ,HS_CHILD_LUNCH,20,1033,0,0,1033,13212,0,0,13212,660.6
SAN DIEGO,Oct 2015,CACF,2016,EPISCOPAL COMMUNITY SERVICES ,HS_CHILD_SNACK_PM,20,1033,0,0,1033,7317,0,0,7317,365.85
SAN DIEGO,Nov 2015,CACF,2016,EPISCOPAL COMMUNITY SERVICES ,CHILD_BREAKFAST,14,100,0,0,100,589,0,0,589,42.0714
SAN DIEGO,Nov 2015,CACF,2016,EPISCOPAL COMMUNITY SERVICES ,CHILD_LUNCH,14,100,0,0,100,809,0,0,809,57.7857
SAN DIEGO,Nov 2015,CACF,2016,EPISCOPAL COMMUNITY SERVICES ,CHILD_SNACK_PM,14,100,0,0,100,511,0,0,511,36.5
SAN DIEGO,Nov 2015,CACF,2016,EPISCOPAL COMMUNITY SERVICES ,HS_CHILD_BREAKFAST,14,1033,0,0,1033,6436,0,0,6436,459.7143
SAN DIEGO,Nov 2015,CACF,2016,EPISCOPAL COMMUNITY SERVICES ,HS_CHILD_LUNCH,14,1033,0,0,1033,9879,0,0,9879,705.6429
SAN DIEGO,Nov 2015,CACF,2016,EPISCOPAL COMMUNITY SERVICES ,HS_CHILD_SNACK_PM,14,1033,0,0,1033,6007,0,0,6007,429.0714
SAN DIEGO,Dec 2015,CACF,2016,EPISCOPAL COMMUNITY SERVICES ,CHILD_BREAKFAST,14,100,0,0,100,660,0,0,660,47.1429
SAN DIEGO,Dec 2015,CACF,2016,EPISCOPAL COMMUNITY SERVICES ,CHILD_LUNCH,14,100,0,0,100,714,0,0,714,51
SAN DIEGO,Dec 2015,CACF,2016,EPISCOPAL COMMUNITY SERVICES ,CHILD_SNACK_PM,14,100,0,0,100,322,0,0,322,23
SAN DIEGO,Dec 2015,CACF,2016,EPISCOPAL COMMUNITY SERVICES ,HS_CHILD_BREAKFAST,14,1033,0,0,1033,5968,0,0,5968,426.2857
SAN DIEGO,Dec 2015,CACF,2016,EPISCOPAL COMMUNITY SERVICES ,HS_CHILD_LUNCH,14,1033,0,0,1033,9230,0,0,9230,659.2857
SAN DIEGO,Dec 2015,CACF,2016,EPISCOPAL COMMUNITY SERVICES ,HS_CHILD_SNACK_PM,14,1033,0,0,1033,5661,0,0,5661,404.3571
SAN DIEGO,Jan 2016,CACF,2016,EPISCOPAL COMMUNITY SERVICES ,CHILD_BREAKFAST,19,100,0,0,100,844,0,0,844,44.4211
SAN DIEGO,Jan 2016,CACF,2016,EPISCOPAL COMMUNITY SERVICES ,CHILD_LUNCH,19,100,0,0,100,963,0,0,963,50.6842
SAN DIEGO,Jan 2016,CACF,2016,EPISCOPAL COMMUNITY SERVICES ,CHILD_SNACK_PM,19,100,0,0,100,498,0,0,498,26.2105
SAN DIEGO,Jan 2016,CACF,2016,EPISCOPAL COMMUNITY SERVICES ,HS_CHILD_BREAKFAST,17,1033,0,0,1033,7584,0,0,7584,446.1176
SAN DIEGO,Jan 2016,CACF,2016,EPISCOPAL COMMUNITY SERVICES ,HS_CHILD_LUNCH,17,1033,0,0,1033,11688,0,0,11688,687.5294
SAN DIEGO,Jan 2016,CACF,2016,EPISCOPAL COMMUNITY SERVICES ,HS_CHILD_SNACK_PM,17,1033,0,0,1033,7363,0,0,7363,433.1176
SAN DIEGO,Feb 2016,CACF,2016,EPISCOPAL COMMUNITY SERVICES ,CHILD_BREAKFAST,19,100,0,0,100,917,0,0,917,48.2632
SAN DIEGO,Feb 2016,CACF,2016,EPISCOPAL COMMUNITY SERVICES ,CHILD_LUNCH,19,100,0,0,100,1128,0,0,1128,59.3684
SAN DIEGO,Feb 2016,CACF,2016,EPISCOPAL COMMUNITY SERVICES ,CHILD_SNACK_PM,19,100,0,0,100,647,0,0,647,34.0526
SAN DIEGO,Feb 2016,CACF,2016,EPISCOPAL COMMUNITY SERVICES ,HS_CHILD_BREAKFAST,19,1033,0,0,1033,9265,0,0,9265,487.6316
SAN DIEGO,Feb 2016,CACF,2016,EPISCOPAL COMMUNITY SERVICES ,HS_CHILD_LUNCH,19,1033,0,0,1033,14342,0,0,14342,754.8421
SAN DIEGO,Feb 2016,CACF,2016,EPISCOPAL COMMUNITY SERVICES ,HS_CHILD_SNACK_PM,19,1033,0,0,1033,8775,0,0,8775,461.8421
SAN DIEGO,Mar 2016,CACF,2016,EPISCOPAL COMMUNITY SERVICES ,CHILD_BREAKFAST,21,100,0,0,100,971,0,0,971,46.2381
SAN DIEGO,Mar 2016,CACF,2016,EPISCOPAL COMMUNITY SERVICES ,CHILD_LUNCH,21,100,0,0,100,1030,0,0,1030,49.0476
SAN DIEGO,Mar 2016,CACF,2016,EPISCOPAL COMMUNITY SERVICES ,CHILD_SNACK_PM,21,100,0,0,100,413,0,0,413,19.6667
SAN DIEGO,Mar 2016,CACF,2016,EPISCOPAL COMMUNITY SERVICES ,HS_CHILD_BREAKFAST,21,1033,0,0,1033,8198,0,0,8198,390.381
SAN DIEGO,Mar 2016,CACF,2016,EPISCOPAL COMMUNITY SERVICES ,HS_CHILD_LUNCH,21,1033,0,0,1033,12772,0,0,12772,608.1905
SAN DIEGO,Mar 2016,CACF,2016,EPISCOPAL COMMUNITY SERVICES ,HS_CHILD_SNACK_PM,21,1033,0,0,1033,7787,0,0,7787,370.8095
SAN DIEGO,Apr 2016,CACF,2016,EPISCOPAL COMMUNITY SERVICES ,CHILD_BREAKFAST,19,100,0,0,100,985,0,0,985,51.8421
SAN DIEGO,Apr 2016,CACF,2016,EPISCOPAL COMMUNITY SERVICES ,CHILD_LUNCH,19,100,0,0,100,1218,0,0,1218,64.1053
SAN DIEGO,Apr 2016,CACF,2016,EPISCOPAL COMMUNITY SERVICES ,CHILD_SNACK_PM,19,100,0,0,100,601,0,0,601,31.6316
SAN DIEGO,Apr 2016,CACF,2016,EPISCOPAL COMMUNITY SERVICES ,HS_CHILD_BREAKFAST,19,1033,0,0,1033,9295,0,0,9295,489.2105
SAN DIEGO,Apr 2016,CACF,2016,EPISCOPAL COMMUNITY SERVICES ,HS_CHILD_LUNCH,19,1033,0,0,1033,14444,0,0,14444,760.2105
SAN DIEGO,Apr 2016,CACF,2016,EPISCOPAL COMMUNITY SERVICES ,HS_CHILD_SNACK_PM,19,1033,0,0,1033,9033,0,0,9033,475.4211
SAN DIEGO,May 2016,CACF,2016,EPISCOPAL COMMUNITY SERVICES ,CHILD_BREAKFAST,20,100,0,0,100,932,0,0,932,46.6
SAN DIEGO,May 2016,CACF,2016,EPISCOPAL COMMUNITY SERVICES ,CHILD_LUNCH,20,100,0,0,100,1176,0,0,1176,58.8
SAN DIEGO,May 2016,CACF,2016,EPISCOPAL COMMUNITY SERVICES ,CHILD_SNACK_PM,20,100,0,0,100,526,0,0,526,26.3
SAN DIEGO,May 2016,CACF,2016,EPISCOPAL COMMUNITY SERVICES ,HS_CHILD_BREAKFAST,20,1033,0,0,1033,9212,0,0,9212,460.6
SAN DIEGO,May 2016,CACF,2016,EPISCOPAL COMMUNITY SERVICES ,HS_CHILD_LUNCH,20,1033,0,0,1033,14487,0,0,14487,724.35
SAN DIEGO,May 2016,CACF,2016,EPISCOPAL COMMUNITY SERVICES ,HS_CHILD_SNACK_PM,20,1033,0,0,1033,7960,0,0,7960,398
SAN DIEGO,Jun 2016,CACF,2016,EPISCOPAL COMMUNITY SERVICES ,CHILD_BREAKFAST,18,100,0,0,100,497,0,0,497,27.6111
SAN DIEGO,Jun 2016,CACF,2016,EPISCOPAL COMMUNITY SERVICES ,CHILD_LUNCH,18,100,0,0,100,640,0,0,640,35.5556
SAN DIEGO,Jun 2016,CACF,2016,EPISCOPAL COMMUNITY SERVICES ,CHILD_SNACK_PM,18,100,0,0,100,295,0,0,295,16.3889
SAN DIEGO,Jun 2016,CACF,2016,EPISCOPAL COMMUNITY SERVICES ,HS_CHILD_BREAKFAST,18,1033,0,0,1033,2454,0,0,2454,136.3333
SAN DIEGO,Jun 2016,CACF,2016,EPISCOPAL COMMUNITY SERVICES ,HS_CHILD_LUNCH,18,1033,0,0,1033,3339,0,0,3339,185.5
SAN DIEGO,Jun 2016,CACF,2016,EPISCOPAL COMMUNITY SERVICES ,HS_CHILD_SNACK_PM,18,1033,0,0,1033,2253,0,0,2253,125.1667
SAN DIEGO,Jul 2016,CACF,2016,EPISCOPAL COMMUNITY SERVICES ,CHILD_BREAKFAST,12,100,0,0,100,483,0,0,483,40.25
SAN DIEGO,Jul 2016,CACF,2016,EPISCOPAL COMMUNITY SERVICES ,CHILD_LUNCH,12,100,0,0,100,508,0,0,508,42.3333
SAN DIEGO,Jul 2016,CACF,2016,EPISCOPAL COMMUNITY SERVICES ,CHILD_SNACK_PM,12,100,0,0,100,241,0,0,241,20.0833
SAN DIEGO,Jul 2016,CACF,2016,EPISCOPAL COMMUNITY SERVICES ,HS_CHILD_BREAKFAST,12,1033,0,0,1033,877,0,0,877,73.0833
SAN DIEGO,Jul 2016,CACF,2016,EPISCOPAL COMMUNITY SERVICES ,HS_CHILD_LUNCH,12,1033,0,0,1033,874,0,0,874,72.8333
SAN DIEGO,Jul 2016,CACF,2016,EPISCOPAL COMMUNITY SERVICES ,HS_CHILD_SNACK_PM,12,1033,0,0,1033,622,0,0,622,51.8333
SAN DIEGO,Oct 2015,CACF,2016,ESCONDIDO COMMUNITY CHILD DEVELOPMENT CTR,CHILD_BREAKFAST,21,257,46,3,306,3868,692,45,4605,219.2857
SAN DIEGO,Oct 2015,CACF,2016,ESCONDIDO COMMUNITY CHILD DEVELOPMENT CTR,CHILD_LUNCH,21,257,46,3,306,4316,772,51,5139,244.7143
SAN DIEGO,Oct 2015,CACF,2016,ESCONDIDO COMMUNITY CHILD DEVELOPMENT CTR,CHILD_SNACK_PM,21,257,46,3,306,3678,658,43,4379,208.5238
SAN DIEGO,Nov 2015,CACF,2016,ESCONDIDO COMMUNITY CHILD DEVELOPMENT CTR,CHILD_BREAKFAST,19,257,46,3,306,3203,573,38,3814,200.7368
SAN DIEGO,Nov 2015,CACF,2016,ESCONDIDO COMMUNITY CHILD DEVELOPMENT CTR,CHILD_LUNCH,19,257,46,3,306,3570,639,42,4251,223.7368
SAN DIEGO,Nov 2015,CACF,2016,ESCONDIDO COMMUNITY CHILD DEVELOPMENT CTR,CHILD_SNACK_PM,19,257,46,3,306,2984,534,35,3553,187
SAN DIEGO,Dec 2015,CACF,2016,ESCONDIDO COMMUNITY CHILD DEVELOPMENT CTR,CHILD_BREAKFAST,20,257,46,3,306,2977,533,35,3545,177.25
SAN DIEGO,Dec 2015,CACF,2016,ESCONDIDO COMMUNITY CHILD DEVELOPMENT CTR,CHILD_LUNCH,20,257,46,3,306,3381,605,40,4026,201.3
SAN DIEGO,Dec 2015,CACF,2016,ESCONDIDO COMMUNITY CHILD DEVELOPMENT CTR,CHILD_SNACK_PM,20,257,46,3,306,2740,490,32,3262,163.1
SAN DIEGO,Jan 2016,CACF,2016,ESCONDIDO COMMUNITY CHILD DEVELOPMENT CTR,CHILD_BREAKFAST,20,257,46,3,306,3556,636,42,4234,211.7
SAN DIEGO,Jan 2016,CACF,2016,ESCONDIDO COMMUNITY CHILD DEVELOPMENT CTR,CHILD_LUNCH,20,257,46,3,306,4004,716,47,4767,238.35
SAN DIEGO,Jan 2016,CACF,2016,ESCONDIDO COMMUNITY CHILD DEVELOPMENT CTR,CHILD_SNACK_PM,20,257,46,3,306,3290,589,38,3917,195.85
SAN DIEGO,Feb 2016,CACF,2016,ESCONDIDO COMMUNITY CHILD DEVELOPMENT CTR,CHILD_BREAKFAST,21,257,46,3,306,3874,693,45,4612,219.619
SAN DIEGO,Feb 2016,CACF,2016,ESCONDIDO COMMUNITY CHILD DEVELOPMENT CTR,CHILD_LUNCH,21,257,46,3,306,4412,790,51,5253,250.1429
SAN DIEGO,Feb 2016,CACF,2016,ESCONDIDO COMMUNITY CHILD DEVELOPMENT CTR,CHILD_SNACK_PM,21,257,46,3,306,3368,603,39,4010,190.9524
SAN DIEGO,Mar 2016,CACF,2016,ESCONDIDO COMMUNITY CHILD DEVELOPMENT CTR,CHILD_BREAKFAST,23,257,46,3,306,4252,761,49,5062,220.087
SAN DIEGO,Mar 2016,CACF,2016,ESCONDIDO COMMUNITY CHILD DEVELOPMENT CTR,CHILD_LUNCH,23,257,46,3,306,4722,845,55,5622,244.4348
SAN DIEGO,Mar 2016,CACF,2016,ESCONDIDO COMMUNITY CHILD DEVELOPMENT CTR,CHILD_SNACK_PM,23,257,46,3,306,3912,700,46,4658,202.5217
SAN DIEGO,Apr 2016,CACF,2016,ESCONDIDO COMMUNITY CHILD DEVELOPMENT CTR,CHILD_BREAKFAST,21,257,46,3,306,3911,700,46,4657,221.7619
SAN DIEGO,Apr 2016,CACF,2016,ESCONDIDO COMMUNITY CHILD DEVELOPMENT CTR,CHILD_LUNCH,21,257,46,3,306,4366,781,51,5198,247.5238
SAN DIEGO,Apr 2016,CACF,2016,ESCONDIDO COMMUNITY CHILD DEVELOPMENT CTR,CHILD_SNACK_PM,21,257,46,3,306,3485,624,40,4149,197.5714
SAN DIEGO,May 2016,CACF,2016,ESCONDIDO COMMUNITY CHILD DEVELOPMENT CTR,CHILD_BREAKFAST,21,257,46,3,306,3978,712,46,4736,225.5238
SAN DIEGO,May 2016,CACF,2016,ESCONDIDO COMMUNITY CHILD DEVELOPMENT CTR,CHILD_LUNCH,21,257,46,3,306,4387,785,51,5223,248.7143
SAN DIEGO,May 2016,CACF,2016,ESCONDIDO COMMUNITY CHILD DEVELOPMENT CTR,CHILD_SNACK_PM,21,257,46,3,306,3671,657,43,4371,208.1429
SAN DIEGO,Jun 2016,CACF,2016,ESCONDIDO COMMUNITY CHILD DEVELOPMENT CTR,CHILD_BREAKFAST,21,257,46,3,306,4095,733,47,4875,232.1429
SAN DIEGO,Jun 2016,CACF,2016,ESCONDIDO COMMUNITY CHILD DEVELOPMENT CTR,CHILD_LUNCH,21,257,46,3,306,4448,796,52,5296,252.1905
SAN DIEGO,Jun 2016,CACF,2016,ESCONDIDO COMMUNITY CHILD DEVELOPMENT CTR,CHILD_SNACK_PM,21,257,46,3,306,3644,652,43,4339,206.619
SAN DIEGO,Jul 2016,CACF,2016,ESCONDIDO COMMUNITY CHILD DEVELOPMENT CTR,CHILD_BREAKFAST,19,257,46,3,306,3342,598,39,3979,209.4211
SAN DIEGO,Jul 2016,CACF,2016,ESCONDIDO COMMUNITY CHILD DEVELOPMENT CTR,CHILD_LUNCH,19,257,46,3,306,3694,661,43,4398,231.4737
SAN DIEGO,Jul 2016,CACF,2016,ESCONDIDO COMMUNITY CHILD DEVELOPMENT CTR,CHILD_SNACK_PM,19,257,46,3,306,3209,574,38,3821,201.1053
SAN DIEGO,Oct 2015,CACF,2016,Escondido Union High School District,ATRISK_CHILD_SUPPER,22,4122,0,0,4122,4122,0,0,4122,187.3636
SAN DIEGO,Oct 2015,CACF,2016,Escondido Union High School District,CHILD_BREAKFAST,22,18,0,0,18,261,0,0,261,11.8636
SAN DIEGO,Oct 2015,CACF,2016,Escondido Union High School District,CHILD_LUNCH,22,18,0,0,18,253,0,0,253,11.5
SAN DIEGO,Oct 2015,CACF,2016,Escondido Union High School District,CHILD_SNACK_PM,22,18,0,0,18,192,0,0,192,8.7273
SAN DIEGO,Nov 2015,CACF,2016,Escondido Union High School District,ATRISK_CHILD_SUPPER,15,2840,0,0,2840,2840,0,0,2840,189.3333
SAN DIEGO,Nov 2015,CACF,2016,Escondido Union High School District,CHILD_BREAKFAST,15,18,0,0,18,170,0,0,170,11.3333
SAN DIEGO,Nov 2015,CACF,2016,Escondido Union High School District,CHILD_LUNCH,15,18,0,0,18,171,0,0,171,11.4
SAN DIEGO,Nov 2015,CACF,2016,Escondido Union High School District,CHILD_SNACK_PM,15,18,0,0,18,134,0,0,134,8.9333
SAN DIEGO,Dec 2015,CACF,2016,Escondido Union High School District,ATRISK_CHILD_SUPPER,11,1904,0,0,1904,1904,0,0,1904,173.0909
SAN DIEGO,Dec 2015,CACF,2016,Escondido Union High School District,CHILD_BREAKFAST,15,18,0,0,18,137,0,0,137,9.1333
SAN DIEGO,Dec 2015,CACF,2016,Escondido Union High School District,CHILD_LUNCH,15,18,0,0,18,137,0,0,137,9.1333
SAN DIEGO,Dec 2015,CACF,2016,Escondido Union High School District,CHILD_SNACK_PM,15,18,0,0,18,49,0,0,49,3.2667
SAN DIEGO,Jan 2016,CACF,2016,Escondido Union High School District,ATRISK_CHILD_SUPPER,18,2921,0,0,2921,2921,0,0,2921,162.2778
SAN DIEGO,Jan 2016,CACF,2016,Escondido Union High School District,CHILD_BREAKFAST,18,18,0,0,18,200,0,0,200,11.1111
SAN DIEGO,Jan 2016,CACF,2016,Escondido Union High School District,CHILD_LUNCH,18,18,0,0,18,214,0,0,214,11.8889
SAN DIEGO,Jan 2016,CACF,2016,Escondido Union High School District,CHILD_SNACK_PM,18,18,0,0,18,170,0,0,170,9.4444
SAN DIEGO,Feb 2016,CACF,2016,Escondido Union High School District,ATRISK_CHILD_SUPPER,19,3579,0,0,3579,3579,0,0,3579,188.3684
SAN DIEGO,Feb 2016,CACF,2016,Escondido Union High School District,CHILD_BREAKFAST,20,18,0,0,18,269,0,0,269,13.45
SAN DIEGO,Feb 2016,CACF,2016,Escondido Union High School District,CHILD_LUNCH,20,18,0,0,18,269,0,0,269,13.45
SAN DIEGO,Feb 2016,CACF,2016,Escondido Union High School District,CHILD_SNACK_PM,20,18,0,0,18,227,0,0,227,11.35
SAN DIEGO,Mar 2016,CACF,2016,Escondido Union High School District,ATRISK_CHILD_SUPPER,17,2724,0,0,2724,2724,0,0,2724,160.2353
SAN DIEGO,Mar 2016,CACF,2016,Escondido Union High School District,CHILD_BREAKFAST,19,18,0,0,18,234,0,0,234,12.3158
SAN DIEGO,Mar 2016,CACF,2016,Escondido Union High School District,CHILD_LUNCH,19,18,0,0,18,231,0,0,231,12.1579
SAN DIEGO,Mar 2016,CACF,2016,Escondido Union High School District,CHILD_SNACK_PM,19,18,0,0,18,180,0,0,180,9.4737
SAN DIEGO,Apr 2016,CACF,2016,Escondido Union High School District,ATRISK_CHILD_SUPPER,21,3252,0,0,3252,3252,0,0,3252,154.8571
SAN DIEGO,Apr 2016,CACF,2016,Escondido Union High School District,CHILD_BREAKFAST,24,18,0,0,18,303,0,0,303,12.625
SAN DIEGO,Apr 2016,CACF,2016,Escondido Union High School District,CHILD_LUNCH,24,18,0,0,18,296,0,0,296,12.3333
SAN DIEGO,Apr 2016,CACF,2016,Escondido Union High School District,CHILD_SNACK_PM,24,18,0,0,18,233,0,0,233,9.7083
SAN DIEGO,May 2016,CACF,2016,Escondido Union High School District,ATRISK_CHILD_SUPPER,19,2952,0,0,2952,2952,0,0,2952,155.3684
SAN DIEGO,May 2016,CACF,2016,Escondido Union High School District,CHILD_BREAKFAST,23,18,0,0,18,284,0,0,284,12.3478
SAN DIEGO,May 2016,CACF,2016,Escondido Union High School District,CHILD_LUNCH,23,18,0,0,18,278,0,0,278,12.087
SAN DIEGO,May 2016,CACF,2016,Escondido Union High School District,CHILD_SNACK_PM,23,18,0,0,18,215,0,0,215,9.3478
SAN DIEGO,Jun 2016,CACF,2016,Escondido Union High School District,CHILD_BREAKFAST,16,18,0,0,18,53,0,0,53,3.3125
SAN DIEGO,Jun 2016,CACF,2016,Escondido Union High School District,CHILD_LUNCH,16,18,0,0,18,53,0,0,53,3.3125
SAN DIEGO,Jun 2016,CACF,2016,Escondido Union High School District,CHILD_SNACK_PM,16,18,0,0,18,20,0,0,20,1.25
SAN DIEGO,Oct 2015,CACF,2016,Escondido Union School District,ATRISK_CHILD_SNACK,20,8260,0,0,8260,4862,0,0,4862,243.1
SAN DIEGO,Oct 2015,CACF,2016,Escondido Union School District,ATRISK_CHILD_SUPPER,20,8260,0,0,8260,31774,0,0,31774,1588.7
SAN DIEGO,Nov 2015,CACF,2016,Escondido Union School District,ATRISK_CHILD_SNACK,15,8338,0,0,8338,2799,0,0,2799,186.6
SAN DIEGO,Nov 2015,CACF,2016,Escondido Union School District,ATRISK_CHILD_SUPPER,15,8338,0,0,8338,23305,0,0,23305,1553.6667
SAN DIEGO,Dec 2015,CACF,2016,Escondido Union School District,ATRISK_CHILD_SNACK,14,8404,0,0,8404,2667,0,0,2667,190.5
SAN DIEGO,Dec 2015,CACF,2016,Escondido Union School District,ATRISK_CHILD_SUPPER,14,8404,0,0,8404,20809,0,0,20809,1486.3571
SAN DIEGO,Jan 2016,CACF,2016,Escondido Union School District,ATRISK_CHILD_SNACK,18,8413,0,0,8413,3837,0,0,3837,213.1667
SAN DIEGO,Jan 2016,CACF,2016,Escondido Union School District,ATRISK_CHILD_SUPPER,18,8413,0,0,8413,26564,0,0,26564,1475.7778
SAN DIEGO,Feb 2016,CACF,2016,Escondido Union School District,ATRISK_CHILD_SNACK,19,8458,0,0,8458,4427,0,0,4427,233
SAN DIEGO,Feb 2016,CACF,2016,Escondido Union School District,ATRISK_CHILD_SUPPER,19,8458,0,0,8458,28105,0,0,28105,1479.2105
SAN DIEGO,Mar 2016,CACF,2016,Escondido Union School District,ATRISK_CHILD_SNACK,23,8462,0,0,8462,4338,0,0,4338,188.6087
SAN DIEGO,Mar 2016,CACF,2016,Escondido Union School District,ATRISK_CHILD_SUPPER,23,8462,0,0,8462,21737,0,0,21737,945.087
SAN DIEGO,Apr 2016,CACF,2016,Escondido Union School District,ATRISK_CHILD_SNACK,20,8482,0,0,8482,5320,0,0,5320,266
SAN DIEGO,Apr 2016,CACF,2016,Escondido Union School District,ATRISK_CHILD_SUPPER,20,8482,0,0,8482,29858,0,0,29858,1492.9
SAN DIEGO,May 2016,CACF,2016,Escondido Union School District,ATRISK_CHILD_SNACK,21,8496,0,0,8496,5384,0,0,5384,256.381
SAN DIEGO,May 2016,CACF,2016,Escondido Union School District,ATRISK_CHILD_SUPPER,21,8496,0,0,8496,30251,0,0,30251,1440.5238
SAN DIEGO,Jun 2016,CACF,2016,Escondido Union School District,ATRISK_CHILD_SNACK,7,8509,0,0,8509,1584,0,0,1584,226.2857
SAN DIEGO,Jun 2016,CACF,2016,Escondido Union School District,ATRISK_CHILD_SUPPER,7,8509,0,0,8509,8242,0,0,8242,1177.4286
SAN DIEGO,Oct 2015,CACF,2016,FALLBROOK CHILD DEVELOP CENTER ,CHILD_BREAKFAST,22,42,3,2,47,734,52,35,821,37.3182
SAN DIEGO,Oct 2015,CACF,2016,FALLBROOK CHILD DEVELOP CENTER ,CHILD_LUNCH,22,42,3,2,47,726,52,34,812,36.9091
SAN DIEGO,Oct 2015,CACF,2016,FALLBROOK CHILD DEVELOP CENTER ,CHILD_SNACK_PM,22,42,3,2,47,526,38,25,589,26.7727
SAN DIEGO,Nov 2015,CACF,2016,FALLBROOK CHILD DEVELOP CENTER ,CHILD_BREAKFAST,19,42,3,2,47,563,40,27,630,33.1579
SAN DIEGO,Nov 2015,CACF,2016,FALLBROOK CHILD DEVELOP CENTER ,CHILD_LUNCH,19,42,3,2,47,559,40,27,626,32.9474
SAN DIEGO,Nov 2015,CACF,2016,FALLBROOK CHILD DEVELOP CENTER ,CHILD_SNACK_PM,19,42,3,2,47,412,29,20,461,24.2632
SAN DIEGO,Dec 2015,CACF,2016,FALLBROOK CHILD DEVELOP CENTER ,CHILD_BREAKFAST,14,42,3,2,47,434,31,21,486,34.7143
SAN DIEGO,Dec 2015,CACF,2016,FALLBROOK CHILD DEVELOP CENTER ,CHILD_LUNCH,14,42,3,2,47,443,32,21,496,35.4286
SAN DIEGO,Dec 2015,CACF,2016,FALLBROOK CHILD DEVELOP CENTER ,CHILD_SNACK_PM,14,42,3,2,47,308,22,15,345,24.6429
SAN DIEGO,Jan 2016,CACF,2016,FALLBROOK CHILD DEVELOP CENTER ,CHILD_BREAKFAST,20,42,3,2,47,598,43,28,669,33.45
SAN DIEGO,Jan 2016,CACF,2016,FALLBROOK CHILD DEVELOP CENTER ,CHILD_LUNCH,20,42,3,2,47,593,42,29,664,33.2
SAN DIEGO,Jan 2016,CACF,2016,FALLBROOK CHILD DEVELOP CENTER ,CHILD_SNACK_PM,20,42,3,2,47,399,29,19,447,22.35
SAN DIEGO,Feb 2016,CACF,2016,FALLBROOK CHILD DEVELOP CENTER ,CHILD_BREAKFAST,21,42,3,2,47,681,49,32,762,36.2857
SAN DIEGO,Feb 2016,CACF,2016,FALLBROOK CHILD DEVELOP CENTER ,CHILD_LUNCH,21,42,3,2,47,683,49,32,764,36.381
SAN DIEGO,Feb 2016,CACF,2016,FALLBROOK CHILD DEVELOP CENTER ,CHILD_SNACK_PM,21,42,3,2,47,504,36,24,564,26.8571
SAN DIEGO,Mar 2016,CACF,2016,FALLBROOK CHILD DEVELOP CENTER ,CHILD_BREAKFAST,23,42,3,2,47,754,54,36,844,36.6957
SAN DIEGO,Mar 2016,CACF,2016,FALLBROOK CHILD DEVELOP CENTER ,CHILD_LUNCH,23,42,3,2,47,757,54,36,847,36.8261
SAN DIEGO,Mar 2016,CACF,2016,FALLBROOK CHILD DEVELOP CENTER ,CHILD_SNACK_PM,23,42,3,2,47,528,38,25,591,25.6957
SAN DIEGO,Apr 2016,CACF,2016,FALLBROOK CHILD DEVELOP CENTER ,CHILD_BREAKFAST,21,42,3,2,47,645,46,31,722,34.381
SAN DIEGO,Apr 2016,CACF,2016,FALLBROOK CHILD DEVELOP CENTER ,CHILD_LUNCH,21,42,3,2,47,655,47,31,733,34.9048
SAN DIEGO,Apr 2016,CACF,2016,FALLBROOK CHILD DEVELOP CENTER ,CHILD_SNACK_PM,21,42,3,2,47,468,33,23,524,24.9524
SAN DIEGO,May 2016,CACF,2016,FALLBROOK CHILD DEVELOP CENTER ,CHILD_BREAKFAST,21,42,3,2,47,684,49,33,766,36.4762
SAN DIEGO,May 2016,CACF,2016,FALLBROOK CHILD DEVELOP CENTER ,CHILD_LUNCH,21,42,3,2,47,715,51,34,800,38.0952
SAN DIEGO,May 2016,CACF,2016,FALLBROOK CHILD DEVELOP CENTER ,CHILD_SNACK_PM,21,42,3,2,47,501,36,24,561,26.7143
SAN DIEGO,Jun 2016,CACF,2016,FALLBROOK CHILD DEVELOP CENTER ,CHILD_BREAKFAST,22,42,3,2,47,683,49,32,764,34.7273
SAN DIEGO,Jun 2016,CACF,2016,FALLBROOK CHILD DEVELOP CENTER ,CHILD_LUNCH,22,42,3,2,47,693,50,33,776,35.2727
SAN DIEGO,Jun 2016,CACF,2016,FALLBROOK CHILD DEVELOP CENTER ,CHILD_SNACK_PM,22,42,3,2,47,464,33,22,519,23.5909
SAN DIEGO,Jul 2016,CACF,2016,FALLBROOK CHILD DEVELOP CENTER ,CHILD_BREAKFAST,20,42,3,2,47,668,48,32,748,37.4
SAN DIEGO,Jul 2016,CACF,2016,FALLBROOK CHILD DEVELOP CENTER ,CHILD_LUNCH,20,42,3,2,47,673,48,32,753,37.65
SAN DIEGO,Jul 2016,CACF,2016,FALLBROOK CHILD DEVELOP CENTER ,CHILD_SNACK_PM,20,42,3,2,47,474,34,22,530,26.5
SAN DIEGO,Oct 2015,CACF,2016,Feeding America San Diego,ATRISK_CHILD_SUPPER,22,404,0,0,404,5913,0,0,5913,268.7727
SAN DIEGO,Nov 2015,CACF,2016,Feeding America San Diego,ATRISK_CHILD_SUPPER,18,391,0,0,391,4747,0,0,4747,263.7222
SAN DIEGO,Dec 2015,CACF,2016,Feeding America San Diego,ATRISK_CHILD_SUPPER,20,380,0,0,380,5034,0,0,5034,251.7
SAN DIEGO,Jan 2016,CACF,2016,Feeding America San Diego,ATRISK_CHILD_SUPPER,19,385,0,0,385,5246,0,0,5246,276.1053
SAN DIEGO,Feb 2016,CACF,2016,Feeding America San Diego,ATRISK_CHILD_SUPPER,20,344,0,0,344,5630,0,0,5630,281.5
SAN DIEGO,Mar 2016,CACF,2016,Feeding America San Diego,ATRISK_CHILD_SUPPER,23,341,0,0,341,6663,0,0,6663,289.6957
SAN DIEGO,Apr 2016,CACF,2016,Feeding America San Diego,ATRISK_CHILD_SUPPER,21,301,0,0,301,4820,0,0,4820,229.5238
SAN DIEGO,May 2016,CACF,2016,Feeding America San Diego,ATRISK_CHILD_SUPPER,22,272,0,0,272,4955,0,0,4955,225.2273
SAN DIEGO,Jun 2016,CACF,2016,Feeding America San Diego,ATRISK_CHILD_SUPPER,15,218,0,0,218,2640,0,0,2640,176
SAN DIEGO,Oct 2015,CACF,2016,GENAVEVES PLAYHOUSE PRESCHOOL,CHILD_BREAKFAST,22,54,26,20,100,947,456,351,1754,79.7273
SAN DIEGO,Oct 2015,CACF,2016,GENAVEVES PLAYHOUSE PRESCHOOL,CHILD_LUNCH,22,54,26,20,100,955,460,353,1768,80.3636
SAN DIEGO,Oct 2015,CACF,2016,GENAVEVES PLAYHOUSE PRESCHOOL,CHILD_SNACK_AM,22,54,26,20,100,950,458,352,1760,80
SAN DIEGO,Oct 2015,CACF,2016,GENAVEVES PLAYHOUSE PRESCHOOL,CHILD_SNACK_PM,22,54,26,20,100,6,3,2,11,0.5
SAN DIEGO,Nov 2015,CACF,2016,GENAVEVES PLAYHOUSE PRESCHOOL,CHILD_BREAKFAST,20,37,18,15,70,634,309,257,1200,60
SAN DIEGO,Nov 2015,CACF,2016,GENAVEVES PLAYHOUSE PRESCHOOL,CHILD_LUNCH,20,37,18,15,70,634,309,257,1200,60
SAN DIEGO,Nov 2015,CACF,2016,GENAVEVES PLAYHOUSE PRESCHOOL,CHILD_SNACK_AM,20,37,18,15,70,634,308,257,1199,59.95
SAN DIEGO,Dec 2015,CACF,2016,GENAVEVES PLAYHOUSE PRESCHOOL,CHILD_BREAKFAST,22,37,18,15,70,709,345,288,1342,61
SAN DIEGO,Dec 2015,CACF,2016,GENAVEVES PLAYHOUSE PRESCHOOL,CHILD_LUNCH,22,37,18,15,70,706,343,286,1335,60.6818
SAN DIEGO,Dec 2015,CACF,2016,GENAVEVES PLAYHOUSE PRESCHOOL,CHILD_SNACK_AM,22,37,18,15,70,570,277,231,1078,49
SAN DIEGO,Dec 2015,CACF,2016,GENAVEVES PLAYHOUSE PRESCHOOL,CHILD_SNACK_PM,22,37,18,15,70,70,34,28,132,6
SAN DIEGO,Jan 2016,CACF,2016,GENAVEVES PLAYHOUSE PRESCHOOL,CHILD_BREAKFAST,20,37,18,15,70,655,319,266,1240,62
SAN DIEGO,Jan 2016,CACF,2016,GENAVEVES PLAYHOUSE PRESCHOOL,CHILD_LUNCH,20,37,18,15,70,653,318,264,1235,61.75
SAN DIEGO,Jan 2016,CACF,2016,GENAVEVES PLAYHOUSE PRESCHOOL,CHILD_SNACK_AM,20,37,18,15,70,655,319,265,1239,61.95
SAN DIEGO,Feb 2016,CACF,2016,GENAVEVES PLAYHOUSE PRESCHOOL,CHILD_BREAKFAST,21,37,18,15,70,733,356,297,1386,66
SAN DIEGO,Feb 2016,CACF,2016,GENAVEVES PLAYHOUSE PRESCHOOL,CHILD_LUNCH,21,37,18,15,70,731,355,296,1382,65.8095
SAN DIEGO,Feb 2016,CACF,2016,GENAVEVES PLAYHOUSE PRESCHOOL,CHILD_SNACK_AM,21,37,18,15,70,731,355,296,1382,65.8095
SAN DIEGO,Feb 2016,CACF,2016,GENAVEVES PLAYHOUSE PRESCHOOL,CHILD_SNACK_PM,21,37,18,15,70,1,1,0,2,0.0952
SAN DIEGO,Mar 2016,CACF,2016,GENAVEVES PLAYHOUSE PRESCHOOL,CHILD_BREAKFAST,23,37,18,15,70,802,390,326,1518,66
SAN DIEGO,Mar 2016,CACF,2016,GENAVEVES PLAYHOUSE PRESCHOOL,CHILD_LUNCH,23,37,18,15,70,800,389,325,1514,65.8261
SAN DIEGO,Mar 2016,CACF,2016,GENAVEVES PLAYHOUSE PRESCHOOL,CHILD_SNACK_AM,23,37,18,15,70,800,389,325,1514,65.8261
SAN DIEGO,May 2016,CACF,2016,GENAVEVES PLAYHOUSE PRESCHOOL,CHILD_BREAKFAST,21,37,18,15,70,576,280,234,1090,51.9048
SAN DIEGO,May 2016,CACF,2016,GENAVEVES PLAYHOUSE PRESCHOOL,CHILD_LUNCH,21,37,18,15,70,576,280,234,1090,51.9048
SAN DIEGO,May 2016,CACF,2016,GENAVEVES PLAYHOUSE PRESCHOOL,CHILD_SNACK_PM,21,37,18,15,70,538,261,218,1017,48.4286
SAN DIEGO,Jun 2016,CACF,2016,GENAVEVES PLAYHOUSE PRESCHOOL,CHILD_BREAKFAST,22,37,18,15,70,594,289,241,1124,51.0909
SAN DIEGO,Jun 2016,CACF,2016,GENAVEVES PLAYHOUSE PRESCHOOL,CHILD_LUNCH,22,37,18,15,70,609,296,248,1153,52.4091
SAN DIEGO,Jun 2016,CACF,2016,GENAVEVES PLAYHOUSE PRESCHOOL,CHILD_SNACK_PM,22,37,18,15,70,572,278,233,1083,49.2273
SAN DIEGO,Jul 2016,CACF,2016,GENAVEVES PLAYHOUSE PRESCHOOL,CHILD_BREAKFAST,20,37,18,15,70,470,229,191,890,44.5
SAN DIEGO,Jul 2016,CACF,2016,GENAVEVES PLAYHOUSE PRESCHOOL,CHILD_LUNCH,20,37,18,15,70,499,243,202,944,47.2
SAN DIEGO,Jul 2016,CACF,2016,GENAVEVES PLAYHOUSE PRESCHOOL,CHILD_SNACK_AM,20,37,18,15,70,476,232,193,901,45.05
SAN DIEGO,Oct 2015,CACF,2016,GEORGE G GLENNER ALZHEIMERS FM CTR INC,ADULT_BREAKFAST,22,26,7,71,104,214,57,583,854,38.8182
SAN DIEGO,Oct 2015,CACF,2016,GEORGE G GLENNER ALZHEIMERS FM CTR INC,ADULT_LUNCH,22,26,7,71,104,336,90,918,1344,61.0909
SAN DIEGO,Oct 2015,CACF,2016,GEORGE G GLENNER ALZHEIMERS FM CTR INC,ADULT_SNACK_PM,22,26,7,71,104,207,56,564,827,37.5909
SAN DIEGO,Nov 2015,CACF,2016,GEORGE G GLENNER ALZHEIMERS FM CTR INC,ADULT_BREAKFAST,18,26,7,71,104,170,46,465,681,37.8333
SAN DIEGO,Nov 2015,CACF,2016,GEORGE G GLENNER ALZHEIMERS FM CTR INC,ADULT_LUNCH,18,26,7,71,104,260,70,711,1041,57.8333
SAN DIEGO,Nov 2015,CACF,2016,GEORGE G GLENNER ALZHEIMERS FM CTR INC,ADULT_SNACK_PM,18,26,7,71,104,175,47,479,701,38.9444
SAN DIEGO,Dec 2015,CACF,2016,GEORGE G GLENNER ALZHEIMERS FM CTR INC,ADULT_BREAKFAST,20,26,7,71,104,184,49,502,735,36.75
SAN DIEGO,Dec 2015,CACF,2016,GEORGE G GLENNER ALZHEIMERS FM CTR INC,ADULT_LUNCH,20,26,7,71,104,305,82,833,1220,61
SAN DIEGO,Dec 2015,CACF,2016,GEORGE G GLENNER ALZHEIMERS FM CTR INC,ADULT_SNACK_PM,20,26,7,71,104,203,55,552,810,40.5
SAN DIEGO,Jan 2016,CACF,2016,GEORGE G GLENNER ALZHEIMERS FM CTR INC,ADULT_BREAKFAST,20,26,7,71,104,178,48,484,710,35.5
SAN DIEGO,Jan 2016,CACF,2016,GEORGE G GLENNER ALZHEIMERS FM CTR INC,ADULT_LUNCH,20,26,7,71,104,290,78,790,1158,57.9
SAN DIEGO,Jan 2016,CACF,2016,GEORGE G GLENNER ALZHEIMERS FM CTR INC,ADULT_SNACK_PM,20,26,7,71,104,187,50,510,747,37.35
SAN DIEGO,Feb 2016,CACF,2016,GEORGE G GLENNER ALZHEIMERS FM CTR INC,ADULT_BREAKFAST,20,26,7,71,104,180,48,490,718,35.9
SAN DIEGO,Feb 2016,CACF,2016,GEORGE G GLENNER ALZHEIMERS FM CTR INC,ADULT_LUNCH,20,26,7,71,104,289,78,789,1156,57.8
SAN DIEGO,Feb 2016,CACF,2016,GEORGE G GLENNER ALZHEIMERS FM CTR INC,ADULT_SNACK_PM,20,26,7,71,104,196,53,534,783,39.15
SAN DIEGO,Mar 2016,CACF,2016,GEORGE G GLENNER ALZHEIMERS FM CTR INC,ADULT_BREAKFAST,23,26,7,71,104,214,57,583,854,37.1304
SAN DIEGO,Mar 2016,CACF,2016,GEORGE G GLENNER ALZHEIMERS FM CTR INC,ADULT_LUNCH,23,26,7,71,104,337,91,919,1347,58.5652
SAN DIEGO,Mar 2016,CACF,2016,GEORGE G GLENNER ALZHEIMERS FM CTR INC,ADULT_SNACK_PM,23,26,7,71,104,225,61,613,899,39.087
SAN DIEGO,Apr 2016,CACF,2016,GEORGE G GLENNER ALZHEIMERS FM CTR INC,ADULT_BREAKFAST,21,26,7,71,104,207,56,564,827,39.381
SAN DIEGO,Apr 2016,CACF,2016,GEORGE G GLENNER ALZHEIMERS FM CTR INC,ADULT_LUNCH,21,26,7,71,104,324,87,886,1297,61.7619
SAN DIEGO,Apr 2016,CACF,2016,GEORGE G GLENNER ALZHEIMERS FM CTR INC,ADULT_SNACK_PM,21,26,7,71,104,229,62,623,914,43.5238
SAN DIEGO,May 2016,CACF,2016,GEORGE G GLENNER ALZHEIMERS FM CTR INC,ADULT_BREAKFAST,21,26,7,71,104,168,45,458,671,31.9524
SAN DIEGO,May 2016,CACF,2016,GEORGE G GLENNER ALZHEIMERS FM CTR INC,ADULT_LUNCH,21,26,7,71,104,257,69,703,1029,49
SAN DIEGO,May 2016,CACF,2016,GEORGE G GLENNER ALZHEIMERS FM CTR INC,ADULT_SNACK_PM,21,26,7,71,104,222,60,607,889,42.3333
SAN DIEGO,Jun 2016,CACF,2016,GEORGE G GLENNER ALZHEIMERS FM CTR INC,ADULT_BREAKFAST,22,26,7,71,104,221,60,604,885,40.2273
SAN DIEGO,Jun 2016,CACF,2016,GEORGE G GLENNER ALZHEIMERS FM CTR INC,ADULT_LUNCH,22,26,7,71,104,411,111,1123,1645,74.7727
SAN DIEGO,Jun 2016,CACF,2016,GEORGE G GLENNER ALZHEIMERS FM CTR INC,ADULT_SNACK_PM,22,26,7,71,104,243,65,662,970,44.0909
SAN DIEGO,Jul 2016,CACF,2016,GEORGE G GLENNER ALZHEIMERS FM CTR INC,ADULT_BREAKFAST,20,26,7,71,104,205,55,561,821,41.05
SAN DIEGO,Jul 2016,CACF,2016,GEORGE G GLENNER ALZHEIMERS FM CTR INC,ADULT_LUNCH,20,26,7,71,104,304,82,831,1217,60.85
SAN DIEGO,Jul 2016,CACF,2016,GEORGE G GLENNER ALZHEIMERS FM CTR INC,ADULT_SNACK_PM,20,26,7,71,104,215,58,586,859,42.95
SAN DIEGO,Oct 2015,CACF,2016,GIGGLES & SMILES CHILD CARE CENTER  ,CHILD_BREAKFAST,22,11,9,52,72,190,156,898,1244,56.5455
SAN DIEGO,Oct 2015,CACF,2016,GIGGLES & SMILES CHILD CARE CENTER  ,CHILD_LUNCH,22,11,9,52,72,200,164,947,1311,59.5909
SAN DIEGO,Oct 2015,CACF,2016,GIGGLES & SMILES CHILD CARE CENTER  ,CHILD_SNACK_PM,22,11,9,52,72,187,153,887,1227,55.7727
SAN DIEGO,Nov 2015,CACF,2016,GIGGLES & SMILES CHILD CARE CENTER  ,CHILD_BREAKFAST,18,11,9,52,72,163,133,769,1065,59.1667
SAN DIEGO,Nov 2015,CACF,2016,GIGGLES & SMILES CHILD CARE CENTER  ,CHILD_LUNCH,18,11,9,52,72,174,142,823,1139,63.2778
SAN DIEGO,Nov 2015,CACF,2016,GIGGLES & SMILES CHILD CARE CENTER  ,CHILD_SNACK_PM,18,11,9,52,72,160,131,759,1050,58.3333
SAN DIEGO,Dec 2015,CACF,2016,GIGGLES & SMILES CHILD CARE CENTER  ,CHILD_BREAKFAST,20,11,9,52,72,169,138,797,1104,55.2
SAN DIEGO,Dec 2015,CACF,2016,GIGGLES & SMILES CHILD CARE CENTER  ,CHILD_LUNCH,20,11,9,52,72,180,147,851,1178,58.9
SAN DIEGO,Dec 2015,CACF,2016,GIGGLES & SMILES CHILD CARE CENTER  ,CHILD_SNACK_PM,20,11,9,52,72,164,134,773,1071,53.55
SAN DIEGO,Jan 2016,CACF,2016,GIGGLES & SMILES CHILD CARE CENTER  ,CHILD_BREAKFAST,19,11,9,52,72,158,129,748,1035,54.4737
SAN DIEGO,Jan 2016,CACF,2016,GIGGLES & SMILES CHILD CARE CENTER  ,CHILD_LUNCH,19,11,9,52,72,168,138,796,1102,58
SAN DIEGO,Jan 2016,CACF,2016,GIGGLES & SMILES CHILD CARE CENTER  ,CHILD_SNACK_PM,19,11,9,52,72,153,125,722,1000,52.6316
SAN DIEGO,Feb 2016,CACF,2016,GIGGLES & SMILES CHILD CARE CENTER  ,CHILD_BREAKFAST,20,11,9,52,72,187,153,887,1227,61.35
SAN DIEGO,Feb 2016,CACF,2016,GIGGLES & SMILES CHILD CARE CENTER  ,CHILD_LUNCH,20,11,9,52,72,196,160,927,1283,64.15
SAN DIEGO,Feb 2016,CACF,2016,GIGGLES & SMILES CHILD CARE CENTER  ,CHILD_SNACK_PM,20,11,9,52,72,182,149,863,1194,59.7
SAN DIEGO,Mar 2016,CACF,2016,GIGGLES & SMILES CHILD CARE CENTER  ,CHILD_BREAKFAST,22,11,9,52,72,199,163,942,1304,59.2727
SAN DIEGO,Mar 2016,CACF,2016,GIGGLES & SMILES CHILD CARE CENTER  ,CHILD_LUNCH,22,11,9,52,72,208,171,985,1364,62
SAN DIEGO,Mar 2016,CACF,2016,GIGGLES & SMILES CHILD CARE CENTER  ,CHILD_SNACK_PM,22,11,9,52,72,198,162,938,1298,59
SAN DIEGO,Apr 2016,CACF,2016,GIGGLES & SMILES CHILD CARE CENTER  ,CHILD_BREAKFAST,21,15,7,53,75,257,120,906,1283,61.0952
SAN DIEGO,Apr 2016,CACF,2016,GIGGLES & SMILES CHILD CARE CENTER  ,CHILD_LUNCH,21,15,7,53,75,278,130,980,1388,66.0952
SAN DIEGO,Apr 2016,CACF,2016,GIGGLES & SMILES CHILD CARE CENTER  ,CHILD_SNACK_PM,21,15,7,53,75,256,119,905,1280,60.9524
SAN DIEGO,May 2016,CACF,2016,GIGGLES & SMILES CHILD CARE CENTER  ,CHILD_BREAKFAST,21,15,7,53,75,255,119,901,1275,60.7143
SAN DIEGO,May 2016,CACF,2016,GIGGLES & SMILES CHILD CARE CENTER  ,CHILD_LUNCH,21,15,7,53,75,275,128,973,1376,65.5238
SAN DIEGO,May 2016,CACF,2016,GIGGLES & SMILES CHILD CARE CENTER  ,CHILD_SNACK_PM,21,15,7,53,75,253,118,893,1264,60.1905
SAN DIEGO,Jun 2016,CACF,2016,GIGGLES & SMILES CHILD CARE CENTER  ,CHILD_BREAKFAST,22,15,7,53,75,270,126,956,1352,61.4545
SAN DIEGO,Jun 2016,CACF,2016,GIGGLES & SMILES CHILD CARE CENTER  ,CHILD_LUNCH,22,15,7,53,75,287,134,1013,1434,65.1818
SAN DIEGO,Jun 2016,CACF,2016,GIGGLES & SMILES CHILD CARE CENTER  ,CHILD_SNACK_PM,22,15,7,53,75,265,124,935,1324,60.1818
SAN DIEGO,Jul 2016,CACF,2016,GIGGLES & SMILES CHILD CARE CENTER  ,CHILD_BREAKFAST,20,15,7,53,75,216,101,764,1081,54.05
SAN DIEGO,Jul 2016,CACF,2016,GIGGLES & SMILES CHILD CARE CENTER  ,CHILD_LUNCH,20,15,7,53,75,234,109,825,1168,58.4
SAN DIEGO,Jul 2016,CACF,2016,GIGGLES & SMILES CHILD CARE CENTER  ,CHILD_SNACK_PM,20,15,7,53,75,213,100,754,1067,53.35
SAN DIEGO,Oct 2015,CACF,2016,GROSSMONT CUYAMACA COMMUNITY COLLEGE DISTRICT ,CHILD_BREAKFAST,22,75,1,48,124,668,9,427,1104,50.1818
SAN DIEGO,Oct 2015,CACF,2016,GROSSMONT CUYAMACA COMMUNITY COLLEGE DISTRICT ,CHILD_LUNCH,22,75,1,48,124,1170,16,748,1934,87.9091
SAN DIEGO,Oct 2015,CACF,2016,GROSSMONT CUYAMACA COMMUNITY COLLEGE DISTRICT ,CHILD_SNACK_PM,22,75,1,48,124,574,8,367,949,43.1364
SAN DIEGO,Nov 2015,CACF,2016,GROSSMONT CUYAMACA COMMUNITY COLLEGE DISTRICT ,CHILD_BREAKFAST,18,75,1,48,124,509,7,326,842,46.7778
SAN DIEGO,Nov 2015,CACF,2016,GROSSMONT CUYAMACA COMMUNITY COLLEGE DISTRICT ,CHILD_LUNCH,18,75,1,48,124,942,13,602,1557,86.5
SAN DIEGO,Nov 2015,CACF,2016,GROSSMONT CUYAMACA COMMUNITY COLLEGE DISTRICT ,CHILD_SNACK_PM,18,75,1,48,124,481,6,308,795,44.1667
SAN DIEGO,Dec 2015,CACF,2016,GROSSMONT CUYAMACA COMMUNITY COLLEGE DISTRICT ,CHILD_BREAKFAST,15,75,1,48,124,282,4,180,466,31.0667
SAN DIEGO,Dec 2015,CACF,2016,GROSSMONT CUYAMACA COMMUNITY COLLEGE DISTRICT ,CHILD_LUNCH,15,75,1,48,124,564,8,361,933,62.2
SAN DIEGO,Dec 2015,CACF,2016,GROSSMONT CUYAMACA COMMUNITY COLLEGE DISTRICT ,CHILD_SNACK_PM,15,75,1,48,124,290,4,185,479,31.9333
SAN DIEGO,Jan 2016,CACF,2016,GROSSMONT CUYAMACA COMMUNITY COLLEGE DISTRICT ,CHILD_BREAKFAST,19,75,1,48,124,228,3,146,377,19.8421
SAN DIEGO,Jan 2016,CACF,2016,GROSSMONT CUYAMACA COMMUNITY COLLEGE DISTRICT ,CHILD_LUNCH,19,75,1,48,124,486,7,310,803,42.2632
SAN DIEGO,Jan 2016,CACF,2016,GROSSMONT CUYAMACA COMMUNITY COLLEGE DISTRICT ,CHILD_SNACK_PM,19,75,1,48,124,211,3,135,349,18.3684
SAN DIEGO,Feb 2016,CACF,2016,GROSSMONT CUYAMACA COMMUNITY COLLEGE DISTRICT ,CHILD_BREAKFAST,19,75,1,48,124,497,7,317,821,43.2105
SAN DIEGO,Feb 2016,CACF,2016,GROSSMONT CUYAMACA COMMUNITY COLLEGE DISTRICT ,CHILD_LUNCH,19,75,1,48,124,1031,14,660,1705,89.7368
SAN DIEGO,Feb 2016,CACF,2016,GROSSMONT CUYAMACA COMMUNITY COLLEGE DISTRICT ,CHILD_SNACK_PM,19,75,1,48,124,486,7,311,804,42.3158
SAN DIEGO,Mar 2016,CACF,2016,GROSSMONT CUYAMACA COMMUNITY COLLEGE DISTRICT ,CHILD_BREAKFAST,23,85,4,49,138,556,26,321,903,39.2609
SAN DIEGO,Mar 2016,CACF,2016,GROSSMONT CUYAMACA COMMUNITY COLLEGE DISTRICT ,CHILD_LUNCH,23,85,4,49,138,1130,53,652,1835,79.7826
SAN DIEGO,Mar 2016,CACF,2016,GROSSMONT CUYAMACA COMMUNITY COLLEGE DISTRICT ,CHILD_SNACK_PM,23,85,4,49,138,537,25,310,872,37.913
SAN DIEGO,Apr 2016,CACF,2016,GROSSMONT CUYAMACA COMMUNITY COLLEGE DISTRICT ,CHILD_BREAKFAST,21,85,4,49,138,586,28,337,951,45.2857
SAN DIEGO,Apr 2016,CACF,2016,GROSSMONT CUYAMACA COMMUNITY COLLEGE DISTRICT ,CHILD_LUNCH,21,85,4,49,138,1244,59,717,2020,96.1905
SAN DIEGO,Apr 2016,CACF,2016,GROSSMONT CUYAMACA COMMUNITY COLLEGE DISTRICT ,CHILD_SNACK_PM,21,85,4,49,138,580,27,335,942,44.8571
SAN DIEGO,May 2016,CACF,2016,GROSSMONT CUYAMACA COMMUNITY COLLEGE DISTRICT ,CHILD_BREAKFAST,21,85,4,49,138,564,27,324,915,43.5714
SAN DIEGO,May 2016,CACF,2016,GROSSMONT CUYAMACA COMMUNITY COLLEGE DISTRICT ,CHILD_LUNCH,21,85,4,49,138,1141,54,657,1852,88.1905
SAN DIEGO,May 2016,CACF,2016,GROSSMONT CUYAMACA COMMUNITY COLLEGE DISTRICT ,CHILD_SNACK_PM,21,85,4,49,138,552,26,319,897,42.7143
SAN DIEGO,Jun 2016,CACF,2016,GROSSMONT CUYAMACA COMMUNITY COLLEGE DISTRICT ,CHILD_BREAKFAST,22,85,4,49,138,169,8,98,275,12.5
SAN DIEGO,Jun 2016,CACF,2016,GROSSMONT CUYAMACA COMMUNITY COLLEGE DISTRICT ,CHILD_LUNCH,22,85,4,49,138,471,22,271,764,34.7273
SAN DIEGO,Jun 2016,CACF,2016,GROSSMONT CUYAMACA COMMUNITY COLLEGE DISTRICT ,CHILD_SNACK_PM,22,85,4,49,138,196,9,113,318,14.4545
SAN DIEGO,Jul 2016,CACF,2016,GROSSMONT CUYAMACA COMMUNITY COLLEGE DISTRICT ,CHILD_BREAKFAST,20,85,4,49,138,125,6,72,203,10.15
SAN DIEGO,Jul 2016,CACF,2016,GROSSMONT CUYAMACA COMMUNITY COLLEGE DISTRICT ,CHILD_LUNCH,20,85,4,49,138,357,17,206,580,29
SAN DIEGO,Jul 2016,CACF,2016,GROSSMONT CUYAMACA COMMUNITY COLLEGE DISTRICT ,CHILD_SNACK_PM,20,85,4,49,138,115,5,67,187,9.35
SAN DIEGO,Oct 2015,CACF,2016,Grossmont Union High School District,ATRISK_CHILD_SUPPER,24,6960,0,0,6960,17805,0,0,17805,741.875
SAN DIEGO,Nov 2015,CACF,2016,Grossmont Union High School District,ATRISK_CHILD_SUPPER,15,1247,0,0,1247,12901,0,0,12901,860.0667
SAN DIEGO,Dec 2015,CACF,2016,Grossmont Union High School District,ATRISK_CHILD_SUPPER,16,962,0,0,962,10532,0,0,10532,658.25
SAN DIEGO,Jan 2016,CACF,2016,Grossmont Union High School District,ATRISK_CHILD_SUPPER,20,6960,0,0,6960,14493,0,0,14493,724.65
SAN DIEGO,Feb 2016,CACF,2016,Grossmont Union High School District,ATRISK_CHILD_SUPPER,23,6960,0,0,6960,15947,0,0,15947,693.3478
SAN DIEGO,Mar 2016,CACF,2016,Grossmont Union High School District,ATRISK_CHILD_SUPPER,21,6960,0,0,6960,14313,0,0,14313,681.5714
SAN DIEGO,Apr 2016,CACF,2016,Grossmont Union High School District,ATRISK_CHILD_SUPPER,26,1003,0,0,1003,18463,0,0,18463,710.1154
SAN DIEGO,May 2016,CACF,2016,Grossmont Union High School District,ATRISK_CHILD_SUPPER,24,6960,0,0,6960,18823,0,0,18823,784.2917
SAN DIEGO,Jun 2016,CACF,2016,Grossmont Union High School District,ATRISK_CHILD_SUPPER,12,10382,0,0,10382,7393,0,0,7393,616.0833
SAN DIEGO,Oct 2015,CACF,2016,GSCA INC ,CHILD_BREAKFAST,22,137,14,27,178,1674,171,330,2175,98.8636
SAN DIEGO,Oct 2015,CACF,2016,GSCA INC ,CHILD_LUNCH,22,137,14,27,178,2575,263,507,3345,152.0455
SAN DIEGO,Oct 2015,CACF,2016,GSCA INC ,CHILD_SNACK_AM,22,137,14,27,178,2566,262,506,3334,151.5455
SAN DIEGO,Oct 2015,CACF,2016,GSCA INC ,CHILD_SUPPER,22,137,14,27,178,837,86,165,1088,49.4545
SAN DIEGO,Nov 2015,CACF,2016,GSCA INC ,CHILD_BREAKFAST,19,137,14,27,178,1447,148,285,1880,98.9474
SAN DIEGO,Nov 2015,CACF,2016,GSCA INC ,CHILD_LUNCH,19,137,14,27,178,2203,225,434,2862,150.6316
SAN DIEGO,Nov 2015,CACF,2016,GSCA INC ,CHILD_SNACK_AM,19,137,14,27,178,2192,224,432,2848,149.8947
SAN DIEGO,Nov 2015,CACF,2016,GSCA INC ,CHILD_SUPPER,19,137,14,27,178,719,74,141,934,49.1579
SAN DIEGO,Dec 2015,CACF,2016,GSCA INC ,CHILD_BREAKFAST,21,137,14,27,178,1554,159,306,2019,96.1429
SAN DIEGO,Dec 2015,CACF,2016,GSCA INC ,CHILD_LUNCH,21,137,14,27,178,2456,251,484,3191,151.9524
SAN DIEGO,Dec 2015,CACF,2016,GSCA INC ,CHILD_SNACK_AM,21,137,14,27,178,2435,249,479,3163,150.619
SAN DIEGO,Dec 2015,CACF,2016,GSCA INC ,CHILD_SUPPER,21,137,14,27,178,804,82,159,1045,49.7619
SAN DIEGO,Jan 2016,CACF,2016,GSCA INC ,CHILD_BREAKFAST,20,137,14,27,178,1539,157,304,2000,100
SAN DIEGO,Jan 2016,CACF,2016,GSCA INC ,CHILD_LUNCH,20,137,14,27,178,2349,240,463,3052,152.6
SAN DIEGO,Jan 2016,CACF,2016,GSCA INC ,CHILD_SNACK_AM,20,137,14,27,178,2347,240,462,3049,152.45
SAN DIEGO,Jan 2016,CACF,2016,GSCA INC ,CHILD_SUPPER,20,137,14,27,178,772,79,152,1003,50.15
SAN DIEGO,Feb 2016,CACF,2016,GSCA INC ,CHILD_BREAKFAST,20,137,14,27,178,1455,149,286,1890,94.5
SAN DIEGO,Feb 2016,CACF,2016,GSCA INC ,CHILD_LUNCH,20,137,14,27,178,2351,240,464,3055,152.75
SAN DIEGO,Feb 2016,CACF,2016,GSCA INC ,CHILD_SNACK_AM,20,137,14,27,178,2336,239,460,3035,151.75
SAN DIEGO,Feb 2016,CACF,2016,GSCA INC ,CHILD_SUPPER,20,137,14,27,178,787,80,155,1022,51.1
SAN DIEGO,Mar 2016,CACF,2016,GSCA INC ,CHILD_BREAKFAST,23,137,14,27,178,1570,161,309,2040,88.6957
SAN DIEGO,Mar 2016,CACF,2016,GSCA INC ,CHILD_LUNCH,23,137,14,27,178,2694,275,531,3500,152.1739
SAN DIEGO,Mar 2016,CACF,2016,GSCA INC ,CHILD_SNACK_AM,23,137,14,27,178,2655,272,523,3450,150
SAN DIEGO,Mar 2016,CACF,2016,GSCA INC ,CHILD_SUPPER,23,137,14,27,178,885,91,174,1150,50
SAN DIEGO,Apr 2016,CACF,2016,GSCA INC ,CHILD_BREAKFAST,21,137,14,27,178,1516,155,299,1970,93.8095
SAN DIEGO,Apr 2016,CACF,2016,GSCA INC ,CHILD_LUNCH,21,137,14,27,178,2305,236,454,2995,142.619
SAN DIEGO,Apr 2016,CACF,2016,GSCA INC ,CHILD_SNACK_AM,21,137,14,27,178,2295,235,452,2982,142
SAN DIEGO,Apr 2016,CACF,2016,GSCA INC ,CHILD_SUPPER,21,137,14,27,178,667,68,131,866,41.2381
SAN DIEGO,May 2016,CACF,2016,GSCA INC ,CHILD_BREAKFAST,21,137,14,27,178,1507,154,297,1958,93.2381
SAN DIEGO,May 2016,CACF,2016,GSCA INC ,CHILD_LUNCH,21,137,14,27,178,2431,249,479,3159,150.4286
SAN DIEGO,May 2016,CACF,2016,GSCA INC ,CHILD_SNACK_AM,21,137,14,27,178,2420,247,477,3144,149.7143
SAN DIEGO,May 2016,CACF,2016,GSCA INC ,CHILD_SUPPER,21,137,14,27,178,798,82,157,1037,49.381
SAN DIEGO,Jun 2016,CACF,2016,GSCA INC ,CHILD_BREAKFAST,22,160,14,40,214,1609,141,402,2152,97.8182
SAN DIEGO,Jun 2016,CACF,2016,GSCA INC ,CHILD_LUNCH,22,160,14,40,214,2576,225,644,3445,156.5909
SAN DIEGO,Jun 2016,CACF,2016,GSCA INC ,CHILD_SNACK_AM,22,160,14,40,214,1460,128,365,1953,88.7727
SAN DIEGO,Jun 2016,CACF,2016,GSCA INC ,CHILD_SNACK_PM,22,160,14,40,214,1062,93,265,1420,64.5455
SAN DIEGO,Jun 2016,CACF,2016,GSCA INC ,CHILD_SUPPER,22,160,14,40,214,816,71,204,1091,49.5909
SAN DIEGO,Jun 2016,CACF,2016,GSCA INC ,OSCH_CHILD_BREAKFAST,3,14,0,3,17,12,0,2,14,4.6667
SAN DIEGO,Jun 2016,CACF,2016,GSCA INC ,OSCH_CHILD_LUNCH,3,14,0,3,17,13,0,3,16,5.3333
SAN DIEGO,Jun 2016,CACF,2016,GSCA INC ,OSCH_CHILD_SNACK_AM,3,14,0,3,17,13,0,3,16,5.3333
SAN DIEGO,Jul 2016,CACF,2016,GSCA INC ,CHILD_BREAKFAST,20,166,15,40,221,1767,160,426,2353,117.65
SAN DIEGO,Jul 2016,CACF,2016,GSCA INC ,CHILD_LUNCH,20,166,15,40,221,2719,246,655,3620,181
SAN DIEGO,Jul 2016,CACF,2016,GSCA INC ,CHILD_SNACK_AM,20,166,15,40,221,2682,242,647,3571,178.55
SAN DIEGO,Jul 2016,CACF,2016,GSCA INC ,CHILD_SUPPER,20,166,15,40,221,735,66,178,979,48.95
SAN DIEGO,Jul 2016,CACF,2016,GSCA INC ,OSCH_CHILD_BREAKFAST,20,14,0,3,17,98,0,21,119,5.95
SAN DIEGO,Jul 2016,CACF,2016,GSCA INC ,OSCH_CHILD_LUNCH,20,14,0,3,17,103,0,22,125,6.25
SAN DIEGO,Jul 2016,CACF,2016,GSCA INC ,OSCH_CHILD_SNACK_AM,20,14,0,3,17,99,0,21,120,6
SAN DIEGO,Oct 2015,CACF,2016,HAGAR & SHRYOCK,CHILD_BREAKFAST,22,23,11,22,56,314,150,301,765,34.7727
SAN DIEGO,Oct 2015,CACF,2016,HAGAR & SHRYOCK,CHILD_LUNCH,22,23,11,22,56,339,162,325,826,37.5455
SAN DIEGO,Oct 2015,CACF,2016,HAGAR & SHRYOCK,CHILD_SNACK_PM,22,23,11,22,56,399,191,381,971,44.1364
SAN DIEGO,Nov 2015,CACF,2016,HAGAR & SHRYOCK,CHILD_BREAKFAST,19,23,11,22,56,294,140,281,715,37.6316
SAN DIEGO,Nov 2015,CACF,2016,HAGAR & SHRYOCK,CHILD_LUNCH,19,23,11,22,56,320,153,305,778,40.9474
SAN DIEGO,Nov 2015,CACF,2016,HAGAR & SHRYOCK,CHILD_SNACK_PM,19,23,11,22,56,392,188,375,955,50.2632
SAN DIEGO,Dec 2015,CACF,2016,HAGAR & SHRYOCK,CHILD_BREAKFAST,21,23,11,22,56,311,149,297,757,36.0476
SAN DIEGO,Dec 2015,CACF,2016,HAGAR & SHRYOCK,CHILD_LUNCH,21,23,11,22,56,341,163,327,831,39.5714
SAN DIEGO,Dec 2015,CACF,2016,HAGAR & SHRYOCK,CHILD_SNACK_PM,21,23,11,22,56,379,181,364,924,44
SAN DIEGO,Jan 2016,CACF,2016,HAGAR & SHRYOCK,CHILD_BREAKFAST,20,23,11,22,56,308,147,295,750,37.5
SAN DIEGO,Jan 2016,CACF,2016,HAGAR & SHRYOCK,CHILD_LUNCH,20,23,11,22,56,339,162,325,826,41.3
SAN DIEGO,Jan 2016,CACF,2016,HAGAR & SHRYOCK,CHILD_SNACK_PM,20,23,11,22,56,375,180,359,914,45.7
SAN DIEGO,Feb 2016,CACF,2016,HAGAR & SHRYOCK,CHILD_BREAKFAST,21,23,11,22,56,346,165,331,842,40.0952
SAN DIEGO,Feb 2016,CACF,2016,HAGAR & SHRYOCK,CHILD_LUNCH,21,23,11,22,56,342,163,327,832,39.619
SAN DIEGO,Feb 2016,CACF,2016,HAGAR & SHRYOCK,CHILD_SNACK_PM,21,23,11,22,56,379,181,362,922,43.9048
SAN DIEGO,Mar 2016,CACF,2016,HAGAR & SHRYOCK,CHILD_BREAKFAST,23,23,11,22,56,371,177,355,903,39.2609
SAN DIEGO,Mar 2016,CACF,2016,HAGAR & SHRYOCK,CHILD_LUNCH,23,23,11,22,56,373,178,357,908,39.4783
SAN DIEGO,Mar 2016,CACF,2016,HAGAR & SHRYOCK,CHILD_SNACK_PM,23,23,11,22,56,410,196,392,998,43.3913
SAN DIEGO,Apr 2016,CACF,2016,HAGAR & SHRYOCK,CHILD_BREAKFAST,21,23,11,22,56,350,167,335,852,40.5714
SAN DIEGO,Apr 2016,CACF,2016,HAGAR & SHRYOCK,CHILD_LUNCH,21,23,11,22,56,352,168,336,856,40.7619
SAN DIEGO,Apr 2016,CACF,2016,HAGAR & SHRYOCK,CHILD_SNACK_PM,21,23,11,22,56,393,188,376,957,45.5714
SAN DIEGO,May 2016,CACF,2016,HAGAR & SHRYOCK,CHILD_BREAKFAST,21,23,11,22,56,334,160,320,814,38.7619
SAN DIEGO,May 2016,CACF,2016,HAGAR & SHRYOCK,CHILD_LUNCH,21,23,11,22,56,361,173,345,879,41.8571
SAN DIEGO,May 2016,CACF,2016,HAGAR & SHRYOCK,CHILD_SNACK_PM,21,23,11,22,56,404,193,387,984,46.8571
SAN DIEGO,Jun 2016,CACF,2016,HAGAR & SHRYOCK,CHILD_BREAKFAST,22,23,11,22,56,350,168,335,853,38.7727
SAN DIEGO,Jun 2016,CACF,2016,HAGAR & SHRYOCK,CHILD_LUNCH,22,23,11,22,56,353,169,338,860,39.0909
SAN DIEGO,Jun 2016,CACF,2016,HAGAR & SHRYOCK,CHILD_SNACK_PM,22,23,11,22,56,332,159,317,808,36.7273
SAN DIEGO,Jul 2016,CACF,2016,HAGAR & SHRYOCK,CHILD_BREAKFAST,20,23,11,22,56,323,155,309,787,39.35
SAN DIEGO,Jul 2016,CACF,2016,HAGAR & SHRYOCK,CHILD_LUNCH,20,23,11,22,56,326,156,312,794,39.7
SAN DIEGO,Jul 2016,CACF,2016,HAGAR & SHRYOCK,CHILD_SNACK_PM,20,23,11,22,56,304,145,291,740,37
SAN DIEGO,Oct 2015,CACF,2016,HEAVEN'S WINDOWS,ATRISK_CHILD_SNACK,17,315,0,0,315,1536,0,0,1536,90.3529
SAN DIEGO,Oct 2015,CACF,2016,HEAVEN'S WINDOWS,ATRISK_CHILD_SNACK_AM,17,315,0,0,315,290,0,0,290,17.0588
SAN DIEGO,Oct 2015,CACF,2016,HEAVEN'S WINDOWS,ATRISK_CHILD_SNACK_NT,17,315,0,0,315,468,0,0,468,27.5294
SAN DIEGO,Oct 2015,CACF,2016,HEAVEN'S WINDOWS,ATRISK_CHILD_SUPPER,17,315,0,0,315,977,0,0,977,57.4706
SAN DIEGO,Nov 2015,CACF,2016,HEAVEN'S WINDOWS,ATRISK_CHILD_SNACK,18,325,0,0,325,1568,0,0,1568,87.1111
SAN DIEGO,Nov 2015,CACF,2016,HEAVEN'S WINDOWS,ATRISK_CHILD_SNACK_AM,18,325,0,0,325,856,0,0,856,47.5556
SAN DIEGO,Nov 2015,CACF,2016,HEAVEN'S WINDOWS,ATRISK_CHILD_SNACK_NT,18,325,0,0,325,609,0,0,609,33.8333
SAN DIEGO,Nov 2015,CACF,2016,HEAVEN'S WINDOWS,ATRISK_CHILD_SUPPER,18,325,0,0,325,963,0,0,963,53.5
SAN DIEGO,Dec 2015,CACF,2016,HEAVEN'S WINDOWS,ATRISK_CHILD_SNACK,15,320,0,0,320,1299,0,0,1299,86.6
SAN DIEGO,Dec 2015,CACF,2016,HEAVEN'S WINDOWS,ATRISK_CHILD_SNACK_AM,15,320,0,0,320,376,0,0,376,25.0667
SAN DIEGO,Dec 2015,CACF,2016,HEAVEN'S WINDOWS,ATRISK_CHILD_SNACK_NT,15,320,0,0,320,501,0,0,501,33.4
SAN DIEGO,Dec 2015,CACF,2016,HEAVEN'S WINDOWS,ATRISK_CHILD_SUPPER,15,320,0,0,320,731,0,0,731,48.7333
SAN DIEGO,Jan 2016,CACF,2016,HEAVEN'S WINDOWS,ATRISK_CHILD_SNACK,21,500,0,0,500,1489,0,0,1489,70.9048
SAN DIEGO,Jan 2016,CACF,2016,HEAVEN'S WINDOWS,ATRISK_CHILD_SNACK_AM,21,500,0,0,500,1661,0,0,1661,79.0952
SAN DIEGO,Jan 2016,CACF,2016,HEAVEN'S WINDOWS,ATRISK_CHILD_SNACK_NT,21,500,0,0,500,700,0,0,700,33.3333
SAN DIEGO,Jan 2016,CACF,2016,HEAVEN'S WINDOWS,ATRISK_CHILD_SUPPER,21,500,0,0,500,1855,0,0,1855,88.3333
SAN DIEGO,Feb 2016,CACF,2016,HEAVEN'S WINDOWS,ATRISK_CHILD_SNACK,20,560,0,0,560,1930,0,0,1930,96.5
SAN DIEGO,Feb 2016,CACF,2016,HEAVEN'S WINDOWS,ATRISK_CHILD_SNACK_AM,20,560,0,0,560,1742,0,0,1742,87.1
SAN DIEGO,Feb 2016,CACF,2016,HEAVEN'S WINDOWS,ATRISK_CHILD_SUPPER,20,560,0,0,560,1859,0,0,1859,92.95
SAN DIEGO,Mar 2016,CACF,2016,HEAVEN'S WINDOWS,ATRISK_CHILD_SNACK,22,720,0,0,720,3707,0,0,3707,168.5
SAN DIEGO,Mar 2016,CACF,2016,HEAVEN'S WINDOWS,ATRISK_CHILD_SNACK_AM,22,720,0,0,720,2003,0,0,2003,91.0455
SAN DIEGO,Mar 2016,CACF,2016,HEAVEN'S WINDOWS,ATRISK_CHILD_SNACK_NT,22,720,0,0,720,197,0,0,197,8.9545
SAN DIEGO,Mar 2016,CACF,2016,HEAVEN'S WINDOWS,ATRISK_CHILD_SUPPER,22,720,0,0,720,1393,0,0,1393,63.3182
SAN DIEGO,Apr 2016,CACF,2016,HEAVEN'S WINDOWS,ATRISK_CHILD_SNACK,21,715,0,0,715,3871,0,0,3871,184.3333
SAN DIEGO,Apr 2016,CACF,2016,HEAVEN'S WINDOWS,ATRISK_CHILD_SNACK_AM,21,715,0,0,715,1794,0,0,1794,85.4286
SAN DIEGO,Apr 2016,CACF,2016,HEAVEN'S WINDOWS,ATRISK_CHILD_SNACK_NT,21,715,0,0,715,269,0,0,269,12.8095
SAN DIEGO,Apr 2016,CACF,2016,HEAVEN'S WINDOWS,ATRISK_CHILD_SUPPER,21,715,0,0,715,1585,0,0,1585,75.4762
SAN DIEGO,May 2016,CACF,2016,HEAVEN'S WINDOWS,ATRISK_CHILD_BREAKFAST,21,615,0,0,615,40,0,0,40,1.9048
SAN DIEGO,May 2016,CACF,2016,HEAVEN'S WINDOWS,ATRISK_CHILD_SNACK,21,615,0,0,615,3661,0,0,3661,174.3333
SAN DIEGO,May 2016,CACF,2016,HEAVEN'S WINDOWS,ATRISK_CHILD_SNACK_AM,21,615,0,0,615,1383,0,0,1383,65.8571
SAN DIEGO,May 2016,CACF,2016,HEAVEN'S WINDOWS,ATRISK_CHILD_SNACK_NT,21,615,0,0,615,369,0,0,369,17.5714
SAN DIEGO,May 2016,CACF,2016,HEAVEN'S WINDOWS,ATRISK_CHILD_SUPPER,21,615,0,0,615,1530,0,0,1530,72.8571
SAN DIEGO,Jun 2016,CACF,2016,HEAVEN'S WINDOWS,ATRISK_CHILD_BREAKFAST,13,615,0,0,615,71,0,0,71,5.4615
SAN DIEGO,Jun 2016,CACF,2016,HEAVEN'S WINDOWS,ATRISK_CHILD_SNACK,13,615,0,0,615,1998,0,0,1998,153.6923
SAN DIEGO,Jun 2016,CACF,2016,HEAVEN'S WINDOWS,ATRISK_CHILD_SNACK_AM,13,615,0,0,615,768,0,0,768,59.0769
SAN DIEGO,Jun 2016,CACF,2016,HEAVEN'S WINDOWS,ATRISK_CHILD_SNACK_NT,13,615,0,0,615,206,0,0,206,15.8462
SAN DIEGO,Jun 2016,CACF,2016,HEAVEN'S WINDOWS,ATRISK_CHILD_SUPPER,13,615,0,0,615,909,0,0,909,69.9231
SAN DIEGO,Oct 2015,CACF,2016,HIGHER LEARNING ACADEMY INC,CHILD_LUNCH,22,61,15,17,93,634,156,176,966,43.9091
SAN DIEGO,Oct 2015,CACF,2016,HIGHER LEARNING ACADEMY INC,CHILD_SNACK_AM,22,61,15,17,93,562,138,157,857,38.9545
SAN DIEGO,Oct 2015,CACF,2016,HIGHER LEARNING ACADEMY INC,CHILD_SUPPER,22,61,15,17,93,650,160,181,991,45.0455
SAN DIEGO,Nov 2015,CACF,2016,HIGHER LEARNING ACADEMY INC,CHILD_LUNCH,17,65,15,17,97,413,95,108,616,36.2353
SAN DIEGO,Nov 2015,CACF,2016,HIGHER LEARNING ACADEMY INC,CHILD_SNACK_AM,17,65,15,17,97,415,96,109,620,36.4706
SAN DIEGO,Nov 2015,CACF,2016,HIGHER LEARNING ACADEMY INC,CHILD_SUPPER,17,65,15,17,97,440,102,115,657,38.6471
SAN DIEGO,Dec 2015,CACF,2016,HIGHER LEARNING ACADEMY INC,CHILD_LUNCH,20,65,15,17,97,517,119,135,771,38.55
SAN DIEGO,Dec 2015,CACF,2016,HIGHER LEARNING ACADEMY INC,CHILD_SNACK_AM,20,65,15,17,97,523,121,136,780,39
SAN DIEGO,Dec 2015,CACF,2016,HIGHER LEARNING ACADEMY INC,CHILD_SUPPER,20,65,15,17,97,561,129,147,837,41.85
SAN DIEGO,Jan 2016,CACF,2016,HIGHER LEARNING ACADEMY INC,CHILD_LUNCH,19,65,15,17,97,485,112,127,724,38.1053
SAN DIEGO,Jan 2016,CACF,2016,HIGHER LEARNING ACADEMY INC,CHILD_SNACK_AM,19,65,15,17,97,497,115,129,741,39
SAN DIEGO,Jan 2016,CACF,2016,HIGHER LEARNING ACADEMY INC,CHILD_SUPPER,19,65,15,17,97,515,119,134,768,40.4211
SAN DIEGO,Feb 2016,CACF,2016,HIGHER LEARNING ACADEMY INC,CHILD_LUNCH,20,61,8,12,81,694,91,137,922,46.1
SAN DIEGO,Feb 2016,CACF,2016,HIGHER LEARNING ACADEMY INC,CHILD_SNACK_AM,20,61,8,12,81,763,100,150,1013,50.65
SAN DIEGO,Feb 2016,CACF,2016,HIGHER LEARNING ACADEMY INC,CHILD_SUPPER,20,61,8,12,81,797,105,156,1058,52.9
SAN DIEGO,Mar 2016,CACF,2016,HIGHER LEARNING ACADEMY INC,CHILD_LUNCH,23,61,8,12,81,847,111,167,1125,48.913
SAN DIEGO,Mar 2016,CACF,2016,HIGHER LEARNING ACADEMY INC,CHILD_SNACK_AM,23,61,8,12,81,852,112,167,1131,49.1739
SAN DIEGO,Mar 2016,CACF,2016,HIGHER LEARNING ACADEMY INC,CHILD_SUPPER,23,61,8,12,81,866,114,170,1150,50
SAN DIEGO,Apr 2016,CACF,2016,HIGHER LEARNING ACADEMY INC,CHILD_LUNCH,21,61,8,12,81,724,95,143,962,45.8095
SAN DIEGO,Apr 2016,CACF,2016,HIGHER LEARNING ACADEMY INC,CHILD_SNACK_AM,21,61,8,12,81,706,93,138,937,44.619
SAN DIEGO,Apr 2016,CACF,2016,HIGHER LEARNING ACADEMY INC,CHILD_SUPPER,21,61,8,12,81,810,106,159,1075,51.1905
SAN DIEGO,May 2016,CACF,2016,HIGHER LEARNING ACADEMY INC,CHILD_LUNCH,21,52,5,9,66,680,65,118,863,41.0952
SAN DIEGO,May 2016,CACF,2016,HIGHER LEARNING ACADEMY INC,CHILD_SNACK_AM,21,52,5,9,66,689,66,120,875,41.6667
SAN DIEGO,May 2016,CACF,2016,HIGHER LEARNING ACADEMY INC,CHILD_SUPPER,21,52,5,9,66,781,75,135,991,47.1905
SAN DIEGO,Jun 2016,CACF,2016,HIGHER LEARNING ACADEMY INC,CHILD_LUNCH,22,52,5,9,66,735,71,127,933,42.4091
SAN DIEGO,Jun 2016,CACF,2016,HIGHER LEARNING ACADEMY INC,CHILD_SNACK_AM,22,52,5,9,66,773,74,134,981,44.5909
SAN DIEGO,Jun 2016,CACF,2016,HIGHER LEARNING ACADEMY INC,CHILD_SUPPER,22,52,5,9,66,813,78,141,1032,46.9091
SAN DIEGO,Jul 2016,CACF,2016,HIGHER LEARNING ACADEMY INC,CHILD_LUNCH,20,52,5,9,66,879,85,151,1115,55.75
SAN DIEGO,Jul 2016,CACF,2016,HIGHER LEARNING ACADEMY INC,CHILD_SNACK_AM,20,52,5,9,66,667,64,115,846,42.3
SAN DIEGO,Jul 2016,CACF,2016,HIGHER LEARNING ACADEMY INC,CHILD_SUPPER,20,52,5,9,66,879,85,151,1115,55.75
SAN DIEGO,Oct 2015,CACF,2016,HORIZONS ADHC CENTER INC,ADULT_BREAKFAST,22,263,0,4,267,2853,0,43,2896,131.6364
SAN DIEGO,Oct 2015,CACF,2016,HORIZONS ADHC CENTER INC,ADULT_LUNCH,22,263,0,4,267,3203,0,49,3252,147.8182
SAN DIEGO,Oct 2015,CACF,2016,HORIZONS ADHC CENTER INC,ADULT_SNACK_AM,22,263,0,4,267,351,0,5,356,16.1818
SAN DIEGO,Oct 2015,CACF,2016,HORIZONS ADHC CENTER INC,ADULT_SNACK_PM,22,263,0,4,267,1290,0,20,1310,59.5455
SAN DIEGO,Nov 2015,CACF,2016,HORIZONS ADHC CENTER INC,ADULT_BREAKFAST,20,263,0,4,267,2452,0,37,2489,124.45
SAN DIEGO,Nov 2015,CACF,2016,HORIZONS ADHC CENTER INC,ADULT_LUNCH,20,263,0,4,267,2848,0,43,2891,144.55
SAN DIEGO,Nov 2015,CACF,2016,HORIZONS ADHC CENTER INC,ADULT_SNACK_AM,20,263,0,4,267,396,0,6,402,20.1
SAN DIEGO,Nov 2015,CACF,2016,HORIZONS ADHC CENTER INC,ADULT_SNACK_PM,20,263,0,4,267,1114,0,17,1131,56.55
SAN DIEGO,Dec 2015,CACF,2016,HORIZONS ADHC CENTER INC,ADULT_BREAKFAST,22,263,0,4,267,2735,0,42,2777,126.2273
SAN DIEGO,Dec 2015,CACF,2016,HORIZONS ADHC CENTER INC,ADULT_LUNCH,22,263,0,4,267,2940,0,45,2985,135.6818
SAN DIEGO,Dec 2015,CACF,2016,HORIZONS ADHC CENTER INC,ADULT_SNACK_AM,22,263,0,4,267,205,0,3,208,9.4545
SAN DIEGO,Dec 2015,CACF,2016,HORIZONS ADHC CENTER INC,ADULT_SNACK_PM,22,263,0,4,267,916,0,14,930,42.2727
SAN DIEGO,Jan 2016,CACF,2016,HORIZONS ADHC CENTER INC,ADULT_BREAKFAST,20,263,0,4,267,2429,0,37,2466,123.3
SAN DIEGO,Jan 2016,CACF,2016,HORIZONS ADHC CENTER INC,ADULT_LUNCH,20,263,0,4,267,2613,0,40,2653,132.65
SAN DIEGO,Jan 2016,CACF,2016,HORIZONS ADHC CENTER INC,ADULT_SNACK_AM,20,263,0,4,267,184,0,3,187,9.35
SAN DIEGO,Jan 2016,CACF,2016,HORIZONS ADHC CENTER INC,ADULT_SNACK_PM,20,263,0,4,267,830,0,13,843,42.15
SAN DIEGO,Feb 2016,CACF,2016,HORIZONS ADHC CENTER INC,ADULT_BREAKFAST,21,263,0,4,267,2627,0,40,2667,127
SAN DIEGO,Feb 2016,CACF,2016,HORIZONS ADHC CENTER INC,ADULT_LUNCH,21,263,0,4,267,2926,0,45,2971,141.4762
SAN DIEGO,Feb 2016,CACF,2016,HORIZONS ADHC CENTER INC,ADULT_SNACK_AM,21,263,0,4,267,299,0,5,304,14.4762
SAN DIEGO,Feb 2016,CACF,2016,HORIZONS ADHC CENTER INC,ADULT_SNACK_PM,21,263,0,4,267,976,0,15,991,47.1905
SAN DIEGO,Mar 2016,CACF,2016,HORIZONS ADHC CENTER INC,ADULT_BREAKFAST,23,263,0,4,267,2985,0,45,3030,131.7391
SAN DIEGO,Mar 2016,CACF,2016,HORIZONS ADHC CENTER INC,ADULT_LUNCH,23,263,0,4,267,3299,0,50,3349,145.6087
SAN DIEGO,Mar 2016,CACF,2016,HORIZONS ADHC CENTER INC,ADULT_SNACK_AM,23,263,0,4,267,314,0,5,319,13.8696
SAN DIEGO,Mar 2016,CACF,2016,HORIZONS ADHC CENTER INC,ADULT_SNACK_PM,23,263,0,4,267,1201,0,18,1219,53
SAN DIEGO,Apr 2016,CACF,2016,HORIZONS ADHC CENTER INC,ADULT_BREAKFAST,21,263,0,4,267,2619,0,40,2659,126.619
SAN DIEGO,Apr 2016,CACF,2016,HORIZONS ADHC CENTER INC,ADULT_LUNCH,21,263,0,4,267,3099,0,47,3146,149.8095
SAN DIEGO,Apr 2016,CACF,2016,HORIZONS ADHC CENTER INC,ADULT_SNACK_AM,21,263,0,4,267,480,0,7,487,23.1905
SAN DIEGO,Apr 2016,CACF,2016,HORIZONS ADHC CENTER INC,ADULT_SNACK_PM,21,263,0,4,267,1225,0,19,1244,59.2381
SAN DIEGO,May 2016,CACF,2016,HORIZONS ADHC CENTER INC,ADULT_BREAKFAST,22,263,0,4,267,2691,0,41,2732,124.1818
SAN DIEGO,May 2016,CACF,2016,HORIZONS ADHC CENTER INC,ADULT_LUNCH,22,263,0,4,267,3250,0,49,3299,149.9545
SAN DIEGO,May 2016,CACF,2016,HORIZONS ADHC CENTER INC,ADULT_SNACK_AM,22,263,0,4,267,558,0,9,567,25.7727
SAN DIEGO,May 2016,CACF,2016,HORIZONS ADHC CENTER INC,ADULT_SNACK_PM,22,263,0,4,267,1278,0,19,1297,58.9545
SAN DIEGO,Jun 2016,CACF,2016,HORIZONS ADHC CENTER INC,ADULT_BREAKFAST,22,263,0,4,267,3055,0,47,3102,141
SAN DIEGO,Jun 2016,CACF,2016,HORIZONS ADHC CENTER INC,ADULT_LUNCH,22,263,0,4,267,3412,0,52,3464,157.4545
SAN DIEGO,Jun 2016,CACF,2016,HORIZONS ADHC CENTER INC,ADULT_SNACK_AM,22,263,0,4,267,357,0,5,362,16.4545
SAN DIEGO,Jun 2016,CACF,2016,HORIZONS ADHC CENTER INC,ADULT_SNACK_PM,22,263,0,4,267,1280,0,19,1299,59.0455
SAN DIEGO,Jul 2016,CACF,2016,HORIZONS ADHC CENTER INC,ADULT_BREAKFAST,21,263,0,4,267,3054,0,46,3100,147.619
SAN DIEGO,Jul 2016,CACF,2016,HORIZONS ADHC CENTER INC,ADULT_LUNCH,21,263,0,4,267,3250,0,49,3299,157.0952
SAN DIEGO,Jul 2016,CACF,2016,HORIZONS ADHC CENTER INC,ADULT_SNACK_AM,21,263,0,4,267,196,0,3,199,9.4762
SAN DIEGO,Jul 2016,CACF,2016,HORIZONS ADHC CENTER INC,ADULT_SNACK_PM,21,263,0,4,267,1155,0,18,1173,55.8571
SAN DIEGO,Oct 2015,CACF,2016,J GELT CORPORATION CASA PACIFICA ADHC,ADULT_BREAKFAST,22,239,0,1,240,1530,0,6,1536,69.8182
SAN DIEGO,Oct 2015,CACF,2016,J GELT CORPORATION CASA PACIFICA ADHC,ADULT_LUNCH,22,239,0,1,240,3535,0,15,3550,161.3636
SAN DIEGO,Oct 2015,CACF,2016,J GELT CORPORATION CASA PACIFICA ADHC,ADULT_SNACK_AM,22,239,0,1,240,836,0,4,840,38.1818
SAN DIEGO,Oct 2015,CACF,2016,J GELT CORPORATION CASA PACIFICA ADHC,ADULT_SNACK_PM,22,239,0,1,240,1261,0,5,1266,57.5455
SAN DIEGO,Nov 2015,CACF,2016,J GELT CORPORATION CASA PACIFICA ADHC,ADULT_BREAKFAST,20,239,0,1,240,1376,0,6,1382,69.1
SAN DIEGO,Nov 2015,CACF,2016,J GELT CORPORATION CASA PACIFICA ADHC,ADULT_LUNCH,20,239,0,1,240,3158,0,13,3171,158.55
SAN DIEGO,Nov 2015,CACF,2016,J GELT CORPORATION CASA PACIFICA ADHC,ADULT_SNACK_AM,20,239,0,1,240,826,0,3,829,41.45
SAN DIEGO,Nov 2015,CACF,2016,J GELT CORPORATION CASA PACIFICA ADHC,ADULT_SNACK_PM,20,239,0,1,240,1098,0,5,1103,55.15
SAN DIEGO,Dec 2015,CACF,2016,J GELT CORPORATION CASA PACIFICA ADHC,ADULT_BREAKFAST,22,239,0,1,240,1652,0,7,1659,75.4091
SAN DIEGO,Dec 2015,CACF,2016,J GELT CORPORATION CASA PACIFICA ADHC,ADULT_LUNCH,22,239,0,1,240,3360,0,14,3374,153.3636
SAN DIEGO,Dec 2015,CACF,2016,J GELT CORPORATION CASA PACIFICA ADHC,ADULT_SNACK_AM,22,239,0,1,240,773,0,3,776,35.2727
SAN DIEGO,Dec 2015,CACF,2016,J GELT CORPORATION CASA PACIFICA ADHC,ADULT_SNACK_PM,22,239,0,1,240,1163,0,5,1168,53.0909
SAN DIEGO,Jan 2016,CACF,2016,J GELT CORPORATION CASA PACIFICA ADHC,ADULT_BREAKFAST,20,239,0,1,240,1443,0,6,1449,72.45
SAN DIEGO,Jan 2016,CACF,2016,J GELT CORPORATION CASA PACIFICA ADHC,ADULT_LUNCH,20,239,0,1,240,2884,0,12,2896,144.8
SAN DIEGO,Jan 2016,CACF,2016,J GELT CORPORATION CASA PACIFICA ADHC,ADULT_SNACK_AM,20,239,0,1,240,638,0,3,641,32.05
SAN DIEGO,Jan 2016,CACF,2016,J GELT CORPORATION CASA PACIFICA ADHC,ADULT_SNACK_PM,20,239,0,1,240,990,0,4,994,49.7
SAN DIEGO,Feb 2016,CACF,2016,J GELT CORPORATION CASA PACIFICA ADHC,ADULT_BREAKFAST,21,239,0,1,240,1640,0,7,1647,78.4286
SAN DIEGO,Feb 2016,CACF,2016,J GELT CORPORATION CASA PACIFICA ADHC,ADULT_LUNCH,21,239,0,1,240,3074,0,13,3087,147
SAN DIEGO,Feb 2016,CACF,2016,J GELT CORPORATION CASA PACIFICA ADHC,ADULT_SNACK_AM,21,239,0,1,240,542,0,2,544,25.9048
SAN DIEGO,Feb 2016,CACF,2016,J GELT CORPORATION CASA PACIFICA ADHC,ADULT_SNACK_PM,21,239,0,1,240,994,0,4,998,47.5238
SAN DIEGO,Mar 2016,CACF,2016,J GELT CORPORATION CASA PACIFICA ADHC,ADULT_BREAKFAST,23,239,0,1,240,1878,0,8,1886,82
SAN DIEGO,Mar 2016,CACF,2016,J GELT CORPORATION CASA PACIFICA ADHC,ADULT_LUNCH,23,239,0,1,240,3442,0,15,3457,150.3043
SAN DIEGO,Mar 2016,CACF,2016,J GELT CORPORATION CASA PACIFICA ADHC,ADULT_SNACK_AM,23,239,0,1,240,619,0,3,622,27.0435
SAN DIEGO,Mar 2016,CACF,2016,J GELT CORPORATION CASA PACIFICA ADHC,ADULT_SNACK_PM,23,239,0,1,240,1108,0,5,1113,48.3913
SAN DIEGO,Apr 2016,CACF,2016,J GELT CORPORATION CASA PACIFICA ADHC,ADULT_BREAKFAST,21,239,0,1,240,1905,0,8,1913,91.0952
SAN DIEGO,Apr 2016,CACF,2016,J GELT CORPORATION CASA PACIFICA ADHC,ADULT_LUNCH,21,239,0,1,240,3425,0,14,3439,163.7619
SAN DIEGO,Apr 2016,CACF,2016,J GELT CORPORATION CASA PACIFICA ADHC,ADULT_SNACK_AM,21,239,0,1,240,619,0,3,622,29.619
SAN DIEGO,Apr 2016,CACF,2016,J GELT CORPORATION CASA PACIFICA ADHC,ADULT_SNACK_PM,21,239,0,1,240,1016,0,4,1020,48.5714
SAN DIEGO,May 2016,CACF,2016,J GELT CORPORATION CASA PACIFICA ADHC,ADULT_BREAKFAST,21,239,0,1,240,1940,0,8,1948,92.7619
SAN DIEGO,May 2016,CACF,2016,J GELT CORPORATION CASA PACIFICA ADHC,ADULT_LUNCH,21,239,0,1,240,3417,0,14,3431,163.381
SAN DIEGO,May 2016,CACF,2016,J GELT CORPORATION CASA PACIFICA ADHC,ADULT_SNACK_AM,21,239,0,1,240,590,0,2,592,28.1905
SAN DIEGO,May 2016,CACF,2016,J GELT CORPORATION CASA PACIFICA ADHC,ADULT_SNACK_PM,21,239,0,1,240,1056,0,4,1060,50.4762
SAN DIEGO,Jun 2016,CACF,2016,J GELT CORPORATION CASA PACIFICA ADHC,ADULT_BREAKFAST,22,239,0,1,240,2178,0,9,2187,99.4091
SAN DIEGO,Jun 2016,CACF,2016,J GELT CORPORATION CASA PACIFICA ADHC,ADULT_LUNCH,22,239,0,1,240,3751,0,16,3767,171.2273
SAN DIEGO,Jun 2016,CACF,2016,J GELT CORPORATION CASA PACIFICA ADHC,ADULT_SNACK_AM,22,239,0,1,240,680,0,3,683,31.0455
SAN DIEGO,Jun 2016,CACF,2016,J GELT CORPORATION CASA PACIFICA ADHC,ADULT_SNACK_PM,22,239,0,1,240,1224,0,5,1229,55.8636
SAN DIEGO,Jul 2016,CACF,2016,J GELT CORPORATION CASA PACIFICA ADHC,ADULT_BREAKFAST,20,239,0,1,240,2018,0,9,2027,101.35
SAN DIEGO,Jul 2016,CACF,2016,J GELT CORPORATION CASA PACIFICA ADHC,ADULT_LUNCH,20,239,0,1,240,3447,0,15,3462,173.1
SAN DIEGO,Jul 2016,CACF,2016,J GELT CORPORATION CASA PACIFICA ADHC,ADULT_SNACK_AM,20,239,0,1,240,591,0,2,593,29.65
SAN DIEGO,Jul 2016,CACF,2016,J GELT CORPORATION CASA PACIFICA ADHC,ADULT_SNACK_PM,20,239,0,1,240,1075,0,5,1080,54
SAN DIEGO,Oct 2015,CACF,2016,Julian Union Elementary School District,ATRISK_CHILD_SNACK_NT,22,319,0,0,319,1412,0,0,1412,64.1818
SAN DIEGO,Oct 2015,CACF,2016,Julian Union Elementary School District,ATRISK_CHILD_SUPPER,22,319,0,0,319,1653,0,0,1653,75.1364
SAN DIEGO,Nov 2015,CACF,2016,Julian Union Elementary School District,ATRISK_CHILD_SNACK_NT,15,316,0,0,316,832,0,0,832,55.4667
SAN DIEGO,Nov 2015,CACF,2016,Julian Union Elementary School District,ATRISK_CHILD_SUPPER,15,316,0,0,316,1119,0,0,1119,74.6
SAN DIEGO,Dec 2015,CACF,2016,Julian Union Elementary School District,ATRISK_CHILD_SNACK_NT,14,317,0,0,317,798,0,0,798,57
SAN DIEGO,Dec 2015,CACF,2016,Julian Union Elementary School District,ATRISK_CHILD_SUPPER,14,317,0,0,317,956,0,0,956,68.2857
SAN DIEGO,Jan 2016,CACF,2016,Julian Union Elementary School District,ATRISK_CHILD_SNACK_NT,14,326,0,0,326,860,0,0,860,61.4286
SAN DIEGO,Jan 2016,CACF,2016,Julian Union Elementary School District,ATRISK_CHILD_SUPPER,14,326,0,0,326,1177,0,0,1177,84.0714
SAN DIEGO,Feb 2016,CACF,2016,Julian Union Elementary School District,ATRISK_CHILD_SNACK_NT,18,327,0,0,327,1142,0,0,1142,63.4444
SAN DIEGO,Feb 2016,CACF,2016,Julian Union Elementary School District,ATRISK_CHILD_SUPPER,18,327,0,0,327,1295,0,0,1295,71.9444
SAN DIEGO,Mar 2016,CACF,2016,Julian Union Elementary School District,ATRISK_CHILD_SNACK_NT,21,327,0,0,327,1223,0,0,1223,58.2381
SAN DIEGO,Mar 2016,CACF,2016,Julian Union Elementary School District,ATRISK_CHILD_SUPPER,21,327,0,0,327,1436,0,0,1436,68.381
SAN DIEGO,Apr 2016,CACF,2016,Julian Union Elementary School District,ATRISK_CHILD_SNACK_NT,16,336,0,0,336,834,0,0,834,52.125
SAN DIEGO,Apr 2016,CACF,2016,Julian Union Elementary School District,ATRISK_CHILD_SUPPER,16,336,0,0,336,1006,0,0,1006,62.875
SAN DIEGO,May 2016,CACF,2016,Julian Union Elementary School District,ATRISK_CHILD_SNACK_NT,21,348,0,0,348,1180,0,0,1180,56.1905
SAN DIEGO,May 2016,CACF,2016,Julian Union Elementary School District,ATRISK_CHILD_SUPPER,21,348,0,0,348,1003,0,0,1003,47.7619
SAN DIEGO,Jun 2016,CACF,2016,Julian Union Elementary School District,ATRISK_CHILD_SNACK_NT,3,328,0,0,328,94,0,0,94,31.3333
SAN DIEGO,Jun 2016,CACF,2016,Julian Union Elementary School District,ATRISK_CHILD_SUPPER,3,328,0,0,328,432,0,0,432,144
SAN DIEGO,Nov 2015,CACF,2016,KING CHAVEZ ACADEMY OF,CHILD_BREAKFAST,15,43,1,1,45,401,9,10,420,28
SAN DIEGO,Nov 2015,CACF,2016,KING CHAVEZ ACADEMY OF,CHILD_LUNCH,15,43,1,1,45,309,7,7,323,21.5333
SAN DIEGO,Nov 2015,CACF,2016,KING CHAVEZ ACADEMY OF,CHILD_SNACK_PM,15,43,1,1,45,235,5,6,246,16.4
SAN DIEGO,Dec 2015,CACF,2016,KING CHAVEZ ACADEMY OF,CHILD_BREAKFAST,17,43,1,1,45,405,9,10,424,24.9412
SAN DIEGO,Dec 2015,CACF,2016,KING CHAVEZ ACADEMY OF,CHILD_LUNCH,17,43,1,1,45,342,8,8,358,21.0588
SAN DIEGO,Dec 2015,CACF,2016,KING CHAVEZ ACADEMY OF,CHILD_SNACK_PM,17,43,1,1,45,265,6,6,277,16.2941
SAN DIEGO,Jan 2016,CACF,2016,KING CHAVEZ ACADEMY OF,CHILD_BREAKFAST,16,43,1,1,45,378,9,9,396,24.75
SAN DIEGO,Jan 2016,CACF,2016,KING CHAVEZ ACADEMY OF,CHILD_LUNCH,16,43,1,1,45,337,8,8,353,22.0625
SAN DIEGO,Jan 2016,CACF,2016,KING CHAVEZ ACADEMY OF,CHILD_SNACK_PM,16,43,1,1,45,291,7,6,304,19
SAN DIEGO,Feb 2016,CACF,2016,KING CHAVEZ ACADEMY OF,CHILD_BREAKFAST,20,43,1,1,45,454,11,10,475,23.75
SAN DIEGO,Feb 2016,CACF,2016,KING CHAVEZ ACADEMY OF,CHILD_LUNCH,20,43,1,1,45,406,9,10,425,21.25
SAN DIEGO,Feb 2016,CACF,2016,KING CHAVEZ ACADEMY OF,CHILD_SNACK_PM,20,43,1,1,45,355,8,8,371,18.55
SAN DIEGO,Mar 2016,CACF,2016,KING CHAVEZ ACADEMY OF,CHILD_BREAKFAST,22,43,1,1,45,463,11,11,485,22.0455
SAN DIEGO,Mar 2016,CACF,2016,KING CHAVEZ ACADEMY OF,CHILD_LUNCH,22,43,1,1,45,439,10,10,459,20.8636
SAN DIEGO,Mar 2016,CACF,2016,KING CHAVEZ ACADEMY OF,CHILD_SNACK_PM,22,43,1,1,45,372,9,8,389,17.6818
SAN DIEGO,Apr 2016,CACF,2016,KING CHAVEZ ACADEMY OF,CHILD_BREAKFAST,21,43,1,1,45,446,10,11,467,22.2381
SAN DIEGO,Apr 2016,CACF,2016,KING CHAVEZ ACADEMY OF,CHILD_LUNCH,21,43,1,1,45,406,9,10,425,20.2381
SAN DIEGO,Apr 2016,CACF,2016,KING CHAVEZ ACADEMY OF,CHILD_SNACK_PM,21,43,1,1,45,355,8,8,371,17.6667
SAN DIEGO,May 2016,CACF,2016,KING CHAVEZ ACADEMY OF,CHILD_BREAKFAST,21,43,1,1,45,445,10,11,466,22.1905
SAN DIEGO,May 2016,CACF,2016,KING CHAVEZ ACADEMY OF,CHILD_LUNCH,21,43,1,1,45,423,10,10,443,21.0952
SAN DIEGO,May 2016,CACF,2016,KING CHAVEZ ACADEMY OF,CHILD_SNACK_PM,21,43,1,1,45,272,6,7,285,13.5714
SAN DIEGO,Jun 2016,CACF,2016,KING CHAVEZ ACADEMY OF,CHILD_BREAKFAST,22,43,1,1,45,420,10,9,439,19.9545
SAN DIEGO,Jun 2016,CACF,2016,KING CHAVEZ ACADEMY OF,CHILD_LUNCH,22,43,1,1,45,437,10,10,457,20.7727
SAN DIEGO,Jun 2016,CACF,2016,KING CHAVEZ ACADEMY OF,CHILD_SNACK_PM,22,43,1,1,45,388,9,9,406,18.4545
SAN DIEGO,Jul 2016,CACF,2016,KING CHAVEZ ACADEMY OF,CHILD_BREAKFAST,20,43,1,1,45,306,7,7,320,16
SAN DIEGO,Jul 2016,CACF,2016,KING CHAVEZ ACADEMY OF,CHILD_LUNCH,20,43,1,1,45,264,6,6,276,13.8
SAN DIEGO,Jul 2016,CACF,2016,KING CHAVEZ ACADEMY OF,CHILD_SNACK_PM,20,43,1,1,45,240,6,5,251,12.55
SAN DIEGO,Oct 2015,CACF,2016,LA JOLLA BAND OF LUISENO,ATRISK_CHILD_SUPPER,17,40,0,0,40,432,0,0,432,25.4118
SAN DIEGO,Nov 2015,CACF,2016,LA JOLLA BAND OF LUISENO,ATRISK_CHILD_SUPPER,11,40,0,0,40,290,0,0,290,26.3636
SAN DIEGO,Jan 2016,CACF,2016,LA JOLLA BAND OF LUISENO,ATRISK_CHILD_SUPPER,15,40,0,0,40,395,0,0,395,26.3333
SAN DIEGO,Feb 2016,CACF,2016,LA JOLLA BAND OF LUISENO,ATRISK_CHILD_SUPPER,13,40,0,0,40,360,0,0,360,27.6923
SAN DIEGO,Mar 2016,CACF,2016,LA JOLLA BAND OF LUISENO,ATRISK_CHILD_SUPPER,19,40,0,0,40,385,0,0,385,20.2632
SAN DIEGO,Apr 2016,CACF,2016,LA JOLLA BAND OF LUISENO,ATRISK_CHILD_SUPPER,12,40,0,0,40,329,0,0,329,27.4167
SAN DIEGO,May 2016,CACF,2016,LA JOLLA BAND OF LUISENO,ATRISK_CHILD_SUPPER,17,40,0,0,40,456,0,0,456,26.8235
SAN DIEGO,Oct 2015,CACF,2016,La Mesa-Spring Valley School District,ATRISK_CHILD_SNACK,12,1230,0,0,1230,2160,0,0,2160,180
SAN DIEGO,Oct 2015,CACF,2016,La Mesa-Spring Valley School District,ATRISK_CHILD_SUPPER,12,1230,0,0,1230,10684,0,0,10684,890.3333
SAN DIEGO,Nov 2015,CACF,2016,La Mesa-Spring Valley School District,ATRISK_CHILD_SNACK,15,1230,0,0,1230,2625,0,0,2625,175
SAN DIEGO,Nov 2015,CACF,2016,La Mesa-Spring Valley School District,ATRISK_CHILD_SUPPER,15,1230,0,0,1230,13087,0,0,13087,872.4667
SAN DIEGO,Dec 2015,CACF,2016,La Mesa-Spring Valley School District,ATRISK_CHILD_SNACK,14,1230,0,0,1230,2440,0,0,2440,174.2857
SAN DIEGO,Dec 2015,CACF,2016,La Mesa-Spring Valley School District,ATRISK_CHILD_SUPPER,14,1230,0,0,1230,11865,0,0,11865,847.5
SAN DIEGO,Jan 2016,CACF,2016,La Mesa-Spring Valley School District,ATRISK_CHILD_SNACK,19,1338,0,0,1338,3356,0,0,3356,176.6316
SAN DIEGO,Jan 2016,CACF,2016,La Mesa-Spring Valley School District,ATRISK_CHILD_SUPPER,19,1338,0,0,1338,16042,0,0,16042,844.3158
SAN DIEGO,Feb 2016,CACF,2016,La Mesa-Spring Valley School District,ATRISK_CHILD_SNACK,19,1341,0,0,1341,3422,0,0,3422,180.1053
SAN DIEGO,Feb 2016,CACF,2016,La Mesa-Spring Valley School District,ATRISK_CHILD_SUPPER,19,1341,0,0,1341,15867,0,0,15867,835.1053
SAN DIEGO,Mar 2016,CACF,2016,La Mesa-Spring Valley School District,ATRISK_CHILD_SNACK,14,1355,0,0,1355,2984,0,0,2984,213.1429
SAN DIEGO,Mar 2016,CACF,2016,La Mesa-Spring Valley School District,ATRISK_CHILD_SUPPER,14,1355,0,0,1355,12149,0,0,12149,867.7857
SAN DIEGO,Apr 2016,CACF,2016,La Mesa-Spring Valley School District,ATRISK_CHILD_SNACK,20,1355,0,0,1355,3859,0,0,3859,192.95
SAN DIEGO,Apr 2016,CACF,2016,La Mesa-Spring Valley School District,ATRISK_CHILD_SUPPER,20,1355,0,0,1355,17396,0,0,17396,869.8
SAN DIEGO,May 2016,CACF,2016,La Mesa-Spring Valley School District,ATRISK_CHILD_SNACK,21,1358,0,0,1358,3900,0,0,3900,185.7143
SAN DIEGO,May 2016,CACF,2016,La Mesa-Spring Valley School District,ATRISK_CHILD_SUPPER,21,1358,0,0,1358,18154,0,0,18154,864.4762
SAN DIEGO,Jun 2016,CACF,2016,La Mesa-Spring Valley School District,ATRISK_CHILD_SNACK,13,1405,0,0,1405,3900,0,0,3900,300
SAN DIEGO,Jun 2016,CACF,2016,La Mesa-Spring Valley School District,ATRISK_CHILD_SUPPER,13,1405,0,0,1405,10346,0,0,10346,795.8462
SAN DIEGO,Oct 2015,CACF,2016,Lakeside Union Elementary School District,ATRISK_CHILD_SUPPER,22,663,0,0,663,10901,0,0,10901,495.5
SAN DIEGO,Nov 2015,CACF,2016,Lakeside Union Elementary School District,ATRISK_CHILD_SUPPER,15,696,0,0,696,7831,0,0,7831,522.0667
SAN DIEGO,Dec 2015,CACF,2016,Lakeside Union Elementary School District,ATRISK_CHILD_SUPPER,14,686,0,0,686,6627,0,0,6627,473.3571
SAN DIEGO,Jan 2016,CACF,2016,Lakeside Union Elementary School District,ATRISK_CHILD_SUPPER,18,655,0,0,655,8893,0,0,8893,494.0556
SAN DIEGO,Feb 2016,CACF,2016,Lakeside Union Elementary School District,ATRISK_CHILD_SUPPER,19,662,0,0,662,9340,0,0,9340,491.5789
SAN DIEGO,Mar 2016,CACF,2016,Lakeside Union Elementary School District,ATRISK_CHILD_SUPPER,14,672,0,0,672,6845,0,0,6845,488.9286
SAN DIEGO,Apr 2016,CACF,2016,Lakeside Union Elementary School District,ATRISK_CHILD_SUPPER,20,703,0,0,703,10000,0,0,10000,500
SAN DIEGO,May 2016,CACF,2016,Lakeside Union Elementary School District,ATRISK_CHILD_SUPPER,21,671,0,0,671,9943,0,0,9943,473.4762
SAN DIEGO,Jun 2016,CACF,2016,Lakeside Union Elementary School District,ATRISK_CHILD_SUPPER,16,590,0,0,590,6487,0,0,6487,405.4375
SAN DIEGO,Oct 2015,CACF,2016,Lemon Grove School District,ATRISK_CHILD_SUPPER,22,750,0,0,750,14848,0,0,14848,674.9091
SAN DIEGO,Nov 2015,CACF,2016,Lemon Grove School District,ATRISK_CHILD_SUPPER,15,755,0,0,755,9744,0,0,9744,649.6
SAN DIEGO,Dec 2015,CACF,2016,Lemon Grove School District,ATRISK_CHILD_SUPPER,14,755,0,0,755,8764,0,0,8764,626
SAN DIEGO,Jan 2016,CACF,2016,Lemon Grove School District,ATRISK_CHILD_SUPPER,19,755,0,0,755,12194,0,0,12194,641.7895
SAN DIEGO,Feb 2016,CACF,2016,Lemon Grove School District,ATRISK_CHILD_SUPPER,19,755,0,0,755,11526,0,0,11526,606.6316
SAN DIEGO,Mar 2016,CACF,2016,Lemon Grove School District,ATRISK_CHILD_SUPPER,14,755,0,0,755,8524,0,0,8524,608.8571
SAN DIEGO,Apr 2016,CACF,2016,Lemon Grove School District,ATRISK_CHILD_SUPPER,20,850,0,0,850,13249,0,0,13249,662.45
SAN DIEGO,May 2016,CACF,2016,Lemon Grove School District,ATRISK_CHILD_SUPPER,21,760,0,0,760,13116,0,0,13116,624.5714
SAN DIEGO,Jun 2016,CACF,2016,Lemon Grove School District,ATRISK_CHILD_SUPPER,6,760,0,0,760,3336,0,0,3336,556
SAN DIEGO,Oct 2015,CACF,2016,LIFEBRIDGE CHURCH,CHILD_LUNCH,22,0,0,125,125,0,0,1706,1706,77.5455
SAN DIEGO,Oct 2015,CACF,2016,LIFEBRIDGE CHURCH,CHILD_SNACK_AM,22,0,0,125,125,0,0,1785,1785,81.1364
SAN DIEGO,Oct 2015,CACF,2016,LIFEBRIDGE CHURCH,CHILD_SNACK_PM,22,0,0,125,125,0,0,1469,1469,66.7727
SAN DIEGO,Nov 2015,CACF,2016,LIFEBRIDGE CHURCH,CHILD_LUNCH,17,0,0,125,125,0,0,1327,1327,78.0588
SAN DIEGO,Nov 2015,CACF,2016,LIFEBRIDGE CHURCH,CHILD_SNACK_AM,17,0,0,125,125,0,0,1429,1429,84.0588
SAN DIEGO,Nov 2015,CACF,2016,LIFEBRIDGE CHURCH,CHILD_SNACK_PM,17,0,0,125,125,0,0,1183,1183,69.5882
SAN DIEGO,Dec 2015,CACF,2016,LIFEBRIDGE CHURCH,CHILD_LUNCH,14,0,0,125,125,0,0,1054,1054,75.2857
SAN DIEGO,Dec 2015,CACF,2016,LIFEBRIDGE CHURCH,CHILD_SNACK_AM,14,0,0,125,125,0,0,1110,1110,79.2857
SAN DIEGO,Dec 2015,CACF,2016,LIFEBRIDGE CHURCH,CHILD_SNACK_PM,14,0,0,125,125,0,0,935,935,66.7857
SAN DIEGO,Jan 2016,CACF,2016,LIFEBRIDGE CHURCH,CHILD_LUNCH,20,0,0,125,125,0,0,1726,1726,86.3
SAN DIEGO,Jan 2016,CACF,2016,LIFEBRIDGE CHURCH,CHILD_SNACK_AM,20,0,0,125,125,0,0,1786,1786,89.3
SAN DIEGO,Feb 2016,CACF,2016,LIFEBRIDGE CHURCH,CHILD_LUNCH,20,0,0,125,125,0,0,1655,1655,82.75
SAN DIEGO,Feb 2016,CACF,2016,LIFEBRIDGE CHURCH,CHILD_SNACK_AM,20,0,0,125,125,0,0,1756,1756,87.8
SAN DIEGO,Feb 2016,CACF,2016,LIFEBRIDGE CHURCH,CHILD_SNACK_PM,20,0,0,125,125,0,0,1442,1442,72.1
SAN DIEGO,Mar 2016,CACF,2016,LIFEBRIDGE CHURCH,CHILD_LUNCH,20,0,0,125,125,0,0,1753,1753,87.65
SAN DIEGO,Mar 2016,CACF,2016,LIFEBRIDGE CHURCH,CHILD_SNACK_AM,20,0,0,125,125,0,0,1831,1831,91.55
SAN DIEGO,Mar 2016,CACF,2016,LIFEBRIDGE CHURCH,CHILD_SNACK_PM,20,0,0,125,125,0,0,1530,1530,76.5
SAN DIEGO,Apr 2016,CACF,2016,LIFEBRIDGE CHURCH,CHILD_LUNCH,21,0,0,125,125,0,0,1722,1722,82
SAN DIEGO,Apr 2016,CACF,2016,LIFEBRIDGE CHURCH,CHILD_SNACK_AM,21,0,0,125,125,0,0,1813,1813,86.3333
SAN DIEGO,Apr 2016,CACF,2016,LIFEBRIDGE CHURCH,CHILD_SNACK_PM,21,0,0,125,125,0,0,1523,1523,72.5238
SAN DIEGO,May 2016,CACF,2016,LIFEBRIDGE CHURCH,CHILD_LUNCH,21,0,0,125,125,0,0,1818,1818,86.5714
SAN DIEGO,May 2016,CACF,2016,LIFEBRIDGE CHURCH,CHILD_SNACK_AM,21,0,0,125,125,0,0,1896,1896,90.2857
SAN DIEGO,May 2016,CACF,2016,LIFEBRIDGE CHURCH,CHILD_SNACK_PM,21,0,0,125,125,0,0,1587,1587,75.5714
SAN DIEGO,Jun 2016,CACF,2016,LIFEBRIDGE CHURCH,CHILD_LUNCH,21,0,0,125,125,0,0,1411,1411,67.1905
SAN DIEGO,Jun 2016,CACF,2016,LIFEBRIDGE CHURCH,CHILD_SNACK_AM,21,0,0,125,125,0,0,1459,1459,69.4762
SAN DIEGO,Jun 2016,CACF,2016,LIFEBRIDGE CHURCH,CHILD_SNACK_PM,21,0,0,125,125,0,0,1237,1237,58.9048
SAN DIEGO,Jul 2016,CACF,2016,LIFEBRIDGE CHURCH,CHILD_LUNCH,20,0,0,125,125,0,0,1138,1138,56.9
SAN DIEGO,Jul 2016,CACF,2016,LIFEBRIDGE CHURCH,CHILD_SNACK_AM,20,0,0,125,125,0,0,1191,1191,59.55
SAN DIEGO,Jul 2016,CACF,2016,LIFEBRIDGE CHURCH,CHILD_SNACK_PM,20,0,0,125,125,0,0,1021,1021,51.05
SAN DIEGO,Oct 2015,CACF,2016,LINERS CORP ,ADULT_BREAKFAST,22,122,0,4,126,1517,0,50,1567,71.2273
SAN DIEGO,Oct 2015,CACF,2016,LINERS CORP ,ADULT_LUNCH,22,122,0,4,126,1710,0,56,1766,80.2727
SAN DIEGO,Oct 2015,CACF,2016,LINERS CORP ,ADULT_SNACK_PM,22,122,0,4,126,873,0,29,902,41
SAN DIEGO,Nov 2015,CACF,2016,LINERS CORP ,ADULT_BREAKFAST,19,122,0,4,126,1291,0,42,1333,70.1579
SAN DIEGO,Nov 2015,CACF,2016,LINERS CORP ,ADULT_LUNCH,19,122,0,4,126,1511,0,49,1560,82.1053
SAN DIEGO,Nov 2015,CACF,2016,LINERS CORP ,ADULT_SNACK_PM,19,122,0,4,126,793,0,26,819,43.1053
SAN DIEGO,Dec 2015,CACF,2016,LINERS CORP ,ADULT_BREAKFAST,21,126,0,4,130,1398,0,44,1442,68.6667
SAN DIEGO,Dec 2015,CACF,2016,LINERS CORP ,ADULT_LUNCH,21,126,0,4,130,1576,0,50,1626,77.4286
SAN DIEGO,Dec 2015,CACF,2016,LINERS CORP ,ADULT_SNACK_PM,21,126,0,4,130,823,0,26,849,40.4286
SAN DIEGO,Jan 2016,CACF,2016,LINERS CORP ,ADULT_BREAKFAST,20,115,0,5,120,1286,0,56,1342,67.1
SAN DIEGO,Jan 2016,CACF,2016,LINERS CORP ,ADULT_LUNCH,20,115,0,5,120,1497,0,65,1562,78.1
SAN DIEGO,Jan 2016,CACF,2016,LINERS CORP ,ADULT_SNACK_PM,20,115,0,5,120,644,0,28,672,33.6
SAN DIEGO,Feb 2016,CACF,2016,LINERS CORP ,ADULT_BREAKFAST,21,117,0,6,123,1476,0,76,1552,73.9048
SAN DIEGO,Feb 2016,CACF,2016,LINERS CORP ,ADULT_LUNCH,21,117,0,6,123,1654,0,85,1739,82.8095
SAN DIEGO,Feb 2016,CACF,2016,LINERS CORP ,ADULT_SNACK_PM,21,117,0,6,123,721,0,37,758,36.0952
SAN DIEGO,Mar 2016,CACF,2016,LINERS CORP ,ADULT_BREAKFAST,23,122,0,1,123,1323,0,11,1334,58
SAN DIEGO,Mar 2016,CACF,2016,LINERS CORP ,ADULT_LUNCH,23,122,0,1,123,1802,0,15,1817,79
SAN DIEGO,Mar 2016,CACF,2016,LINERS CORP ,ADULT_SNACK_PM,23,122,0,1,123,1100,0,9,1109,48.2174
SAN DIEGO,Apr 2016,CACF,2016,LINERS CORP ,ADULT_BREAKFAST,21,122,0,1,123,1332,0,11,1343,63.9524
SAN DIEGO,Apr 2016,CACF,2016,LINERS CORP ,ADULT_LUNCH,21,122,0,1,123,1651,0,13,1664,79.2381
SAN DIEGO,Apr 2016,CACF,2016,LINERS CORP ,ADULT_SNACK_PM,21,122,0,1,123,774,0,6,780,37.1429
SAN DIEGO,May 2016,CACF,2016,LINERS CORP ,ADULT_BREAKFAST,21,122,0,1,123,1286,0,11,1297,61.7619
SAN DIEGO,May 2016,CACF,2016,LINERS CORP ,ADULT_LUNCH,21,122,0,1,123,1633,0,13,1646,78.381
SAN DIEGO,May 2016,CACF,2016,LINERS CORP ,ADULT_SNACK_AM,21,122,0,1,123,372,0,3,375,17.8571
SAN DIEGO,May 2016,CACF,2016,LINERS CORP ,ADULT_SNACK_PM,21,122,0,1,123,716,0,6,722,34.381
SAN DIEGO,Jun 2016,CACF,2016,LINERS CORP ,ADULT_BREAKFAST,22,122,0,1,123,1507,0,12,1519,69.0455
SAN DIEGO,Jun 2016,CACF,2016,LINERS CORP ,ADULT_LUNCH,22,122,0,1,123,1757,0,14,1771,80.5
SAN DIEGO,Jun 2016,CACF,2016,LINERS CORP ,ADULT_SNACK_AM,22,122,0,1,123,263,0,2,265,12.0455
SAN DIEGO,Jun 2016,CACF,2016,LINERS CORP ,ADULT_SNACK_PM,22,122,0,1,123,821,0,7,828,37.6364
SAN DIEGO,Jul 2016,CACF,2016,LINERS CORP ,ADULT_BREAKFAST,20,122,0,1,123,1336,0,11,1347,67.35
SAN DIEGO,Jul 2016,CACF,2016,LINERS CORP ,ADULT_LUNCH,20,122,0,1,123,1591,0,13,1604,80.2
SAN DIEGO,Jul 2016,CACF,2016,LINERS CORP ,ADULT_SNACK_AM,20,122,0,1,123,236,0,2,238,11.9
SAN DIEGO,Jul 2016,CACF,2016,LINERS CORP ,ADULT_SNACK_PM,20,122,0,1,123,749,0,6,755,37.75
SAN DIEGO,Oct 2015,CACF,2016,LOVING CARE ADHC LIMITED ,ADULT_BREAKFAST,22,139,0,1,140,1400,0,10,1410,64.0909
SAN DIEGO,Oct 2015,CACF,2016,LOVING CARE ADHC LIMITED ,ADULT_LUNCH,22,139,0,1,140,1400,0,10,1410,64.0909
SAN DIEGO,Oct 2015,CACF,2016,LOVING CARE ADHC LIMITED ,ADULT_SNACK_AM,22,139,0,1,140,1400,0,10,1410,64.0909
SAN DIEGO,Nov 2015,CACF,2016,LOVING CARE ADHC LIMITED ,ADULT_BREAKFAST,21,139,0,1,140,1483,0,11,1494,71.1429
SAN DIEGO,Nov 2015,CACF,2016,LOVING CARE ADHC LIMITED ,ADULT_LUNCH,21,139,0,1,140,1482,0,11,1493,71.0952
SAN DIEGO,Nov 2015,CACF,2016,LOVING CARE ADHC LIMITED ,ADULT_SNACK_AM,21,139,0,1,140,1483,0,11,1494,71.1429
SAN DIEGO,Dec 2015,CACF,2016,LOVING CARE ADHC LIMITED ,ADULT_BREAKFAST,22,139,0,1,140,1592,0,11,1603,72.8636
SAN DIEGO,Dec 2015,CACF,2016,LOVING CARE ADHC LIMITED ,ADULT_LUNCH,22,139,0,1,140,1591,0,11,1602,72.8182
SAN DIEGO,Dec 2015,CACF,2016,LOVING CARE ADHC LIMITED ,ADULT_SNACK_AM,22,139,0,1,140,1592,0,11,1603,72.8636
SAN DIEGO,Jan 2016,CACF,2016,LOVING CARE ADHC LIMITED ,ADULT_BREAKFAST,20,139,0,1,140,1431,0,10,1441,72.05
SAN DIEGO,Jan 2016,CACF,2016,LOVING CARE ADHC LIMITED ,ADULT_LUNCH,20,139,0,1,140,1430,0,10,1440,72
SAN DIEGO,Jan 2016,CACF,2016,LOVING CARE ADHC LIMITED ,ADULT_SNACK_AM,20,139,0,1,140,1431,0,10,1441,72.05
SAN DIEGO,Feb 2016,CACF,2016,LOVING CARE ADHC LIMITED ,ADULT_BREAKFAST,21,139,0,1,140,1512,0,11,1523,72.5238
SAN DIEGO,Feb 2016,CACF,2016,LOVING CARE ADHC LIMITED ,ADULT_LUNCH,21,139,0,1,140,1511,0,11,1522,72.4762
SAN DIEGO,Feb 2016,CACF,2016,LOVING CARE ADHC LIMITED ,ADULT_SNACK_AM,21,139,0,1,140,1513,0,11,1524,72.5714
SAN DIEGO,Mar 2016,CACF,2016,LOVING CARE ADHC LIMITED ,ADULT_BREAKFAST,23,139,0,1,140,1513,0,11,1524,66.2609
SAN DIEGO,Mar 2016,CACF,2016,LOVING CARE ADHC LIMITED ,ADULT_LUNCH,23,139,0,1,140,1510,0,11,1521,66.1304
SAN DIEGO,Mar 2016,CACF,2016,LOVING CARE ADHC LIMITED ,ADULT_SNACK_AM,23,139,0,1,140,1510,0,11,1521,66.1304
SAN DIEGO,Apr 2016,CACF,2016,LOVING CARE ADHC LIMITED ,ADULT_BREAKFAST,21,139,0,1,140,1361,0,10,1371,65.2857
SAN DIEGO,Apr 2016,CACF,2016,LOVING CARE ADHC LIMITED ,ADULT_LUNCH,21,139,0,1,140,1360,0,10,1370,65.2381
SAN DIEGO,Apr 2016,CACF,2016,LOVING CARE ADHC LIMITED ,ADULT_SNACK_AM,21,139,0,1,140,1361,0,10,1371,65.2857
SAN DIEGO,May 2016,CACF,2016,LOVING CARE ADHC LIMITED ,ADULT_BREAKFAST,22,139,0,1,140,1408,0,10,1418,64.4545
SAN DIEGO,May 2016,CACF,2016,LOVING CARE ADHC LIMITED ,ADULT_LUNCH,22,139,0,1,140,1408,0,10,1418,64.4545
SAN DIEGO,May 2016,CACF,2016,LOVING CARE ADHC LIMITED ,ADULT_SNACK_AM,22,139,0,1,140,1408,0,10,1418,64.4545
SAN DIEGO,Jun 2016,CACF,2016,LOVING CARE ADHC LIMITED ,ADULT_BREAKFAST,22,139,0,1,140,1415,0,10,1425,64.7727
SAN DIEGO,Jun 2016,CACF,2016,LOVING CARE ADHC LIMITED ,ADULT_LUNCH,22,139,0,1,140,1413,0,10,1423,64.6818
SAN DIEGO,Jun 2016,CACF,2016,LOVING CARE ADHC LIMITED ,ADULT_SNACK_AM,22,139,0,1,140,1413,0,10,1423,64.6818
SAN DIEGO,Jul 2016,CACF,2016,LOVING CARE ADHC LIMITED ,ADULT_BREAKFAST,21,139,0,1,140,1323,0,9,1332,63.4286
SAN DIEGO,Jul 2016,CACF,2016,LOVING CARE ADHC LIMITED ,ADULT_LUNCH,21,139,0,1,140,1322,0,9,1331,63.381
SAN DIEGO,Jul 2016,CACF,2016,LOVING CARE ADHC LIMITED ,ADULT_SNACK_AM,21,139,0,1,140,1322,0,9,1331,63.381
SAN DIEGO,Oct 2015,CACF,2016,MARANGELYS KIDS INC KIDDIE ACADEMY CHILD CARE CTR,CHILD_BREAKFAST,22,58,8,31,97,752,104,402,1258,57.1818
SAN DIEGO,Oct 2015,CACF,2016,MARANGELYS KIDS INC KIDDIE ACADEMY CHILD CARE CTR,CHILD_LUNCH,22,58,8,31,97,912,126,487,1525,69.3182
SAN DIEGO,Oct 2015,CACF,2016,MARANGELYS KIDS INC KIDDIE ACADEMY CHILD CARE CTR,CHILD_SNACK_PM,22,58,8,31,97,799,110,428,1337,60.7727
SAN DIEGO,Oct 2015,CACF,2016,MARANGELYS KIDS INC KIDDIE ACADEMY CHILD CARE CTR,OSCH_CHILD_BREAKFAST,22,83,5,20,108,832,50,200,1082,49.1818
SAN DIEGO,Oct 2015,CACF,2016,MARANGELYS KIDS INC KIDDIE ACADEMY CHILD CARE CTR,OSCH_CHILD_LUNCH,22,83,5,20,108,182,11,44,237,10.7727
SAN DIEGO,Oct 2015,CACF,2016,MARANGELYS KIDS INC KIDDIE ACADEMY CHILD CARE CTR,OSCH_CHILD_SNACK_PM,22,83,5,20,108,1228,74,296,1598,72.6364
SAN DIEGO,Nov 2015,CACF,2016,MARANGELYS KIDS INC KIDDIE ACADEMY CHILD CARE CTR,CHILD_BREAKFAST,20,58,8,31,97,610,84,326,1020,51
SAN DIEGO,Nov 2015,CACF,2016,MARANGELYS KIDS INC KIDDIE ACADEMY CHILD CARE CTR,CHILD_LUNCH,20,58,8,31,97,765,106,408,1279,63.95
SAN DIEGO,Nov 2015,CACF,2016,MARANGELYS KIDS INC KIDDIE ACADEMY CHILD CARE CTR,CHILD_SNACK_PM,20,58,8,31,97,679,94,363,1136,56.8
SAN DIEGO,Nov 2015,CACF,2016,MARANGELYS KIDS INC KIDDIE ACADEMY CHILD CARE CTR,OSCH_CHILD_BREAKFAST,20,83,5,20,108,652,39,158,849,42.45
SAN DIEGO,Nov 2015,CACF,2016,MARANGELYS KIDS INC KIDDIE ACADEMY CHILD CARE CTR,OSCH_CHILD_LUNCH,20,83,5,20,108,289,17,70,376,18.8
SAN DIEGO,Nov 2015,CACF,2016,MARANGELYS KIDS INC KIDDIE ACADEMY CHILD CARE CTR,OSCH_CHILD_SNACK_PM,20,83,5,20,108,941,57,227,1225,61.25
SAN DIEGO,Dec 2015,CACF,2016,MARANGELYS KIDS INC KIDDIE ACADEMY CHILD CARE CTR,CHILD_BREAKFAST,22,58,8,31,97,601,83,321,1005,45.6818
SAN DIEGO,Dec 2015,CACF,2016,MARANGELYS KIDS INC KIDDIE ACADEMY CHILD CARE CTR,CHILD_LUNCH,22,58,8,31,97,761,105,406,1272,57.8182
SAN DIEGO,Dec 2015,CACF,2016,MARANGELYS KIDS INC KIDDIE ACADEMY CHILD CARE CTR,CHILD_SNACK_PM,22,58,8,31,97,660,91,353,1104,50.1818
SAN DIEGO,Dec 2015,CACF,2016,MARANGELYS KIDS INC KIDDIE ACADEMY CHILD CARE CTR,OSCH_CHILD_BREAKFAST,22,83,5,20,108,573,35,138,746,33.9091
SAN DIEGO,Dec 2015,CACF,2016,MARANGELYS KIDS INC KIDDIE ACADEMY CHILD CARE CTR,OSCH_CHILD_LUNCH,22,83,5,20,108,354,21,86,461,20.9545
SAN DIEGO,Dec 2015,CACF,2016,MARANGELYS KIDS INC KIDDIE ACADEMY CHILD CARE CTR,OSCH_CHILD_SNACK_PM,22,83,5,20,108,928,56,224,1208,54.9091
SAN DIEGO,Jan 2016,CACF,2016,MARANGELYS KIDS INC KIDDIE ACADEMY CHILD CARE CTR,CHILD_BREAKFAST,20,58,8,31,97,660,91,353,1104,55.2
SAN DIEGO,Jan 2016,CACF,2016,MARANGELYS KIDS INC KIDDIE ACADEMY CHILD CARE CTR,CHILD_LUNCH,20,58,8,31,97,823,114,439,1376,68.8
SAN DIEGO,Jan 2016,CACF,2016,MARANGELYS KIDS INC KIDDIE ACADEMY CHILD CARE CTR,CHILD_SNACK_PM,20,58,8,31,97,704,97,377,1178,58.9
SAN DIEGO,Jan 2016,CACF,2016,MARANGELYS KIDS INC KIDDIE ACADEMY CHILD CARE CTR,OSCH_CHILD_BREAKFAST,20,83,5,20,108,575,35,138,748,37.4
SAN DIEGO,Jan 2016,CACF,2016,MARANGELYS KIDS INC KIDDIE ACADEMY CHILD CARE CTR,OSCH_CHILD_LUNCH,20,83,5,20,108,164,10,39,213,10.65
SAN DIEGO,Jan 2016,CACF,2016,MARANGELYS KIDS INC KIDDIE ACADEMY CHILD CARE CTR,OSCH_CHILD_SNACK_PM,20,83,5,20,108,971,59,234,1264,63.2
SAN DIEGO,Feb 2016,CACF,2016,MARANGELYS KIDS INC KIDDIE ACADEMY CHILD CARE CTR,CHILD_BREAKFAST,21,58,8,31,97,769,106,412,1287,61.2857
SAN DIEGO,Feb 2016,CACF,2016,MARANGELYS KIDS INC KIDDIE ACADEMY CHILD CARE CTR,CHILD_LUNCH,21,58,8,31,97,938,129,501,1568,74.6667
SAN DIEGO,Feb 2016,CACF,2016,MARANGELYS KIDS INC KIDDIE ACADEMY CHILD CARE CTR,CHILD_SNACK_PM,21,58,8,31,97,835,115,447,1397,66.5238
SAN DIEGO,Feb 2016,CACF,2016,MARANGELYS KIDS INC KIDDIE ACADEMY CHILD CARE CTR,OSCH_CHILD_BREAKFAST,21,83,5,20,108,691,42,166,899,42.8095
SAN DIEGO,Feb 2016,CACF,2016,MARANGELYS KIDS INC KIDDIE ACADEMY CHILD CARE CTR,OSCH_CHILD_LUNCH,21,83,5,20,108,360,22,86,468,22.2857
SAN DIEGO,Feb 2016,CACF,2016,MARANGELYS KIDS INC KIDDIE ACADEMY CHILD CARE CTR,OSCH_CHILD_SNACK_PM,21,83,5,20,108,1061,64,255,1380,65.7143
SAN DIEGO,Mar 2016,CACF,2016,MARANGELYS KIDS INC KIDDIE ACADEMY CHILD CARE CTR,CHILD_BREAKFAST,23,58,8,31,97,875,121,467,1463,63.6087
SAN DIEGO,Mar 2016,CACF,2016,MARANGELYS KIDS INC KIDDIE ACADEMY CHILD CARE CTR,CHILD_LUNCH,23,58,8,31,97,1072,148,573,1793,77.9565
SAN DIEGO,Mar 2016,CACF,2016,MARANGELYS KIDS INC KIDDIE ACADEMY CHILD CARE CTR,CHILD_SNACK_PM,23,58,8,31,97,982,135,525,1642,71.3913
SAN DIEGO,Mar 2016,CACF,2016,MARANGELYS KIDS INC KIDDIE ACADEMY CHILD CARE CTR,OSCH_CHILD_BREAKFAST,23,83,5,20,108,666,40,160,866,37.6522
SAN DIEGO,Mar 2016,CACF,2016,MARANGELYS KIDS INC KIDDIE ACADEMY CHILD CARE CTR,OSCH_CHILD_LUNCH,23,83,5,20,108,151,9,36,196,8.5217
SAN DIEGO,Mar 2016,CACF,2016,MARANGELYS KIDS INC KIDDIE ACADEMY CHILD CARE CTR,OSCH_CHILD_SNACK_PM,23,83,5,20,108,1192,72,287,1551,67.4348
SAN DIEGO,Apr 2016,CACF,2016,MARANGELYS KIDS INC KIDDIE ACADEMY CHILD CARE CTR,CHILD_BREAKFAST,21,58,8,31,97,838,116,447,1401,66.7143
SAN DIEGO,Apr 2016,CACF,2016,MARANGELYS KIDS INC KIDDIE ACADEMY CHILD CARE CTR,CHILD_LUNCH,21,58,8,31,97,998,138,533,1669,79.4762
SAN DIEGO,Apr 2016,CACF,2016,MARANGELYS KIDS INC KIDDIE ACADEMY CHILD CARE CTR,CHILD_SNACK_PM,21,58,8,31,97,914,126,488,1528,72.7619
SAN DIEGO,Apr 2016,CACF,2016,MARANGELYS KIDS INC KIDDIE ACADEMY CHILD CARE CTR,OSCH_CHILD_BREAKFAST,21,83,5,20,108,624,38,150,812,38.6667
SAN DIEGO,Apr 2016,CACF,2016,MARANGELYS KIDS INC KIDDIE ACADEMY CHILD CARE CTR,OSCH_CHILD_LUNCH,21,83,5,20,108,261,16,62,339,16.1429
SAN DIEGO,Apr 2016,CACF,2016,MARANGELYS KIDS INC KIDDIE ACADEMY CHILD CARE CTR,OSCH_CHILD_SNACK_PM,21,83,5,20,108,977,59,235,1271,60.5238
SAN DIEGO,May 2016,CACF,2016,MARANGELYS KIDS INC KIDDIE ACADEMY CHILD CARE CTR,CHILD_BREAKFAST,21,58,8,31,97,846,117,452,1415,67.381
SAN DIEGO,May 2016,CACF,2016,MARANGELYS KIDS INC KIDDIE ACADEMY CHILD CARE CTR,CHILD_LUNCH,21,58,8,31,97,1009,139,539,1687,80.3333
SAN DIEGO,May 2016,CACF,2016,MARANGELYS KIDS INC KIDDIE ACADEMY CHILD CARE CTR,CHILD_SNACK_PM,21,58,8,31,97,925,128,494,1547,73.6667
SAN DIEGO,May 2016,CACF,2016,MARANGELYS KIDS INC KIDDIE ACADEMY CHILD CARE CTR,OSCH_CHILD_BREAKFAST,21,83,5,20,108,593,36,142,771,36.7143
SAN DIEGO,May 2016,CACF,2016,MARANGELYS KIDS INC KIDDIE ACADEMY CHILD CARE CTR,OSCH_CHILD_LUNCH,21,83,5,20,108,145,9,35,189,9
SAN DIEGO,May 2016,CACF,2016,MARANGELYS KIDS INC KIDDIE ACADEMY CHILD CARE CTR,OSCH_CHILD_SNACK_PM,21,83,5,20,108,1023,62,246,1331,63.381
SAN DIEGO,Jun 2016,CACF,2016,MARANGELYS KIDS INC KIDDIE ACADEMY CHILD CARE CTR,CHILD_BREAKFAST,22,58,8,31,97,824,114,440,1378,62.6364
SAN DIEGO,Jun 2016,CACF,2016,MARANGELYS KIDS INC KIDDIE ACADEMY CHILD CARE CTR,CHILD_LUNCH,22,58,8,31,97,1007,139,539,1685,76.5909
SAN DIEGO,Jun 2016,CACF,2016,MARANGELYS KIDS INC KIDDIE ACADEMY CHILD CARE CTR,CHILD_SNACK_PM,22,58,8,31,97,932,129,497,1558,70.8182
SAN DIEGO,Jun 2016,CACF,2016,MARANGELYS KIDS INC KIDDIE ACADEMY CHILD CARE CTR,OSCH_CHILD_BREAKFAST,22,83,5,20,108,818,49,197,1064,48.3636
SAN DIEGO,Jun 2016,CACF,2016,MARANGELYS KIDS INC KIDDIE ACADEMY CHILD CARE CTR,OSCH_CHILD_LUNCH,22,83,5,20,108,748,45,180,973,44.2273
SAN DIEGO,Jun 2016,CACF,2016,MARANGELYS KIDS INC KIDDIE ACADEMY CHILD CARE CTR,OSCH_CHILD_SNACK_PM,22,83,5,20,108,940,57,226,1223,55.5909
SAN DIEGO,Jul 2016,CACF,2016,MARANGELYS KIDS INC KIDDIE ACADEMY CHILD CARE CTR,CHILD_BREAKFAST,20,58,8,31,97,764,105,409,1278,63.9
SAN DIEGO,Jul 2016,CACF,2016,MARANGELYS KIDS INC KIDDIE ACADEMY CHILD CARE CTR,CHILD_LUNCH,20,58,8,31,97,902,124,483,1509,75.45
SAN DIEGO,Jul 2016,CACF,2016,MARANGELYS KIDS INC KIDDIE ACADEMY CHILD CARE CTR,CHILD_SNACK_PM,20,58,8,31,97,811,112,433,1356,67.8
SAN DIEGO,Jul 2016,CACF,2016,MARANGELYS KIDS INC KIDDIE ACADEMY CHILD CARE CTR,OSCH_CHILD_BREAKFAST,20,83,5,20,108,745,45,179,969,48.45
SAN DIEGO,Jul 2016,CACF,2016,MARANGELYS KIDS INC KIDDIE ACADEMY CHILD CARE CTR,OSCH_CHILD_LUNCH,20,83,5,20,108,729,44,175,948,47.4
SAN DIEGO,Jul 2016,CACF,2016,MARANGELYS KIDS INC KIDDIE ACADEMY CHILD CARE CTR,OSCH_CHILD_SNACK_PM,20,83,5,20,108,792,48,190,1030,51.5
SAN DIEGO,Oct 2015,CACF,2016,Marine Corps Air Station,ATRISK_CHILD_SNACK,20,122,0,0,122,2180,0,0,2180,109
SAN DIEGO,Oct 2015,CACF,2016,Marine Corps Air Station,CHILD_BREAKFAST,21,0,1,32,33,0,11,356,367,17.4762
SAN DIEGO,Oct 2015,CACF,2016,Marine Corps Air Station,CHILD_LUNCH,21,0,1,32,33,0,15,465,480,22.8571
SAN DIEGO,Oct 2015,CACF,2016,Marine Corps Air Station,CHILD_SNACK_PM,21,0,1,32,33,0,14,460,474,22.5714
SAN DIEGO,Nov 2015,CACF,2016,Marine Corps Air Station,ATRISK_CHILD_LUNCH,19,144,0,0,144,171,0,0,171,9
SAN DIEGO,Nov 2015,CACF,2016,Marine Corps Air Station,ATRISK_CHILD_SNACK,19,144,0,0,144,1615,0,0,1615,85
SAN DIEGO,Nov 2015,CACF,2016,Marine Corps Air Station,CHILD_BREAKFAST,19,0,1,32,33,0,10,323,333,17.5263
SAN DIEGO,Nov 2015,CACF,2016,Marine Corps Air Station,CHILD_LUNCH,19,0,1,32,33,0,14,455,469,24.6842
SAN DIEGO,Nov 2015,CACF,2016,Marine Corps Air Station,CHILD_SNACK_PM,19,0,1,32,33,0,17,540,557,29.3158
SAN DIEGO,Dec 2015,CACF,2016,Marine Corps Air Station,ATRISK_CHILD_LUNCH,22,154,0,0,154,272,0,0,272,12.3636
SAN DIEGO,Dec 2015,CACF,2016,Marine Corps Air Station,ATRISK_CHILD_SNACK,22,154,0,0,154,1540,0,0,1540,70
SAN DIEGO,Dec 2015,CACF,2016,Marine Corps Air Station,CHILD_BREAKFAST,22,0,1,32,33,0,12,373,385,17.5
SAN DIEGO,Dec 2015,CACF,2016,Marine Corps Air Station,CHILD_LUNCH,22,0,1,32,33,0,15,469,484,22
SAN DIEGO,Dec 2015,CACF,2016,Marine Corps Air Station,CHILD_SNACK_PM,22,0,1,32,33,0,14,438,452,20.5455
SAN DIEGO,Jan 2016,CACF,2016,Marine Corps Air Station,ATRISK_CHILD_SNACK,19,154,0,0,154,1973,0,0,1973,103.8421
SAN DIEGO,Jan 2016,CACF,2016,Marine Corps Air Station,CHILD_BREAKFAST,19,0,1,32,33,0,10,330,340,17.8947
SAN DIEGO,Jan 2016,CACF,2016,Marine Corps Air Station,CHILD_LUNCH,19,0,1,32,33,0,16,496,512,26.9474
SAN DIEGO,Jan 2016,CACF,2016,Marine Corps Air Station,CHILD_SNACK_PM,19,0,1,32,33,0,14,451,465,24.4737
SAN DIEGO,Feb 2016,CACF,2016,Marine Corps Air Station,ATRISK_CHILD_LUNCH,20,165,0,0,165,46,0,0,46,2.3
SAN DIEGO,Feb 2016,CACF,2016,Marine Corps Air Station,ATRISK_CHILD_SNACK,20,165,0,0,165,1860,0,0,1860,93
SAN DIEGO,Feb 2016,CACF,2016,Marine Corps Air Station,CHILD_BREAKFAST,20,0,1,32,33,0,10,331,341,17.05
SAN DIEGO,Feb 2016,CACF,2016,Marine Corps Air Station,CHILD_LUNCH,20,0,1,32,33,0,17,559,576,28.8
SAN DIEGO,Feb 2016,CACF,2016,Marine Corps Air Station,CHILD_SNACK_PM,20,0,1,32,33,0,14,458,472,23.6
SAN DIEGO,Mar 2016,CACF,2016,Marine Corps Air Station,ATRISK_CHILD_LUNCH,23,147,0,0,147,195,0,0,195,8.4783
SAN DIEGO,Mar 2016,CACF,2016,Marine Corps Air Station,ATRISK_CHILD_SNACK,23,147,0,0,147,1886,0,0,1886,82
SAN DIEGO,Mar 2016,CACF,2016,Marine Corps Air Station,CHILD_BREAKFAST,23,0,1,32,33,0,12,396,408,17.7391
SAN DIEGO,Mar 2016,CACF,2016,Marine Corps Air Station,CHILD_LUNCH,23,0,1,32,33,0,18,580,598,26
SAN DIEGO,Mar 2016,CACF,2016,Marine Corps Air Station,CHILD_SNACK_PM,23,0,1,32,33,0,16,498,514,22.3478
SAN DIEGO,Apr 2016,CACF,2016,Marine Corps Air Station,ATRISK_CHILD_LUNCH,21,156,0,0,156,45,0,0,45,2.1429
SAN DIEGO,Apr 2016,CACF,2016,Marine Corps Air Station,ATRISK_CHILD_SNACK,21,156,0,0,156,1617,0,0,1617,77
SAN DIEGO,Apr 2016,CACF,2016,Marine Corps Air Station,CHILD_BREAKFAST,21,0,1,32,33,0,11,358,369,17.5714
SAN DIEGO,Apr 2016,CACF,2016,Marine Corps Air Station,CHILD_LUNCH,21,0,1,32,33,0,17,529,546,26
SAN DIEGO,Apr 2016,CACF,2016,Marine Corps Air Station,CHILD_SNACK_PM,21,0,1,32,33,0,15,474,489,23.2857
SAN DIEGO,May 2016,CACF,2016,Marine Corps Air Station,ATRISK_CHILD_LUNCH,21,106,0,0,106,26,0,0,26,1.2381
SAN DIEGO,May 2016,CACF,2016,Marine Corps Air Station,ATRISK_CHILD_SNACK,21,106,0,0,106,1701,0,0,1701,81
SAN DIEGO,May 2016,CACF,2016,Marine Corps Air Station,CHILD_BREAKFAST,21,0,1,32,33,0,12,398,410,19.5238
SAN DIEGO,May 2016,CACF,2016,Marine Corps Air Station,CHILD_LUNCH,21,0,1,32,33,0,17,555,572,27.2381
SAN DIEGO,May 2016,CACF,2016,Marine Corps Air Station,CHILD_SNACK_PM,21,0,1,32,33,0,15,485,500,23.8095
SAN DIEGO,Jun 2016,CACF,2016,Marine Corps Air Station,CHILD_BREAKFAST,20,0,1,32,33,0,12,385,397,19.85
SAN DIEGO,Jun 2016,CACF,2016,Marine Corps Air Station,CHILD_LUNCH,20,0,1,32,33,0,15,484,499,24.95
SAN DIEGO,Jun 2016,CACF,2016,Marine Corps Air Station,CHILD_SNACK_PM,20,0,1,32,33,0,14,457,471,23.55
SAN DIEGO,Jun 2016,CACF,2016,Marine Corps Air Station,OSCH_CHILD_BREAKFAST,20,0,6,68,74,0,19,220,239,11.95
SAN DIEGO,Jun 2016,CACF,2016,Marine Corps Air Station,OSCH_CHILD_LUNCH,20,0,6,68,74,0,36,410,446,22.3
SAN DIEGO,Jun 2016,CACF,2016,Marine Corps Air Station,OSCH_CHILD_SNACK_PM,20,0,6,68,74,0,118,1338,1456,72.8
SAN DIEGO,Jul 2016,CACF,2016,Marine Corps Air Station,CHILD_BREAKFAST,20,0,1,32,33,0,9,297,306,15.3
SAN DIEGO,Jul 2016,CACF,2016,Marine Corps Air Station,CHILD_LUNCH,20,0,1,32,33,0,13,412,425,21.25
SAN DIEGO,Jul 2016,CACF,2016,Marine Corps Air Station,CHILD_SNACK_PM,20,0,1,32,33,0,11,362,373,18.65
SAN DIEGO,Jul 2016,CACF,2016,Marine Corps Air Station,OSCH_CHILD_BREAKFAST,20,0,6,68,74,0,61,694,755,37.75
SAN DIEGO,Jul 2016,CACF,2016,Marine Corps Air Station,OSCH_CHILD_SNACK_PM,20,0,6,68,74,0,118,1340,1458,72.9
SAN DIEGO,Oct 2015,CACF,2016,Marine Corps Community Services,CHILD_BREAKFAST,21,27,38,574,639,348,489,7379,8216,391.2381
SAN DIEGO,Oct 2015,CACF,2016,Marine Corps Community Services,CHILD_LUNCH,21,27,38,574,639,399,562,8479,9440,449.5238
SAN DIEGO,Oct 2015,CACF,2016,Marine Corps Community Services,CHILD_SNACK_AM,21,27,38,574,639,18,25,380,423,20.1429
SAN DIEGO,Oct 2015,CACF,2016,Marine Corps Community Services,CHILD_SNACK_PM,21,27,38,574,639,385,541,8173,9099,433.2857
SAN DIEGO,Oct 2015,CACF,2016,Marine Corps Community Services,OSCH_CHILD_BREAKFAST,21,2,13,198,213,8,50,759,817,38.9048
SAN DIEGO,Oct 2015,CACF,2016,Marine Corps Community Services,OSCH_CHILD_LUNCH,21,2,13,198,213,5,31,473,509,24.2381
SAN DIEGO,Oct 2015,CACF,2016,Marine Corps Community Services,OSCH_CHILD_SNACK_PM,21,2,13,198,213,25,164,2493,2682,127.7143
SAN DIEGO,Nov 2015,CACF,2016,Marine Corps Community Services,CHILD_BREAKFAST,19,27,38,574,639,319,449,6777,7545,397.1053
SAN DIEGO,Nov 2015,CACF,2016,Marine Corps Community Services,CHILD_LUNCH,19,27,38,574,639,357,503,7587,8447,444.5789
SAN DIEGO,Nov 2015,CACF,2016,Marine Corps Community Services,CHILD_SNACK_AM,19,27,38,574,639,14,20,296,330,17.3684
SAN DIEGO,Nov 2015,CACF,2016,Marine Corps Community Services,CHILD_SNACK_PM,19,27,38,574,639,338,475,7172,7985,420.2632
SAN DIEGO,Nov 2015,CACF,2016,Marine Corps Community Services,OSCH_CHILD_BREAKFAST,19,2,13,198,213,7,47,718,772,40.6316
SAN DIEGO,Nov 2015,CACF,2016,Marine Corps Community Services,OSCH_CHILD_LUNCH,19,2,13,198,213,6,40,603,649,34.1579
SAN DIEGO,Nov 2015,CACF,2016,Marine Corps Community Services,OSCH_CHILD_SNACK_PM,19,2,13,198,213,19,126,1926,2071,109
SAN DIEGO,Dec 2015,CACF,2016,Marine Corps Community Services,CHILD_BREAKFAST,22,27,38,574,639,352,495,7467,8314,377.9091
SAN DIEGO,Dec 2015,CACF,2016,Marine Corps Community Services,CHILD_LUNCH,22,27,38,574,639,403,568,8567,9538,433.5455
SAN DIEGO,Dec 2015,CACF,2016,Marine Corps Community Services,CHILD_SNACK_AM,22,27,38,574,639,13,18,275,306,13.9091
SAN DIEGO,Dec 2015,CACF,2016,Marine Corps Community Services,CHILD_SNACK_PM,22,27,38,574,639,372,524,7905,8801,400.0455
SAN DIEGO,Dec 2015,CACF,2016,Marine Corps Community Services,OSCH_CHILD_BREAKFAST,22,2,13,198,213,8,49,746,803,36.5
SAN DIEGO,Dec 2015,CACF,2016,Marine Corps Community Services,OSCH_CHILD_LUNCH,22,2,13,198,213,8,50,763,821,37.3182
SAN DIEGO,Dec 2015,CACF,2016,Marine Corps Community Services,OSCH_CHILD_SNACK_PM,22,2,13,198,213,22,141,2148,2311,105.0455
SAN DIEGO,Jan 2016,CACF,2016,Marine Corps Community Services,CHILD_BREAKFAST,19,27,38,574,639,372,523,7889,8784,462.3158
SAN DIEGO,Jan 2016,CACF,2016,Marine Corps Community Services,CHILD_LUNCH,19,27,38,574,639,421,592,8933,9946,523.4737
SAN DIEGO,Jan 2016,CACF,2016,Marine Corps Community Services,CHILD_SNACK_AM,19,27,38,574,639,18,26,386,430,22.6316
SAN DIEGO,Jan 2016,CACF,2016,Marine Corps Community Services,CHILD_SNACK_PM,19,27,38,574,639,400,563,8499,9462,498
SAN DIEGO,Jan 2016,CACF,2016,Marine Corps Community Services,OSCH_CHILD_BREAKFAST,19,2,13,198,213,7,46,694,747,39.3158
SAN DIEGO,Jan 2016,CACF,2016,Marine Corps Community Services,OSCH_CHILD_LUNCH,19,2,13,198,213,5,33,499,537,28.2632
SAN DIEGO,Jan 2016,CACF,2016,Marine Corps Community Services,OSCH_CHILD_SNACK_PM,19,2,13,198,213,25,162,2475,2662,140.1053
SAN DIEGO,Feb 2016,CACF,2016,Marine Corps Community Services,CHILD_BREAKFAST,20,27,38,574,639,403,567,8563,9533,476.65
SAN DIEGO,Feb 2016,CACF,2016,Marine Corps Community Services,CHILD_LUNCH,20,27,38,574,639,450,632,9547,10629,531.45
SAN DIEGO,Feb 2016,CACF,2016,Marine Corps Community Services,CHILD_SNACK_AM,20,27,38,574,639,15,21,317,353,17.65
SAN DIEGO,Feb 2016,CACF,2016,Marine Corps Community Services,CHILD_SNACK_PM,20,27,38,574,639,427,601,9075,10103,505.15
SAN DIEGO,Feb 2016,CACF,2016,Marine Corps Community Services,OSCH_CHILD_BREAKFAST,20,2,13,198,213,9,59,907,975,48.75
SAN DIEGO,Feb 2016,CACF,2016,Marine Corps Community Services,OSCH_CHILD_LUNCH,20,2,13,198,213,5,35,532,572,28.6
SAN DIEGO,Feb 2016,CACF,2016,Marine Corps Community Services,OSCH_CHILD_SNACK_PM,20,2,13,198,213,25,161,2446,2632,131.6
SAN DIEGO,Mar 2016,CACF,2016,Marine Corps Community Services,CHILD_BREAKFAST,23,27,38,574,639,454,639,9649,10742,467.0435
SAN DIEGO,Mar 2016,CACF,2016,Marine Corps Community Services,CHILD_LUNCH,23,27,38,574,639,513,721,10892,12126,527.2174
SAN DIEGO,Mar 2016,CACF,2016,Marine Corps Community Services,CHILD_SNACK_AM,23,27,38,574,639,16,23,342,381,16.5652
SAN DIEGO,Mar 2016,CACF,2016,Marine Corps Community Services,CHILD_SNACK_PM,23,27,38,574,639,496,698,10538,11732,510.087
SAN DIEGO,Mar 2016,CACF,2016,Marine Corps Community Services,OSCH_CHILD_BREAKFAST,23,2,13,198,213,11,74,1135,1220,53.0435
SAN DIEGO,Mar 2016,CACF,2016,Marine Corps Community Services,OSCH_CHILD_LUNCH,23,2,13,198,213,8,55,835,898,39.0435
SAN DIEGO,Mar 2016,CACF,2016,Marine Corps Community Services,OSCH_CHILD_SNACK_PM,23,2,13,198,213,30,192,2929,3151,137
SAN DIEGO,Apr 2016,CACF,2016,Marine Corps Community Services,CHILD_BREAKFAST,21,27,38,574,639,412,580,8751,9743,463.9524
SAN DIEGO,Apr 2016,CACF,2016,Marine Corps Community Services,CHILD_LUNCH,21,27,38,574,639,468,658,9932,11058,526.5714
SAN DIEGO,Apr 2016,CACF,2016,Marine Corps Community Services,CHILD_SNACK_AM,21,27,38,574,639,20,27,415,462,22
SAN DIEGO,Apr 2016,CACF,2016,Marine Corps Community Services,CHILD_SNACK_PM,21,27,38,574,639,452,636,9601,10689,509
SAN DIEGO,Apr 2016,CACF,2016,Marine Corps Community Services,OSCH_CHILD_BREAKFAST,21,2,13,198,213,9,56,860,925,44.0476
SAN DIEGO,Apr 2016,CACF,2016,Marine Corps Community Services,OSCH_CHILD_LUNCH,21,2,13,198,213,6,36,550,592,28.1905
SAN DIEGO,Apr 2016,CACF,2016,Marine Corps Community Services,OSCH_CHILD_SNACK_PM,21,2,13,198,213,28,184,2811,3023,143.9524
SAN DIEGO,May 2016,CACF,2016,Marine Corps Community Services,CHILD_BREAKFAST,21,27,38,574,639,408,574,8664,9646,459.3333
SAN DIEGO,May 2016,CACF,2016,Marine Corps Community Services,CHILD_LUNCH,21,27,38,574,639,458,644,9723,10825,515.4762
SAN DIEGO,May 2016,CACF,2016,Marine Corps Community Services,CHILD_SNACK_AM,21,27,38,574,639,21,29,445,495,23.5714
SAN DIEGO,May 2016,CACF,2016,Marine Corps Community Services,CHILD_SNACK_PM,21,27,38,574,639,439,618,9324,10381,494.3333
SAN DIEGO,May 2016,CACF,2016,Marine Corps Community Services,OSCH_CHILD_BREAKFAST,21,2,13,198,213,8,50,756,814,38.7619
SAN DIEGO,May 2016,CACF,2016,Marine Corps Community Services,OSCH_CHILD_LUNCH,21,2,13,198,213,5,33,497,535,25.4762
SAN DIEGO,May 2016,CACF,2016,Marine Corps Community Services,OSCH_CHILD_SNACK_PM,21,2,13,198,213,29,186,2837,3052,145.3333
SAN DIEGO,Jun 2016,CACF,2016,Marine Corps Community Services,CHILD_BREAKFAST,22,27,38,574,639,355,500,7540,8395,381.5909
SAN DIEGO,Jun 2016,CACF,2016,Marine Corps Community Services,CHILD_LUNCH,22,27,38,574,639,400,562,8490,9452,429.6364
SAN DIEGO,Jun 2016,CACF,2016,Marine Corps Community Services,CHILD_SNACK_PM,22,27,38,574,639,381,536,8085,9002,409.1818
SAN DIEGO,Jun 2016,CACF,2016,Marine Corps Community Services,OSCH_CHILD_BREAKFAST,22,2,13,198,213,22,144,2196,2362,107.3636
SAN DIEGO,Jun 2016,CACF,2016,Marine Corps Community Services,OSCH_CHILD_LUNCH,22,2,13,198,213,26,167,2542,2735,124.3182
SAN DIEGO,Jun 2016,CACF,2016,Marine Corps Community Services,OSCH_CHILD_SNACK_PM,22,2,13,198,213,28,182,2778,2988,135.8182
SAN DIEGO,Jul 2016,CACF,2016,Marine Corps Community Services,CHILD_BREAKFAST,20,27,38,574,639,292,411,6201,6904,345.2
SAN DIEGO,Jul 2016,CACF,2016,Marine Corps Community Services,CHILD_LUNCH,20,27,38,574,639,334,470,7096,7900,395
SAN DIEGO,Jul 2016,CACF,2016,Marine Corps Community Services,CHILD_SNACK_PM,20,27,38,574,639,318,447,6746,7511,375.55
SAN DIEGO,Jul 2016,CACF,2016,Marine Corps Community Services,OSCH_CHILD_BREAKFAST,20,2,13,198,213,20,131,1996,2147,107.35
SAN DIEGO,Jul 2016,CACF,2016,Marine Corps Community Services,OSCH_CHILD_LUNCH,20,2,13,198,213,24,156,2370,2550,127.5
SAN DIEGO,Jul 2016,CACF,2016,Marine Corps Community Services,OSCH_CHILD_SNACK_PM,20,2,13,198,213,22,144,2196,2362,118.1
SAN DIEGO,Oct 2015,CACF,2016,MARTHA'S VILLAGE & KITCHEN INC ,ES_CHILD_BREAKFAST,31,106,0,0,106,1722,0,0,1722,55.5484
SAN DIEGO,Oct 2015,CACF,2016,MARTHA'S VILLAGE & KITCHEN INC ,ES_CHILD_LUNCH,31,106,0,0,106,1690,0,0,1690,54.5161
SAN DIEGO,Oct 2015,CACF,2016,MARTHA'S VILLAGE & KITCHEN INC ,ES_CHILD_SUPPER,31,106,0,0,106,1248,0,0,1248,40.2581
SAN DIEGO,Nov 2015,CACF,2016,MARTHA'S VILLAGE & KITCHEN INC ,ES_CHILD_BREAKFAST,30,98,0,0,98,1602,0,0,1602,53.4
SAN DIEGO,Nov 2015,CACF,2016,MARTHA'S VILLAGE & KITCHEN INC ,ES_CHILD_LUNCH,30,98,0,0,98,1565,0,0,1565,52.1667
SAN DIEGO,Nov 2015,CACF,2016,MARTHA'S VILLAGE & KITCHEN INC ,ES_CHILD_SUPPER,30,98,0,0,98,1079,0,0,1079,35.9667
SAN DIEGO,Dec 2015,CACF,2016,MARTHA'S VILLAGE & KITCHEN INC ,ES_CHILD_BREAKFAST,31,100,0,0,100,1462,0,0,1462,47.1613
SAN DIEGO,Dec 2015,CACF,2016,MARTHA'S VILLAGE & KITCHEN INC ,ES_CHILD_LUNCH,31,100,0,0,100,1563,0,0,1563,50.4194
SAN DIEGO,Dec 2015,CACF,2016,MARTHA'S VILLAGE & KITCHEN INC ,ES_CHILD_SUPPER,31,100,0,0,100,1223,0,0,1223,39.4516
SAN DIEGO,Jan 2016,CACF,2016,MARTHA'S VILLAGE & KITCHEN INC ,ES_CHILD_BREAKFAST,31,115,0,0,115,1854,0,0,1854,59.8065
SAN DIEGO,Jan 2016,CACF,2016,MARTHA'S VILLAGE & KITCHEN INC ,ES_CHILD_LUNCH,31,115,0,0,115,1801,0,0,1801,58.0968
SAN DIEGO,Jan 2016,CACF,2016,MARTHA'S VILLAGE & KITCHEN INC ,ES_CHILD_SUPPER,31,115,0,0,115,1583,0,0,1583,51.0645
SAN DIEGO,Feb 2016,CACF,2016,MARTHA'S VILLAGE & KITCHEN INC ,ES_CHILD_BREAKFAST,29,99,0,0,99,1218,0,0,1218,42
SAN DIEGO,Feb 2016,CACF,2016,MARTHA'S VILLAGE & KITCHEN INC ,ES_CHILD_LUNCH,29,99,0,0,99,1353,0,0,1353,46.6552
SAN DIEGO,Feb 2016,CACF,2016,MARTHA'S VILLAGE & KITCHEN INC ,ES_CHILD_SUPPER,29,99,0,0,99,1171,0,0,1171,40.3793
SAN DIEGO,Mar 2016,CACF,2016,MARTHA'S VILLAGE & KITCHEN INC ,ES_CHILD_BREAKFAST,31,105,0,0,105,1096,0,0,1096,35.3548
SAN DIEGO,Mar 2016,CACF,2016,MARTHA'S VILLAGE & KITCHEN INC ,ES_CHILD_LUNCH,31,105,0,0,105,1429,0,0,1429,46.0968
SAN DIEGO,Mar 2016,CACF,2016,MARTHA'S VILLAGE & KITCHEN INC ,ES_CHILD_SUPPER,31,105,0,0,105,1140,0,0,1140,36.7742
SAN DIEGO,Apr 2016,CACF,2016,MARTHA'S VILLAGE & KITCHEN INC ,ES_CHILD_BREAKFAST,30,96,0,0,96,1278,0,0,1278,42.6
SAN DIEGO,Apr 2016,CACF,2016,MARTHA'S VILLAGE & KITCHEN INC ,ES_CHILD_LUNCH,30,96,0,0,96,1494,0,0,1494,49.8
SAN DIEGO,Apr 2016,CACF,2016,MARTHA'S VILLAGE & KITCHEN INC ,ES_CHILD_SUPPER,30,96,0,0,96,1121,0,0,1121,37.3667
SAN DIEGO,May 2016,CACF,2016,MARTHA'S VILLAGE & KITCHEN INC ,ES_CHILD_BREAKFAST,31,92,0,0,92,1359,0,0,1359,43.8387
SAN DIEGO,May 2016,CACF,2016,MARTHA'S VILLAGE & KITCHEN INC ,ES_CHILD_LUNCH,31,92,0,0,92,1506,0,0,1506,48.5806
SAN DIEGO,May 2016,CACF,2016,MARTHA'S VILLAGE & KITCHEN INC ,ES_CHILD_SUPPER,31,92,0,0,92,1171,0,0,1171,37.7742
SAN DIEGO,Jun 2016,CACF,2016,MARTHA'S VILLAGE & KITCHEN INC ,ES_CHILD_BREAKFAST,30,94,0,0,94,1033,0,0,1033,34.4333
SAN DIEGO,Jun 2016,CACF,2016,MARTHA'S VILLAGE & KITCHEN INC ,ES_CHILD_LUNCH,30,94,0,0,94,1386,0,0,1386,46.2
SAN DIEGO,Jun 2016,CACF,2016,MARTHA'S VILLAGE & KITCHEN INC ,ES_CHILD_SUPPER,30,94,0,0,94,1139,0,0,1139,37.9667
SAN DIEGO,Oct 2015,CACF,2016,METROPOLITAN AREA ADVISORY COMMITTEE-MAAC-PROJ HEADSTART,CHILD_BREAKFAST,20,334,0,0,334,5603,0,0,5603,280.15
SAN DIEGO,Oct 2015,CACF,2016,METROPOLITAN AREA ADVISORY COMMITTEE-MAAC-PROJ HEADSTART,HS_CHILD_BREAKFAST,20,1495,0,0,1495,7712,0,0,7712,385.6
SAN DIEGO,Oct 2015,CACF,2016,METROPOLITAN AREA ADVISORY COMMITTEE-MAAC-PROJ HEADSTART,HS_CHILD_LUNCH,20,1495,0,0,1495,18363,0,0,18363,918.15
SAN DIEGO,Oct 2015,CACF,2016,METROPOLITAN AREA ADVISORY COMMITTEE-MAAC-PROJ HEADSTART,HS_CHILD_SNACK_PM,20,1495,0,0,1495,11792,0,0,11792,589.6
SAN DIEGO,Nov 2015,CACF,2016,METROPOLITAN AREA ADVISORY COMMITTEE-MAAC-PROJ HEADSTART,CHILD_BREAKFAST,14,334,0,0,334,3801,0,0,3801,271.5
SAN DIEGO,Nov 2015,CACF,2016,METROPOLITAN AREA ADVISORY COMMITTEE-MAAC-PROJ HEADSTART,HS_CHILD_BREAKFAST,16,1495,0,0,1495,5298,0,0,5298,331.125
SAN DIEGO,Nov 2015,CACF,2016,METROPOLITAN AREA ADVISORY COMMITTEE-MAAC-PROJ HEADSTART,HS_CHILD_LUNCH,16,1495,0,0,1495,12487,0,0,12487,780.4375
SAN DIEGO,Nov 2015,CACF,2016,METROPOLITAN AREA ADVISORY COMMITTEE-MAAC-PROJ HEADSTART,HS_CHILD_SNACK_PM,16,1495,0,0,1495,7938,0,0,7938,496.125
SAN DIEGO,Dec 2015,CACF,2016,METROPOLITAN AREA ADVISORY COMMITTEE-MAAC-PROJ HEADSTART,CHILD_BREAKFAST,12,334,0,0,334,3280,0,0,3280,273.3333
SAN DIEGO,Dec 2015,CACF,2016,METROPOLITAN AREA ADVISORY COMMITTEE-MAAC-PROJ HEADSTART,HS_CHILD_BREAKFAST,12,1495,0,0,1495,4807,0,0,4807,400.5833
SAN DIEGO,Dec 2015,CACF,2016,METROPOLITAN AREA ADVISORY COMMITTEE-MAAC-PROJ HEADSTART,HS_CHILD_LUNCH,12,1495,0,0,1495,11560,0,0,11560,963.3333
SAN DIEGO,Dec 2015,CACF,2016,METROPOLITAN AREA ADVISORY COMMITTEE-MAAC-PROJ HEADSTART,HS_CHILD_SNACK_PM,12,1495,0,0,1495,7128,0,0,7128,594
SAN DIEGO,Jan 2016,CACF,2016,METROPOLITAN AREA ADVISORY COMMITTEE-MAAC-PROJ HEADSTART,CHILD_BREAKFAST,14,334,0,0,334,3740,0,0,3740,267.1429
SAN DIEGO,Jan 2016,CACF,2016,METROPOLITAN AREA ADVISORY COMMITTEE-MAAC-PROJ HEADSTART,HS_CHILD_BREAKFAST,14,1495,0,0,1495,5024,0,0,5024,358.8571
SAN DIEGO,Jan 2016,CACF,2016,METROPOLITAN AREA ADVISORY COMMITTEE-MAAC-PROJ HEADSTART,HS_CHILD_LUNCH,14,1495,0,0,1495,12187,0,0,12187,870.5
SAN DIEGO,Jan 2016,CACF,2016,METROPOLITAN AREA ADVISORY COMMITTEE-MAAC-PROJ HEADSTART,HS_CHILD_SNACK_PM,14,1495,0,0,1495,7773,0,0,7773,555.2143
SAN DIEGO,Feb 2016,CACF,2016,METROPOLITAN AREA ADVISORY COMMITTEE-MAAC-PROJ HEADSTART,CHILD_BREAKFAST,17,334,0,0,334,4733,0,0,4733,278.4118
SAN DIEGO,Feb 2016,CACF,2016,METROPOLITAN AREA ADVISORY COMMITTEE-MAAC-PROJ HEADSTART,HS_CHILD_BREAKFAST,17,1495,0,0,1495,6658,0,0,6658,391.6471
SAN DIEGO,Feb 2016,CACF,2016,METROPOLITAN AREA ADVISORY COMMITTEE-MAAC-PROJ HEADSTART,HS_CHILD_LUNCH,17,1495,0,0,1495,16096,0,0,16096,946.8235
SAN DIEGO,Feb 2016,CACF,2016,METROPOLITAN AREA ADVISORY COMMITTEE-MAAC-PROJ HEADSTART,HS_CHILD_SNACK_PM,17,1495,0,0,1495,10041,0,0,10041,590.6471
SAN DIEGO,Mar 2016,CACF,2016,METROPOLITAN AREA ADVISORY COMMITTEE-MAAC-PROJ HEADSTART,CHILD_BREAKFAST,16,334,0,0,334,4482,0,0,4482,280.125
SAN DIEGO,Mar 2016,CACF,2016,METROPOLITAN AREA ADVISORY COMMITTEE-MAAC-PROJ HEADSTART,HS_CHILD_BREAKFAST,16,1495,0,0,1495,6263,0,0,6263,391.4375
SAN DIEGO,Mar 2016,CACF,2016,METROPOLITAN AREA ADVISORY COMMITTEE-MAAC-PROJ HEADSTART,HS_CHILD_LUNCH,16,1495,0,0,1495,15156,0,0,15156,947.25
SAN DIEGO,Mar 2016,CACF,2016,METROPOLITAN AREA ADVISORY COMMITTEE-MAAC-PROJ HEADSTART,HS_CHILD_SNACK_PM,16,1495,0,0,1495,9648,0,0,9648,603
SAN DIEGO,Apr 2016,CACF,2016,METROPOLITAN AREA ADVISORY COMMITTEE-MAAC-PROJ HEADSTART,CHILD_BREAKFAST,18,334,0,0,334,5104,0,0,5104,283.5556
SAN DIEGO,Apr 2016,CACF,2016,METROPOLITAN AREA ADVISORY COMMITTEE-MAAC-PROJ HEADSTART,HS_CHILD_BREAKFAST,18,1495,0,0,1495,6739,0,0,6739,374.3889
SAN DIEGO,Apr 2016,CACF,2016,METROPOLITAN AREA ADVISORY COMMITTEE-MAAC-PROJ HEADSTART,HS_CHILD_LUNCH,18,1495,0,0,1495,16741,0,0,16741,930.0556
SAN DIEGO,Apr 2016,CACF,2016,METROPOLITAN AREA ADVISORY COMMITTEE-MAAC-PROJ HEADSTART,HS_CHILD_SNACK_PM,18,1495,0,0,1495,10876,0,0,10876,604.2222
SAN DIEGO,May 2016,CACF,2016,METROPOLITAN AREA ADVISORY COMMITTEE-MAAC-PROJ HEADSTART,CHILD_BREAKFAST,19,334,0,0,334,5315,0,0,5315,279.7368
SAN DIEGO,May 2016,CACF,2016,METROPOLITAN AREA ADVISORY COMMITTEE-MAAC-PROJ HEADSTART,HS_CHILD_BREAKFAST,19,1495,0,0,1495,4891,0,0,4891,257.4211
SAN DIEGO,May 2016,CACF,2016,METROPOLITAN AREA ADVISORY COMMITTEE-MAAC-PROJ HEADSTART,HS_CHILD_LUNCH,19,1495,0,0,1495,13517,0,0,13517,711.4211
SAN DIEGO,May 2016,CACF,2016,METROPOLITAN AREA ADVISORY COMMITTEE-MAAC-PROJ HEADSTART,HS_CHILD_SNACK_PM,19,1495,0,0,1495,9036,0,0,9036,475.5789
SAN DIEGO,Jun 2016,CACF,2016,METROPOLITAN AREA ADVISORY COMMITTEE-MAAC-PROJ HEADSTART,CHILD_BREAKFAST,12,334,0,0,334,3023,0,0,3023,251.9167
SAN DIEGO,Jun 2016,CACF,2016,METROPOLITAN AREA ADVISORY COMMITTEE-MAAC-PROJ HEADSTART,HS_CHILD_BREAKFAST,16,1495,0,0,1495,1232,0,0,1232,77
SAN DIEGO,Jun 2016,CACF,2016,METROPOLITAN AREA ADVISORY COMMITTEE-MAAC-PROJ HEADSTART,HS_CHILD_LUNCH,16,1495,0,0,1495,4427,0,0,4427,276.6875
SAN DIEGO,Jun 2016,CACF,2016,METROPOLITAN AREA ADVISORY COMMITTEE-MAAC-PROJ HEADSTART,HS_CHILD_SNACK_PM,16,1495,0,0,1495,3434,0,0,3434,214.625
SAN DIEGO,Jul 2016,CACF,2016,METROPOLITAN AREA ADVISORY COMMITTEE-MAAC-PROJ HEADSTART,HS_CHILD_BREAKFAST,14,1498,0,0,1498,1169,0,0,1169,83.5
SAN DIEGO,Jul 2016,CACF,2016,METROPOLITAN AREA ADVISORY COMMITTEE-MAAC-PROJ HEADSTART,HS_CHILD_LUNCH,14,1498,0,0,1498,1233,0,0,1233,88.0714
SAN DIEGO,Jul 2016,CACF,2016,METROPOLITAN AREA ADVISORY COMMITTEE-MAAC-PROJ HEADSTART,HS_CHILD_SNACK_PM,14,1498,0,0,1498,832,0,0,832,59.4286
SAN DIEGO,Oct 2015,CACF,2016,"Navy Region Southwest, Child and Youth Programs",ATRISK_CHILD_LUNCH,21,589,0,0,589,3,0,0,3,0.1429
SAN DIEGO,Oct 2015,CACF,2016,"Navy Region Southwest, Child and Youth Programs",ATRISK_CHILD_SNACK,21,589,0,0,589,12099,0,0,12099,576.1429
SAN DIEGO,Oct 2015,CACF,2016,"Navy Region Southwest, Child and Youth Programs",CHILD_BREAKFAST,21,69,163,2332,2564,1053,2490,35608,39151,1864.3333
SAN DIEGO,Oct 2015,CACF,2016,"Navy Region Southwest, Child and Youth Programs",CHILD_LUNCH,21,69,163,2332,2564,1199,2836,40550,44585,2123.0952
SAN DIEGO,Oct 2015,CACF,2016,"Navy Region Southwest, Child and Youth Programs",CHILD_SNACK_PM,21,69,163,2332,2564,1085,2566,36700,40351,1921.4762
SAN DIEGO,Oct 2015,DCH,2016,"Navy Region Southwest, Child and Youth Programs",DCH_BREAKFAST,22,0,0,0,0,4034,0,0,4034,183.3636
SAN DIEGO,Oct 2015,DCH,2016,"Navy Region Southwest, Child and Youth Programs",DCH_BREAKFAST,,0,0,0,0,0,52,199,251,0
SAN DIEGO,Oct 2015,DCH,2016,"Navy Region Southwest, Child and Youth Programs",DCH_BREAKFAST,21,0,0,0,0,0,0,0,0,0
SAN DIEGO,Oct 2015,DCH,2016,"Navy Region Southwest, Child and Youth Programs",DCH_BREAKFAST,21,0,0,0,0,0,0,0,0,0
SAN DIEGO,Oct 2015,DCH,2016,"Navy Region Southwest, Child and Youth Programs",DCH_LUNCH,22,0,0,0,0,4468,0,0,4468,203.0909
SAN DIEGO,Oct 2015,DCH,2016,"Navy Region Southwest, Child and Youth Programs",DCH_LUNCH,,0,0,0,0,0,52,167,219,0
SAN DIEGO,Oct 2015,DCH,2016,"Navy Region Southwest, Child and Youth Programs",DCH_LUNCH,21,0,0,0,0,0,0,0,0,0
SAN DIEGO,Oct 2015,DCH,2016,"Navy Region Southwest, Child and Youth Programs",DCH_LUNCH,21,0,0,0,0,0,0,0,0,0
SAN DIEGO,Oct 2015,DCH,2016,"Navy Region Southwest, Child and Youth Programs",DCH_SNACK_AM,22,0,0,0,0,2098,0,0,2098,95.3636
SAN DIEGO,Oct 2015,DCH,2016,"Navy Region Southwest, Child and Youth Programs",DCH_SNACK_AM,21,0,0,0,0,0,0,0,0,0
SAN DIEGO,Oct 2015,DCH,2016,"Navy Region Southwest, Child and Youth Programs",DCH_SNACK_AM,21,0,0,0,0,0,0,0,0,0
SAN DIEGO,Oct 2015,DCH,2016,"Navy Region Southwest, Child and Youth Programs",DCH_SNACK_AM,,0,0,0,0,0,52,129,181,0
SAN DIEGO,Oct 2015,DCH,2016,"Navy Region Southwest, Child and Youth Programs",DCH_SNACK_NT,21,0,0,0,0,0,0,0,0,0
SAN DIEGO,Oct 2015,DCH,2016,"Navy Region Southwest, Child and Youth Programs",DCH_SNACK_NT,21,0,0,0,0,0,0,0,0,0
SAN DIEGO,Oct 2015,DCH,2016,"Navy Region Southwest, Child and Youth Programs",DCH_SNACK_NT,22,0,0,0,0,18,0,0,18,0.8182
SAN DIEGO,Oct 2015,DCH,2016,"Navy Region Southwest, Child and Youth Programs",DCH_SNACK_PM,21,0,0,0,0,0,0,0,0,0
SAN DIEGO,Oct 2015,DCH,2016,"Navy Region Southwest, Child and Youth Programs",DCH_SNACK_PM,21,0,0,0,0,0,0,0,0,0
SAN DIEGO,Oct 2015,DCH,2016,"Navy Region Southwest, Child and Youth Programs",DCH_SNACK_PM,,0,0,0,0,0,0,192,192,0
SAN DIEGO,Oct 2015,DCH,2016,"Navy Region Southwest, Child and Youth Programs",DCH_SNACK_PM,22,0,0,0,0,3214,0,0,3214,146.0909
SAN DIEGO,Oct 2015,DCH,2016,"Navy Region Southwest, Child and Youth Programs",DCH_SUPPER,21,0,0,0,0,0,0,0,0,0
SAN DIEGO,Oct 2015,DCH,2016,"Navy Region Southwest, Child and Youth Programs",DCH_SUPPER,21,0,0,0,0,0,0,0,0,0
SAN DIEGO,Oct 2015,DCH,2016,"Navy Region Southwest, Child and Youth Programs",DCH_SUPPER,22,0,0,0,0,283,0,0,283,12.8636
SAN DIEGO,Oct 2015,CACF,2016,"Navy Region Southwest, Child and Youth Programs",OSCH_CHILD_BREAKFAST,21,5,12,119,136,13,32,313,358,17.0476
SAN DIEGO,Oct 2015,CACF,2016,"Navy Region Southwest, Child and Youth Programs",OSCH_CHILD_LUNCH,21,5,12,119,136,6,15,151,172,8.1905
SAN DIEGO,Oct 2015,CACF,2016,"Navy Region Southwest, Child and Youth Programs",OSCH_CHILD_SNACK_PM,21,5,12,119,136,48,115,1146,1309,62.3333
SAN DIEGO,Nov 2015,CACF,2016,"Navy Region Southwest, Child and Youth Programs",ATRISK_CHILD_LUNCH,21,536,0,0,536,92,0,0,92,4.381
SAN DIEGO,Nov 2015,CACF,2016,"Navy Region Southwest, Child and Youth Programs",ATRISK_CHILD_SNACK,21,536,0,0,536,9584,0,0,9584,456.381
SAN DIEGO,Nov 2015,CACF,2016,"Navy Region Southwest, Child and Youth Programs",CHILD_BREAKFAST,21,69,163,2332,2564,911,2155,30812,33878,1613.2381
SAN DIEGO,Nov 2015,CACF,2016,"Navy Region Southwest, Child and Youth Programs",CHILD_LUNCH,21,69,163,2332,2564,994,2350,33603,36947,1759.381
SAN DIEGO,Nov 2015,CACF,2016,"Navy Region Southwest, Child and Youth Programs",CHILD_SNACK_PM,21,69,163,2332,2564,894,2113,30219,33226,1582.1905
SAN DIEGO,Nov 2015,DCH,2016,"Navy Region Southwest, Child and Youth Programs",DCH_BREAKFAST,,0,0,0,0,0,71,207,278,0
SAN DIEGO,Nov 2015,DCH,2016,"Navy Region Southwest, Child and Youth Programs",DCH_BREAKFAST,19,0,0,0,0,0,0,0,0,0
SAN DIEGO,Nov 2015,DCH,2016,"Navy Region Southwest, Child and Youth Programs",DCH_BREAKFAST,19,0,0,0,0,0,0,0,0,0
SAN DIEGO,Nov 2015,DCH,2016,"Navy Region Southwest, Child and Youth Programs",DCH_BREAKFAST,20,0,0,0,0,3560,0,0,3560,178
SAN DIEGO,Nov 2015,DCH,2016,"Navy Region Southwest, Child and Youth Programs",DCH_LUNCH,19,0,0,0,0,0,0,0,0,0
SAN DIEGO,Nov 2015,DCH,2016,"Navy Region Southwest, Child and Youth Programs",DCH_LUNCH,19,0,0,0,0,0,0,0,0,0
SAN DIEGO,Nov 2015,DCH,2016,"Navy Region Southwest, Child and Youth Programs",DCH_LUNCH,,0,0,0,0,0,112,146,258,0
SAN DIEGO,Nov 2015,DCH,2016,"Navy Region Southwest, Child and Youth Programs",DCH_LUNCH,20,0,0,0,0,3934,0,0,3934,196.7
SAN DIEGO,Nov 2015,DCH,2016,"Navy Region Southwest, Child and Youth Programs",DCH_SNACK_AM,19,0,0,0,0,0,0,0,0,0
SAN DIEGO,Nov 2015,DCH,2016,"Navy Region Southwest, Child and Youth Programs",DCH_SNACK_AM,19,0,0,0,0,0,0,0,0,0
SAN DIEGO,Nov 2015,DCH,2016,"Navy Region Southwest, Child and Youth Programs",DCH_SNACK_AM,,0,0,0,0,0,112,127,239,0
SAN DIEGO,Nov 2015,DCH,2016,"Navy Region Southwest, Child and Youth Programs",DCH_SNACK_AM,20,0,0,0,0,1890,0,0,1890,94.5
SAN DIEGO,Nov 2015,DCH,2016,"Navy Region Southwest, Child and Youth Programs",DCH_SNACK_NT,19,0,0,0,0,0,0,0,0,0
SAN DIEGO,Nov 2015,DCH,2016,"Navy Region Southwest, Child and Youth Programs",DCH_SNACK_NT,19,0,0,0,0,0,0,0,0,0
SAN DIEGO,Nov 2015,DCH,2016,"Navy Region Southwest, Child and Youth Programs",DCH_SNACK_NT,20,0,0,0,0,23,0,0,23,1.15
SAN DIEGO,Nov 2015,DCH,2016,"Navy Region Southwest, Child and Youth Programs",DCH_SNACK_PM,19,0,0,0,0,0,0,0,0,0
SAN DIEGO,Nov 2015,DCH,2016,"Navy Region Southwest, Child and Youth Programs",DCH_SNACK_PM,20,0,0,0,0,2714,0,0,2714,135.7
SAN DIEGO,Nov 2015,DCH,2016,"Navy Region Southwest, Child and Youth Programs",DCH_SNACK_PM,19,0,0,0,0,0,0,0,0,0
SAN DIEGO,Nov 2015,DCH,2016,"Navy Region Southwest, Child and Youth Programs",DCH_SNACK_PM,,0,0,0,0,0,0,208,208,0
SAN DIEGO,Nov 2015,DCH,2016,"Navy Region Southwest, Child and Youth Programs",DCH_SUPPER,19,0,0,0,0,0,0,0,0,0
SAN DIEGO,Nov 2015,DCH,2016,"Navy Region Southwest, Child and Youth Programs",DCH_SUPPER,19,0,0,0,0,0,0,0,0,0
SAN DIEGO,Nov 2015,DCH,2016,"Navy Region Southwest, Child and Youth Programs",DCH_SUPPER,,0,0,0,0,0,40,0,40,0
SAN DIEGO,Nov 2015,DCH,2016,"Navy Region Southwest, Child and Youth Programs",DCH_SUPPER,20,0,0,0,0,257,0,0,257,12.85
SAN DIEGO,Nov 2015,CACF,2016,"Navy Region Southwest, Child and Youth Programs",OSCH_CHILD_BREAKFAST,21,5,12,119,136,21,50,498,569,27.0952
SAN DIEGO,Nov 2015,CACF,2016,"Navy Region Southwest, Child and Youth Programs",OSCH_CHILD_LUNCH,21,5,12,119,136,15,35,349,399,19
SAN DIEGO,Nov 2015,CACF,2016,"Navy Region Southwest, Child and Youth Programs",OSCH_CHILD_SNACK_PM,21,5,12,119,136,66,158,1563,1787,85.0952
SAN DIEGO,Dec 2015,CACF,2016,"Navy Region Southwest, Child and Youth Programs",ATRISK_CHILD_LUNCH,22,476,0,0,476,9501,0,0,9501,431.8636
SAN DIEGO,Dec 2015,CACF,2016,"Navy Region Southwest, Child and Youth Programs",ATRISK_CHILD_SNACK,22,476,0,0,476,9639,0,0,9639,438.1364
SAN DIEGO,Dec 2015,CACF,2016,"Navy Region Southwest, Child and Youth Programs",CHILD_BREAKFAST,22,69,163,2332,2564,901,2129,30449,33479,1521.7727
SAN DIEGO,Dec 2015,CACF,2016,"Navy Region Southwest, Child and Youth Programs",CHILD_LUNCH,22,69,163,2332,2564,1044,2468,35298,38810,1764.0909
SAN DIEGO,Dec 2015,CACF,2016,"Navy Region Southwest, Child and Youth Programs",CHILD_SNACK_PM,22,69,163,2332,2564,933,2206,31552,34691,1576.8636
SAN DIEGO,Dec 2015,DCH,2016,"Navy Region Southwest, Child and Youth Programs",DCH_BREAKFAST,22,0,0,0,0,3321,0,0,3321,150.9545
SAN DIEGO,Dec 2015,DCH,2016,"Navy Region Southwest, Child and Youth Programs",DCH_BREAKFAST,,0,0,0,0,0,110,175,285,0
SAN DIEGO,Dec 2015,DCH,2016,"Navy Region Southwest, Child and Youth Programs",DCH_BREAKFAST,20,0,0,0,0,0,0,0,0,0
SAN DIEGO,Dec 2015,DCH,2016,"Navy Region Southwest, Child and Youth Programs",DCH_BREAKFAST,21,0,0,0,0,0,0,0,0,0
SAN DIEGO,Dec 2015,DCH,2016,"Navy Region Southwest, Child and Youth Programs",DCH_LUNCH,22,0,0,0,0,3809,0,0,3809,173.1364
SAN DIEGO,Dec 2015,DCH,2016,"Navy Region Southwest, Child and Youth Programs",DCH_LUNCH,20,0,0,0,0,0,0,0,0,0
SAN DIEGO,Dec 2015,DCH,2016,"Navy Region Southwest, Child and Youth Programs",DCH_LUNCH,21,0,0,0,0,0,0,0,0,0
SAN DIEGO,Dec 2015,DCH,2016,"Navy Region Southwest, Child and Youth Programs",DCH_LUNCH,,0,0,0,0,0,120,144,264,0
SAN DIEGO,Dec 2015,DCH,2016,"Navy Region Southwest, Child and Youth Programs",DCH_SNACK_AM,21,0,0,0,0,0,0,0,0,0
SAN DIEGO,Dec 2015,DCH,2016,"Navy Region Southwest, Child and Youth Programs",DCH_SNACK_AM,22,0,0,0,0,1855,0,0,1855,84.3182
SAN DIEGO,Dec 2015,DCH,2016,"Navy Region Southwest, Child and Youth Programs",DCH_SNACK_AM,,0,0,0,0,0,116,113,229,0
SAN DIEGO,Dec 2015,DCH,2016,"Navy Region Southwest, Child and Youth Programs",DCH_SNACK_AM,20,0,0,0,0,0,0,0,0,0
SAN DIEGO,Dec 2015,DCH,2016,"Navy Region Southwest, Child and Youth Programs",DCH_SNACK_NT,22,0,0,0,0,10,0,0,10,0.4545
SAN DIEGO,Dec 2015,DCH,2016,"Navy Region Southwest, Child and Youth Programs",DCH_SNACK_NT,21,0,0,0,0,0,0,0,0,0
SAN DIEGO,Dec 2015,DCH,2016,"Navy Region Southwest, Child and Youth Programs",DCH_SNACK_NT,20,0,0,0,0,0,0,0,0,0
SAN DIEGO,Dec 2015,DCH,2016,"Navy Region Southwest, Child and Youth Programs",DCH_SNACK_PM,22,0,0,0,0,2640,0,0,2640,120
SAN DIEGO,Dec 2015,DCH,2016,"Navy Region Southwest, Child and Youth Programs",DCH_SNACK_PM,21,0,0,0,0,0,0,0,0,0
SAN DIEGO,Dec 2015,DCH,2016,"Navy Region Southwest, Child and Youth Programs",DCH_SNACK_PM,20,0,0,0,0,0,0,0,0,0
SAN DIEGO,Dec 2015,DCH,2016,"Navy Region Southwest, Child and Youth Programs",DCH_SNACK_PM,,0,0,0,0,0,0,176,176,0
SAN DIEGO,Dec 2015,DCH,2016,"Navy Region Southwest, Child and Youth Programs",DCH_SUPPER,20,0,0,0,0,0,0,0,0,0
SAN DIEGO,Dec 2015,DCH,2016,"Navy Region Southwest, Child and Youth Programs",DCH_SUPPER,21,0,0,0,0,0,0,0,0,0
SAN DIEGO,Dec 2015,DCH,2016,"Navy Region Southwest, Child and Youth Programs",DCH_SUPPER,,0,0,0,0,0,10,0,10,0
SAN DIEGO,Dec 2015,DCH,2016,"Navy Region Southwest, Child and Youth Programs",DCH_SUPPER,22,0,0,0,0,171,0,0,171,7.7727
SAN DIEGO,Dec 2015,CACF,2016,"Navy Region Southwest, Child and Youth Programs",OSCH_CHILD_BREAKFAST,22,5,12,119,136,22,52,514,588,26.7273
SAN DIEGO,Dec 2015,CACF,2016,"Navy Region Southwest, Child and Youth Programs",OSCH_CHILD_LUNCH,22,5,12,119,136,13,31,306,350,15.9091
SAN DIEGO,Dec 2015,CACF,2016,"Navy Region Southwest, Child and Youth Programs",OSCH_CHILD_SNACK_PM,22,5,12,119,136,53,126,1252,1431,65.0455
SAN DIEGO,Jan 2016,CACF,2016,"Navy Region Southwest, Child and Youth Programs",ATRISK_CHILD_LUNCH,22,544,0,0,544,24,0,0,24,1.0909
SAN DIEGO,Jan 2016,CACF,2016,"Navy Region Southwest, Child and Youth Programs",ATRISK_CHILD_SNACK,22,544,0,0,544,10058,0,0,10058,457.1818
SAN DIEGO,Jan 2016,CACF,2016,"Navy Region Southwest, Child and Youth Programs",CHILD_BREAKFAST,21,69,163,2332,2564,975,2305,32962,36242,1725.8095
SAN DIEGO,Jan 2016,CACF,2016,"Navy Region Southwest, Child and Youth Programs",CHILD_LUNCH,21,69,163,2332,2564,1109,2622,37500,41231,1963.381
SAN DIEGO,Jan 2016,CACF,2016,"Navy Region Southwest, Child and Youth Programs",CHILD_SNACK_PM,21,69,163,2332,2564,996,2354,33658,37008,1762.2857
SAN DIEGO,Jan 2016,DCH,2016,"Navy Region Southwest, Child and Youth Programs",DCH_BREAKFAST,19,0,0,0,0,0,0,0,0,0
SAN DIEGO,Jan 2016,DCH,2016,"Navy Region Southwest, Child and Youth Programs",DCH_BREAKFAST,,0,0,0,0,0,79,206,285,0
SAN DIEGO,Jan 2016,DCH,2016,"Navy Region Southwest, Child and Youth Programs",DCH_BREAKFAST,20,0,0,0,0,3546,0,0,3546,177.3
SAN DIEGO,Jan 2016,DCH,2016,"Navy Region Southwest, Child and Youth Programs",DCH_BREAKFAST,19,0,0,0,0,0,0,0,0,0
SAN DIEGO,Jan 2016,DCH,2016,"Navy Region Southwest, Child and Youth Programs",DCH_LUNCH,20,0,0,0,0,4038,0,0,4038,201.9
SAN DIEGO,Jan 2016,DCH,2016,"Navy Region Southwest, Child and Youth Programs",DCH_LUNCH,19,0,0,0,0,0,0,0,0,0
SAN DIEGO,Jan 2016,DCH,2016,"Navy Region Southwest, Child and Youth Programs",DCH_LUNCH,19,0,0,0,0,0,0,0,0,0
SAN DIEGO,Jan 2016,DCH,2016,"Navy Region Southwest, Child and Youth Programs",DCH_LUNCH,,0,0,0,0,0,105,153,258,0
SAN DIEGO,Jan 2016,DCH,2016,"Navy Region Southwest, Child and Youth Programs",DCH_SNACK_AM,19,0,0,0,0,0,0,0,0,0
SAN DIEGO,Jan 2016,DCH,2016,"Navy Region Southwest, Child and Youth Programs",DCH_SNACK_AM,19,0,0,0,0,0,0,0,0,0
SAN DIEGO,Jan 2016,DCH,2016,"Navy Region Southwest, Child and Youth Programs",DCH_SNACK_AM,20,0,0,0,0,1986,0,0,1986,99.3
SAN DIEGO,Jan 2016,DCH,2016,"Navy Region Southwest, Child and Youth Programs",DCH_SNACK_AM,,0,0,0,0,0,71,156,227,0
SAN DIEGO,Jan 2016,DCH,2016,"Navy Region Southwest, Child and Youth Programs",DCH_SNACK_NT,20,0,0,0,0,22,0,0,22,1.1
SAN DIEGO,Jan 2016,DCH,2016,"Navy Region Southwest, Child and Youth Programs",DCH_SNACK_NT,19,0,0,0,0,0,0,0,0,0
SAN DIEGO,Jan 2016,DCH,2016,"Navy Region Southwest, Child and Youth Programs",DCH_SNACK_NT,19,0,0,0,0,0,0,0,0,0
SAN DIEGO,Jan 2016,DCH,2016,"Navy Region Southwest, Child and Youth Programs",DCH_SNACK_PM,19,0,0,0,0,0,0,0,0,0
SAN DIEGO,Jan 2016,DCH,2016,"Navy Region Southwest, Child and Youth Programs",DCH_SNACK_PM,,0,0,0,0,0,33,221,254,0
SAN DIEGO,Jan 2016,DCH,2016,"Navy Region Southwest, Child and Youth Programs",DCH_SNACK_PM,19,0,0,0,0,0,0,0,0,0
SAN DIEGO,Jan 2016,DCH,2016,"Navy Region Southwest, Child and Youth Programs",DCH_SNACK_PM,20,0,0,0,0,2786,0,0,2786,139.3
SAN DIEGO,Jan 2016,DCH,2016,"Navy Region Southwest, Child and Youth Programs",DCH_SUPPER,,0,0,0,0,0,26,0,26,0
SAN DIEGO,Jan 2016,DCH,2016,"Navy Region Southwest, Child and Youth Programs",DCH_SUPPER,20,0,0,0,0,171,0,0,171,8.55
SAN DIEGO,Jan 2016,DCH,2016,"Navy Region Southwest, Child and Youth Programs",DCH_SUPPER,19,0,0,0,0,0,0,0,0,0
SAN DIEGO,Jan 2016,DCH,2016,"Navy Region Southwest, Child and Youth Programs",DCH_SUPPER,19,0,0,0,0,0,0,0,0,0
SAN DIEGO,Jan 2016,CACF,2016,"Navy Region Southwest, Child and Youth Programs",OSCH_CHILD_BREAKFAST,21,5,12,119,136,19,46,461,526,25.0476
SAN DIEGO,Jan 2016,CACF,2016,"Navy Region Southwest, Child and Youth Programs",OSCH_CHILD_LUNCH,21,5,12,119,136,4,9,91,104,4.9524
SAN DIEGO,Jan 2016,CACF,2016,"Navy Region Southwest, Child and Youth Programs",OSCH_CHILD_SNACK_PM,21,5,12,119,136,53,126,1249,1428,68
SAN DIEGO,Feb 2016,CACF,2016,"Navy Region Southwest, Child and Youth Programs",ATRISK_CHILD_LUNCH,20,545,0,0,545,53,0,0,53,2.65
SAN DIEGO,Feb 2016,CACF,2016,"Navy Region Southwest, Child and Youth Programs",ATRISK_CHILD_SNACK,20,545,0,0,545,10519,0,0,10519,525.95
SAN DIEGO,Feb 2016,CACF,2016,"Navy Region Southwest, Child and Youth Programs",CHILD_BREAKFAST,20,69,163,2332,2564,1065,2517,35998,39580,1979
SAN DIEGO,Feb 2016,CACF,2016,"Navy Region Southwest, Child and Youth Programs",CHILD_LUNCH,20,69,163,2332,2564,1217,2877,41139,45233,2261.65
SAN DIEGO,Feb 2016,CACF,2016,"Navy Region Southwest, Child and Youth Programs",CHILD_SNACK_PM,20,69,163,2332,2564,1088,2571,36773,40432,2021.6
SAN DIEGO,Feb 2016,DCH,2016,"Navy Region Southwest, Child and Youth Programs",DCH_BREAKFAST,20,0,0,0,0,0,0,0,0,0
SAN DIEGO,Feb 2016,DCH,2016,"Navy Region Southwest, Child and Youth Programs",DCH_BREAKFAST,20,0,0,0,0,0,0,0,0,0
SAN DIEGO,Feb 2016,DCH,2016,"Navy Region Southwest, Child and Youth Programs",DCH_BREAKFAST,,0,0,0,0,0,45,186,231,0
SAN DIEGO,Feb 2016,DCH,2016,"Navy Region Southwest, Child and Youth Programs",DCH_BREAKFAST,21,0,0,0,0,4091,0,0,4091,194.8095
SAN DIEGO,Feb 2016,DCH,2016,"Navy Region Southwest, Child and Youth Programs",DCH_LUNCH,,0,0,0,0,0,102,142,244,0
SAN DIEGO,Feb 2016,DCH,2016,"Navy Region Southwest, Child and Youth Programs",DCH_LUNCH,20,0,0,0,0,0,0,0,0,0
SAN DIEGO,Feb 2016,DCH,2016,"Navy Region Southwest, Child and Youth Programs",DCH_LUNCH,20,0,0,0,0,0,0,0,0,0
SAN DIEGO,Feb 2016,DCH,2016,"Navy Region Southwest, Child and Youth Programs",DCH_LUNCH,21,0,0,0,0,4561,0,0,4561,217.1905
SAN DIEGO,Feb 2016,DCH,2016,"Navy Region Southwest, Child and Youth Programs",DCH_SNACK_AM,,0,0,0,0,0,102,120,222,0
SAN DIEGO,Feb 2016,DCH,2016,"Navy Region Southwest, Child and Youth Programs",DCH_SNACK_AM,20,0,0,0,0,0,0,0,0,0
SAN DIEGO,Feb 2016,DCH,2016,"Navy Region Southwest, Child and Youth Programs",DCH_SNACK_AM,20,0,0,0,0,0,0,0,0,0
SAN DIEGO,Feb 2016,DCH,2016,"Navy Region Southwest, Child and Youth Programs",DCH_SNACK_AM,21,0,0,0,0,2245,0,0,2245,106.9048
SAN DIEGO,Feb 2016,DCH,2016,"Navy Region Southwest, Child and Youth Programs",DCH_SNACK_NT,20,0,0,0,0,0,0,0,0,0
SAN DIEGO,Feb 2016,DCH,2016,"Navy Region Southwest, Child and Youth Programs",DCH_SNACK_NT,21,0,0,0,0,30,0,0,30,1.4286
SAN DIEGO,Feb 2016,DCH,2016,"Navy Region Southwest, Child and Youth Programs",DCH_SNACK_NT,20,0,0,0,0,0,0,0,0,0
SAN DIEGO,Feb 2016,DCH,2016,"Navy Region Southwest, Child and Youth Programs",DCH_SNACK_PM,21,0,0,0,0,3141,0,0,3141,149.5714
SAN DIEGO,Feb 2016,DCH,2016,"Navy Region Southwest, Child and Youth Programs",DCH_SNACK_PM,,0,0,0,0,0,0,173,173,0
SAN DIEGO,Feb 2016,DCH,2016,"Navy Region Southwest, Child and Youth Programs",DCH_SNACK_PM,20,0,0,0,0,0,0,0,0,0
SAN DIEGO,Feb 2016,DCH,2016,"Navy Region Southwest, Child and Youth Programs",DCH_SNACK_PM,20,0,0,0,0,0,0,0,0,0
SAN DIEGO,Feb 2016,DCH,2016,"Navy Region Southwest, Child and Youth Programs",DCH_SUPPER,21,0,0,0,0,218,0,0,218,10.381
SAN DIEGO,Feb 2016,DCH,2016,"Navy Region Southwest, Child and Youth Programs",DCH_SUPPER,,0,0,0,0,0,55,0,55,0
SAN DIEGO,Feb 2016,DCH,2016,"Navy Region Southwest, Child and Youth Programs",DCH_SUPPER,20,0,0,0,0,0,0,0,0,0
SAN DIEGO,Feb 2016,DCH,2016,"Navy Region Southwest, Child and Youth Programs",DCH_SUPPER,20,0,0,0,0,0,0,0,0,0
SAN DIEGO,Feb 2016,CACF,2016,"Navy Region Southwest, Child and Youth Programs",OSCH_CHILD_BREAKFAST,20,5,12,119,136,21,52,511,584,29.2
SAN DIEGO,Feb 2016,CACF,2016,"Navy Region Southwest, Child and Youth Programs",OSCH_CHILD_LUNCH,20,5,12,119,136,4,9,90,103,5.15
SAN DIEGO,Feb 2016,CACF,2016,"Navy Region Southwest, Child and Youth Programs",OSCH_CHILD_SNACK_PM,20,5,12,119,136,69,165,1635,1869,93.45
SAN DIEGO,Mar 2016,CACF,2016,"Navy Region Southwest, Child and Youth Programs",ATRISK_CHILD_LUNCH,23,554,0,0,554,258,0,0,258,11.2174
SAN DIEGO,Mar 2016,CACF,2016,"Navy Region Southwest, Child and Youth Programs",ATRISK_CHILD_SNACK,23,554,0,0,554,12381,0,0,12381,538.3043
SAN DIEGO,Mar 2016,CACF,2016,"Navy Region Southwest, Child and Youth Programs",CHILD_BREAKFAST,23,69,163,2332,2564,1197,2830,40473,44500,1934.7826
SAN DIEGO,Mar 2016,CACF,2016,"Navy Region Southwest, Child and Youth Programs",CHILD_LUNCH,23,69,163,2332,2564,1384,3273,46802,51459,2237.3478
SAN DIEGO,Mar 2016,CACF,2016,"Navy Region Southwest, Child and Youth Programs",CHILD_SNACK_PM,23,69,163,2332,2564,1236,2922,41790,45948,1997.7391
SAN DIEGO,Mar 2016,DCH,2016,"Navy Region Southwest, Child and Youth Programs",DCH_BREAKFAST,23,0,0,0,0,4395,0,0,4395,191.087
SAN DIEGO,Mar 2016,DCH,2016,"Navy Region Southwest, Child and Youth Programs",DCH_BREAKFAST,23,0,0,0,0,0,0,0,0,0
SAN DIEGO,Mar 2016,DCH,2016,"Navy Region Southwest, Child and Youth Programs",DCH_BREAKFAST,,0,0,0,0,0,56,206,262,0
SAN DIEGO,Mar 2016,DCH,2016,"Navy Region Southwest, Child and Youth Programs",DCH_BREAKFAST,21,0,0,0,0,0,0,0,0,0
SAN DIEGO,Mar 2016,DCH,2016,"Navy Region Southwest, Child and Youth Programs",DCH_LUNCH,23,0,0,0,0,0,0,0,0,0
SAN DIEGO,Mar 2016,DCH,2016,"Navy Region Southwest, Child and Youth Programs",DCH_LUNCH,21,0,0,0,0,0,0,0,0,0
SAN DIEGO,Mar 2016,DCH,2016,"Navy Region Southwest, Child and Youth Programs",DCH_LUNCH,23,0,0,0,0,5032,0,0,5032,218.7826
SAN DIEGO,Mar 2016,DCH,2016,"Navy Region Southwest, Child and Youth Programs",DCH_LUNCH,,0,0,0,0,0,117,161,278,0
SAN DIEGO,Mar 2016,DCH,2016,"Navy Region Southwest, Child and Youth Programs",DCH_SNACK_AM,21,0,0,0,0,0,0,0,0,0
SAN DIEGO,Mar 2016,DCH,2016,"Navy Region Southwest, Child and Youth Programs",DCH_SNACK_AM,23,0,0,0,0,0,0,0,0,0
SAN DIEGO,Mar 2016,DCH,2016,"Navy Region Southwest, Child and Youth Programs",DCH_SNACK_AM,23,0,0,0,0,2749,0,0,2749,119.5217
SAN DIEGO,Mar 2016,DCH,2016,"Navy Region Southwest, Child and Youth Programs",DCH_SNACK_AM,,0,0,0,0,0,113,167,280,0
SAN DIEGO,Mar 2016,DCH,2016,"Navy Region Southwest, Child and Youth Programs",DCH_SNACK_NT,23,0,0,0,0,0,0,0,0,0
SAN DIEGO,Mar 2016,DCH,2016,"Navy Region Southwest, Child and Youth Programs",DCH_SNACK_NT,21,0,0,0,0,0,0,0,0,0
SAN DIEGO,Mar 2016,DCH,2016,"Navy Region Southwest, Child and Youth Programs",DCH_SNACK_NT,23,0,0,0,0,23,0,0,23,1
SAN DIEGO,Mar 2016,DCH,2016,"Navy Region Southwest, Child and Youth Programs",DCH_SNACK_PM,23,0,0,0,0,3205,0,0,3205,139.3478
SAN DIEGO,Mar 2016,DCH,2016,"Navy Region Southwest, Child and Youth Programs",DCH_SNACK_PM,23,0,0,0,0,0,0,0,0,0
SAN DIEGO,Mar 2016,DCH,2016,"Navy Region Southwest, Child and Youth Programs",DCH_SNACK_PM,21,0,0,0,0,0,0,0,0,0
SAN DIEGO,Mar 2016,DCH,2016,"Navy Region Southwest, Child and Youth Programs",DCH_SNACK_PM,,0,0,0,0,0,1,206,207,0
SAN DIEGO,Mar 2016,DCH,2016,"Navy Region Southwest, Child and Youth Programs",DCH_SUPPER,23,0,0,0,0,0,0,0,0,0
SAN DIEGO,Mar 2016,DCH,2016,"Navy Region Southwest, Child and Youth Programs",DCH_SUPPER,21,0,0,0,0,0,0,0,0,0
SAN DIEGO,Mar 2016,DCH,2016,"Navy Region Southwest, Child and Youth Programs",DCH_SUPPER,23,0,0,0,0,213,0,0,213,9.2609
SAN DIEGO,Mar 2016,DCH,2016,"Navy Region Southwest, Child and Youth Programs",DCH_SUPPER,,0,0,0,0,0,57,0,57,0
SAN DIEGO,Mar 2016,CACF,2016,"Navy Region Southwest, Child and Youth Programs",OSCH_CHILD_BREAKFAST,23,5,12,119,136,35,83,827,945,41.087
SAN DIEGO,Mar 2016,CACF,2016,"Navy Region Southwest, Child and Youth Programs",OSCH_CHILD_LUNCH,23,5,12,119,136,19,45,450,514,22.3478
SAN DIEGO,Mar 2016,CACF,2016,"Navy Region Southwest, Child and Youth Programs",OSCH_CHILD_SNACK_PM,23,5,12,119,136,81,195,1938,2214,96.2609
SAN DIEGO,Apr 2016,CACF,2016,"Navy Region Southwest, Child and Youth Programs",ATRISK_CHILD_LUNCH,21,556,0,0,556,13,0,0,13,0.619
SAN DIEGO,Apr 2016,CACF,2016,"Navy Region Southwest, Child and Youth Programs",ATRISK_CHILD_SNACK,21,556,0,0,556,11379,0,0,11379,541.8571
SAN DIEGO,Apr 2016,CACF,2016,"Navy Region Southwest, Child and Youth Programs",CHILD_BREAKFAST,21,69,163,2332,2564,1148,2714,38809,42671,2031.9524
SAN DIEGO,Apr 2016,CACF,2016,"Navy Region Southwest, Child and Youth Programs",CHILD_LUNCH,21,69,163,2332,2564,1265,2992,42783,47040,2240
SAN DIEGO,Apr 2016,CACF,2016,"Navy Region Southwest, Child and Youth Programs",CHILD_SNACK_PM,21,69,163,2332,2564,1182,2795,39974,43951,2092.9048
SAN DIEGO,Apr 2016,DCH,2016,"Navy Region Southwest, Child and Youth Programs",DCH_BREAKFAST,21,0,0,0,0,0,0,0,0,0
SAN DIEGO,Apr 2016,DCH,2016,"Navy Region Southwest, Child and Youth Programs",DCH_BREAKFAST,,0,0,0,0,0,46,190,236,0
SAN DIEGO,Apr 2016,DCH,2016,"Navy Region Southwest, Child and Youth Programs",DCH_BREAKFAST,21,0,0,0,0,0,0,0,0,0
SAN DIEGO,Apr 2016,DCH,2016,"Navy Region Southwest, Child and Youth Programs",DCH_BREAKFAST,22,0,0,0,0,4415,0,0,4415,200.6818
SAN DIEGO,Apr 2016,DCH,2016,"Navy Region Southwest, Child and Youth Programs",DCH_LUNCH,,0,0,0,0,0,113,154,267,0
SAN DIEGO,Apr 2016,DCH,2016,"Navy Region Southwest, Child and Youth Programs",DCH_LUNCH,21,0,0,0,0,0,0,0,0,0
SAN DIEGO,Apr 2016,DCH,2016,"Navy Region Southwest, Child and Youth Programs",DCH_LUNCH,21,0,0,0,0,0,0,0,0,0
SAN DIEGO,Apr 2016,DCH,2016,"Navy Region Southwest, Child and Youth Programs",DCH_LUNCH,22,0,0,0,0,4797,0,0,4797,218.0455
SAN DIEGO,Apr 2016,DCH,2016,"Navy Region Southwest, Child and Youth Programs",DCH_SNACK_AM,21,0,0,0,0,0,0,0,0,0
SAN DIEGO,Apr 2016,DCH,2016,"Navy Region Southwest, Child and Youth Programs",DCH_SNACK_AM,21,0,0,0,0,0,0,0,0,0
SAN DIEGO,Apr 2016,DCH,2016,"Navy Region Southwest, Child and Youth Programs",DCH_SNACK_AM,,0,0,0,0,0,103,128,231,0
SAN DIEGO,Apr 2016,DCH,2016,"Navy Region Southwest, Child and Youth Programs",DCH_SNACK_AM,22,0,0,0,0,2519,0,0,2519,114.5
SAN DIEGO,Apr 2016,DCH,2016,"Navy Region Southwest, Child and Youth Programs",DCH_SNACK_NT,21,0,0,0,0,0,0,0,0,0
SAN DIEGO,Apr 2016,DCH,2016,"Navy Region Southwest, Child and Youth Programs",DCH_SNACK_NT,22,0,0,0,0,27,0,0,27,1.2273
SAN DIEGO,Apr 2016,DCH,2016,"Navy Region Southwest, Child and Youth Programs",DCH_SNACK_NT,21,0,0,0,0,0,0,0,0,0
SAN DIEGO,Apr 2016,DCH,2016,"Navy Region Southwest, Child and Youth Programs",DCH_SNACK_PM,,0,0,0,0,0,0,173,173,0
SAN DIEGO,Apr 2016,DCH,2016,"Navy Region Southwest, Child and Youth Programs",DCH_SNACK_PM,21,0,0,0,0,0,0,0,0,0
SAN DIEGO,Apr 2016,DCH,2016,"Navy Region Southwest, Child and Youth Programs",DCH_SNACK_PM,21,0,0,0,0,0,0,0,0,0
SAN DIEGO,Apr 2016,DCH,2016,"Navy Region Southwest, Child and Youth Programs",DCH_SNACK_PM,22,0,0,0,0,3056,0,0,3056,138.9091
SAN DIEGO,Apr 2016,DCH,2016,"Navy Region Southwest, Child and Youth Programs",DCH_SUPPER,,0,0,0,0,0,65,0,65,0
SAN DIEGO,Apr 2016,DCH,2016,"Navy Region Southwest, Child and Youth Programs",DCH_SUPPER,21,0,0,0,0,0,0,0,0,0
SAN DIEGO,Apr 2016,DCH,2016,"Navy Region Southwest, Child and Youth Programs",DCH_SUPPER,22,0,0,0,0,179,0,0,179,8.1364
SAN DIEGO,Apr 2016,DCH,2016,"Navy Region Southwest, Child and Youth Programs",DCH_SUPPER,21,0,0,0,0,0,0,0,0,0
SAN DIEGO,Apr 2016,CACF,2016,"Navy Region Southwest, Child and Youth Programs",OSCH_CHILD_BREAKFAST,21,5,12,119,136,26,62,618,706,33.619
SAN DIEGO,Apr 2016,CACF,2016,"Navy Region Southwest, Child and Youth Programs",OSCH_CHILD_LUNCH,21,5,12,119,136,5,12,116,133,6.3333
SAN DIEGO,Apr 2016,CACF,2016,"Navy Region Southwest, Child and Youth Programs",OSCH_CHILD_SNACK_PM,21,5,12,119,136,80,191,1896,2167,103.1905
SAN DIEGO,May 2016,CACF,2016,"Navy Region Southwest, Child and Youth Programs",ATRISK_CHILD_SNACK,21,525,0,0,525,10809,0,0,10809,514.7143
SAN DIEGO,May 2016,CACF,2016,"Navy Region Southwest, Child and Youth Programs",CHILD_BREAKFAST,21,69,163,2332,2564,1118,2644,37806,41568,1979.4286
SAN DIEGO,May 2016,CACF,2016,"Navy Region Southwest, Child and Youth Programs",CHILD_LUNCH,21,69,163,2332,2564,1267,2996,42851,47114,2243.5238
SAN DIEGO,May 2016,CACF,2016,"Navy Region Southwest, Child and Youth Programs",CHILD_SNACK_PM,21,69,163,2332,2564,1158,2737,39141,43036,2049.3333
SAN DIEGO,May 2016,DCH,2016,"Navy Region Southwest, Child and Youth Programs",DCH_BREAKFAST,22,0,0,0,0,0,0,0,0,0
SAN DIEGO,May 2016,DCH,2016,"Navy Region Southwest, Child and Youth Programs",DCH_BREAKFAST,21,0,0,0,0,0,0,0,0,0
SAN DIEGO,May 2016,DCH,2016,"Navy Region Southwest, Child and Youth Programs",DCH_BREAKFAST,,0,0,0,0,0,34,188,222,0
SAN DIEGO,May 2016,DCH,2016,"Navy Region Southwest, Child and Youth Programs",DCH_BREAKFAST,22,0,0,0,0,4304,0,0,4304,195.6364
SAN DIEGO,May 2016,DCH,2016,"Navy Region Southwest, Child and Youth Programs",DCH_LUNCH,22,0,0,0,0,4717,0,0,4717,214.4091
SAN DIEGO,May 2016,DCH,2016,"Navy Region Southwest, Child and Youth Programs",DCH_LUNCH,22,0,0,0,0,0,0,0,0,0
SAN DIEGO,May 2016,DCH,2016,"Navy Region Southwest, Child and Youth Programs",DCH_LUNCH,21,0,0,0,0,0,0,0,0,0
SAN DIEGO,May 2016,DCH,2016,"Navy Region Southwest, Child and Youth Programs",DCH_LUNCH,,0,0,0,0,0,100,181,281,0
SAN DIEGO,May 2016,DCH,2016,"Navy Region Southwest, Child and Youth Programs",DCH_SNACK_AM,22,0,0,0,0,2402,0,0,2402,109.1818
SAN DIEGO,May 2016,DCH,2016,"Navy Region Southwest, Child and Youth Programs",DCH_SNACK_AM,,0,0,0,0,0,97,166,263,0
SAN DIEGO,May 2016,DCH,2016,"Navy Region Southwest, Child and Youth Programs",DCH_SNACK_AM,21,0,0,0,0,0,0,0,0,0
SAN DIEGO,May 2016,DCH,2016,"Navy Region Southwest, Child and Youth Programs",DCH_SNACK_AM,22,0,0,0,0,0,0,0,0,0
SAN DIEGO,May 2016,DCH,2016,"Navy Region Southwest, Child and Youth Programs",DCH_SNACK_NT,22,0,0,0,0,0,0,0,0,0
SAN DIEGO,May 2016,DCH,2016,"Navy Region Southwest, Child and Youth Programs",DCH_SNACK_NT,22,0,0,0,0,23,0,0,23,1.0455
SAN DIEGO,May 2016,DCH,2016,"Navy Region Southwest, Child and Youth Programs",DCH_SNACK_NT,21,0,0,0,0,0,0,0,0,0
SAN DIEGO,May 2016,DCH,2016,"Navy Region Southwest, Child and Youth Programs",DCH_SNACK_PM,,0,0,0,0,0,0,219,219,0
SAN DIEGO,May 2016,DCH,2016,"Navy Region Southwest, Child and Youth Programs",DCH_SNACK_PM,21,0,0,0,0,0,0,0,0,0
SAN DIEGO,May 2016,DCH,2016,"Navy Region Southwest, Child and Youth Programs",DCH_SNACK_PM,22,0,0,0,0,0,0,0,0,0
SAN DIEGO,May 2016,DCH,2016,"Navy Region Southwest, Child and Youth Programs",DCH_SNACK_PM,22,0,0,0,0,3223,0,0,3223,146.5
SAN DIEGO,May 2016,DCH,2016,"Navy Region Southwest, Child and Youth Programs",DCH_SUPPER,22,0,0,0,0,174,0,0,174,7.9091
SAN DIEGO,May 2016,DCH,2016,"Navy Region Southwest, Child and Youth Programs",DCH_SUPPER,,0,0,0,0,0,67,0,67,0
SAN DIEGO,May 2016,DCH,2016,"Navy Region Southwest, Child and Youth Programs",DCH_SUPPER,21,0,0,0,0,0,0,0,0,0
SAN DIEGO,May 2016,DCH,2016,"Navy Region Southwest, Child and Youth Programs",DCH_SUPPER,22,0,0,0,0,0,0,0,0,0
SAN DIEGO,May 2016,CACF,2016,"Navy Region Southwest, Child and Youth Programs",OSCH_CHILD_BREAKFAST,21,5,12,119,136,26,64,630,720,34.2857
SAN DIEGO,May 2016,CACF,2016,"Navy Region Southwest, Child and Youth Programs",OSCH_CHILD_LUNCH,21,5,12,119,136,0,1,9,10,0.4762
SAN DIEGO,May 2016,CACF,2016,"Navy Region Southwest, Child and Youth Programs",OSCH_CHILD_SNACK_PM,21,5,12,119,136,74,178,1769,2021,96.2381
SAN DIEGO,Jun 2016,CACF,2016,"Navy Region Southwest, Child and Youth Programs",ATRISK_CHILD_SNACK,20,231,0,0,231,4344,0,0,4344,217.2
SAN DIEGO,Jun 2016,CACF,2016,"Navy Region Southwest, Child and Youth Programs",CHILD_BREAKFAST,20,69,163,2332,2564,1125,2660,38035,41820,2091
SAN DIEGO,Jun 2016,CACF,2016,"Navy Region Southwest, Child and Youth Programs",CHILD_LUNCH,20,69,163,2332,2564,1167,2760,39473,43400,2170
SAN DIEGO,Jun 2016,CACF,2016,"Navy Region Southwest, Child and Youth Programs",CHILD_SNACK_PM,20,69,163,2332,2564,1127,2665,38114,41906,2095.3
SAN DIEGO,Jun 2016,DCH,2016,"Navy Region Southwest, Child and Youth Programs",DCH_BREAKFAST,22,0,0,0,0,0,0,0,0,0
SAN DIEGO,Jun 2016,DCH,2016,"Navy Region Southwest, Child and Youth Programs",DCH_BREAKFAST,22,0,0,0,0,0,0,0,0,0
SAN DIEGO,Jun 2016,DCH,2016,"Navy Region Southwest, Child and Youth Programs",DCH_BREAKFAST,22,0,0,0,0,4248,0,0,4248,193.0909
SAN DIEGO,Jun 2016,DCH,2016,"Navy Region Southwest, Child and Youth Programs",DCH_BREAKFAST,,0,0,0,0,0,42,197,239,0
SAN DIEGO,Jun 2016,DCH,2016,"Navy Region Southwest, Child and Youth Programs",DCH_LUNCH,22,0,0,0,0,0,0,0,0,0
SAN DIEGO,Jun 2016,DCH,2016,"Navy Region Southwest, Child and Youth Programs",DCH_LUNCH,,0,0,0,0,0,107,163,270,0
SAN DIEGO,Jun 2016,DCH,2016,"Navy Region Southwest, Child and Youth Programs",DCH_LUNCH,22,0,0,0,0,4940,0,0,4940,224.5455
SAN DIEGO,Jun 2016,DCH,2016,"Navy Region Southwest, Child and Youth Programs",DCH_LUNCH,22,0,0,0,0,0,0,0,0,0
SAN DIEGO,Jun 2016,DCH,2016,"Navy Region Southwest, Child and Youth Programs",DCH_SNACK_AM,22,0,0,0,0,0,0,0,0,0
SAN DIEGO,Jun 2016,DCH,2016,"Navy Region Southwest, Child and Youth Programs",DCH_SNACK_AM,22,0,0,0,0,2422,0,0,2422,110.0909
SAN DIEGO,Jun 2016,DCH,2016,"Navy Region Southwest, Child and Youth Programs",DCH_SNACK_AM,,0,0,0,0,0,103,157,260,0
SAN DIEGO,Jun 2016,DCH,2016,"Navy Region Southwest, Child and Youth Programs",DCH_SNACK_AM,22,0,0,0,0,0,0,0,0,0
SAN DIEGO,Jun 2016,DCH,2016,"Navy Region Southwest, Child and Youth Programs",DCH_SNACK_NT,22,0,0,0,0,0,0,0,0,0
SAN DIEGO,Jun 2016,DCH,2016,"Navy Region Southwest, Child and Youth Programs",DCH_SNACK_NT,22,0,0,0,0,0,0,0,0,0
SAN DIEGO,Jun 2016,DCH,2016,"Navy Region Southwest, Child and Youth Programs",DCH_SNACK_NT,22,0,0,0,0,1,0,0,1,0.0455
SAN DIEGO,Jun 2016,DCH,2016,"Navy Region Southwest, Child and Youth Programs",DCH_SNACK_PM,,0,0,0,0,0,0,209,209,0
SAN DIEGO,Jun 2016,DCH,2016,"Navy Region Southwest, Child and Youth Programs",DCH_SNACK_PM,22,0,0,0,0,3241,0,0,3241,147.3182
SAN DIEGO,Jun 2016,DCH,2016,"Navy Region Southwest, Child and Youth Programs",DCH_SNACK_PM,22,0,0,0,0,0,0,0,0,0
SAN DIEGO,Jun 2016,DCH,2016,"Navy Region Southwest, Child and Youth Programs",DCH_SNACK_PM,22,0,0,0,0,0,0,0,0,0
SAN DIEGO,Jun 2016,DCH,2016,"Navy Region Southwest, Child and Youth Programs",DCH_SUPPER,22,0,0,0,0,168,0,0,168,7.6364
SAN DIEGO,Jun 2016,DCH,2016,"Navy Region Southwest, Child and Youth Programs",DCH_SUPPER,,0,0,0,0,0,31,0,31,0
SAN DIEGO,Jun 2016,DCH,2016,"Navy Region Southwest, Child and Youth Programs",DCH_SUPPER,22,0,0,0,0,0,0,0,0,0
SAN DIEGO,Jun 2016,DCH,2016,"Navy Region Southwest, Child and Youth Programs",DCH_SUPPER,22,0,0,0,0,0,0,0,0,0
SAN DIEGO,Jun 2016,CACF,2016,"Navy Region Southwest, Child and Youth Programs",OSCH_CHILD_BREAKFAST,20,5,12,119,136,48,114,1129,1291,64.55
SAN DIEGO,Jun 2016,CACF,2016,"Navy Region Southwest, Child and Youth Programs",OSCH_CHILD_LUNCH,20,5,12,119,136,44,105,1036,1185,59.25
SAN DIEGO,Jun 2016,CACF,2016,"Navy Region Southwest, Child and Youth Programs",OSCH_CHILD_SNACK_PM,20,5,12,119,136,78,187,1859,2124,106.2
SAN DIEGO,Jul 2016,CACF,2016,"Navy Region Southwest, Child and Youth Programs",CHILD_BREAKFAST,20,69,163,2332,2564,943,2230,31888,35061,1753.05
SAN DIEGO,Jul 2016,CACF,2016,"Navy Region Southwest, Child and Youth Programs",CHILD_LUNCH,20,69,163,2332,2564,1092,2581,36908,40581,2029.05
SAN DIEGO,Jul 2016,CACF,2016,"Navy Region Southwest, Child and Youth Programs",CHILD_SNACK_PM,20,69,163,2332,2564,973,2301,32905,36179,1808.95
SAN DIEGO,Jul 2016,DCH,2016,"Navy Region Southwest, Child and Youth Programs",DCH_BREAKFAST,9,0,0,0,0,0,0,0,0,0
SAN DIEGO,Jul 2016,DCH,2016,"Navy Region Southwest, Child and Youth Programs",DCH_BREAKFAST,,0,0,0,0,0,35,230,265,0
SAN DIEGO,Jul 2016,DCH,2016,"Navy Region Southwest, Child and Youth Programs",DCH_BREAKFAST,20,0,0,0,0,0,0,0,0,0
SAN DIEGO,Jul 2016,DCH,2016,"Navy Region Southwest, Child and Youth Programs",DCH_BREAKFAST,20,0,0,0,0,0,0,0,0,0
SAN DIEGO,Jul 2016,DCH,2016,"Navy Region Southwest, Child and Youth Programs",DCH_BREAKFAST,20,0,0,0,0,3312,0,0,3312,165.6
SAN DIEGO,Jul 2016,DCH,2016,"Navy Region Southwest, Child and Youth Programs",DCH_LUNCH,20,0,0,0,0,0,0,0,0,0
SAN DIEGO,Jul 2016,DCH,2016,"Navy Region Southwest, Child and Youth Programs",DCH_LUNCH,20,0,0,0,0,0,0,0,0,0
SAN DIEGO,Jul 2016,DCH,2016,"Navy Region Southwest, Child and Youth Programs",DCH_LUNCH,9,0,0,0,0,0,0,0,0,0
SAN DIEGO,Jul 2016,DCH,2016,"Navy Region Southwest, Child and Youth Programs",DCH_LUNCH,,0,0,0,0,0,120,217,337,0
SAN DIEGO,Jul 2016,DCH,2016,"Navy Region Southwest, Child and Youth Programs",DCH_LUNCH,20,0,0,0,0,4247,0,0,4247,212.35
SAN DIEGO,Jul 2016,DCH,2016,"Navy Region Southwest, Child and Youth Programs",DCH_SNACK_AM,20,0,0,0,0,0,0,0,0,0
SAN DIEGO,Jul 2016,DCH,2016,"Navy Region Southwest, Child and Youth Programs",DCH_SNACK_AM,,0,0,0,0,0,102,135,237,0
SAN DIEGO,Jul 2016,DCH,2016,"Navy Region Southwest, Child and Youth Programs",DCH_SNACK_AM,20,0,0,0,0,0,0,0,0,0
SAN DIEGO,Jul 2016,DCH,2016,"Navy Region Southwest, Child and Youth Programs",DCH_SNACK_AM,20,0,0,0,0,2107,0,0,2107,105.35
SAN DIEGO,Jul 2016,DCH,2016,"Navy Region Southwest, Child and Youth Programs",DCH_SNACK_AM,9,0,0,0,0,0,0,0,0,0
SAN DIEGO,Jul 2016,DCH,2016,"Navy Region Southwest, Child and Youth Programs",DCH_SNACK_PM,20,0,0,0,0,2640,0,0,2640,132
SAN DIEGO,Jul 2016,DCH,2016,"Navy Region Southwest, Child and Youth Programs",DCH_SNACK_PM,,0,0,0,0,0,3,257,260,0
SAN DIEGO,Jul 2016,DCH,2016,"Navy Region Southwest, Child and Youth Programs",DCH_SNACK_PM,9,0,0,0,0,0,0,0,0,0
SAN DIEGO,Jul 2016,DCH,2016,"Navy Region Southwest, Child and Youth Programs",DCH_SNACK_PM,20,0,0,0,0,0,0,0,0,0
SAN DIEGO,Jul 2016,DCH,2016,"Navy Region Southwest, Child and Youth Programs",DCH_SNACK_PM,20,0,0,0,0,0,0,0,0,0
SAN DIEGO,Jul 2016,DCH,2016,"Navy Region Southwest, Child and Youth Programs",DCH_SUPPER,20,0,0,0,0,148,0,0,148,7.4
SAN DIEGO,Jul 2016,DCH,2016,"Navy Region Southwest, Child and Youth Programs",DCH_SUPPER,20,0,0,0,0,0,0,0,0,0
SAN DIEGO,Jul 2016,DCH,2016,"Navy Region Southwest, Child and Youth Programs",DCH_SUPPER,20,0,0,0,0,0,0,0,0,0
SAN DIEGO,Jul 2016,DCH,2016,"Navy Region Southwest, Child and Youth Programs",DCH_SUPPER,,0,0,0,0,0,45,5,50,0
SAN DIEGO,Jul 2016,DCH,2016,"Navy Region Southwest, Child and Youth Programs",DCH_SUPPER,9,0,0,0,0,0,0,0,0,0
SAN DIEGO,Jul 2016,CACF,2016,"Navy Region Southwest, Child and Youth Programs",OSCH_CHILD_BREAKFAST,20,5,12,119,136,48,116,1147,1311,65.55
SAN DIEGO,Jul 2016,CACF,2016,"Navy Region Southwest, Child and Youth Programs",OSCH_CHILD_LUNCH,20,5,12,119,136,78,188,1863,2129,106.45
SAN DIEGO,Jul 2016,CACF,2016,"Navy Region Southwest, Child and Youth Programs",OSCH_CHILD_SNACK_PM,20,5,12,119,136,72,173,1717,1962,98.1
SAN DIEGO,Oct 2015,CACF,2016,NEIGHBORHOOD HOUSE ASSOCIATION ,ADULT_LUNCH,22,65,0,11,76,891,0,151,1042,47.3636
SAN DIEGO,Oct 2015,CACF,2016,NEIGHBORHOOD HOUSE ASSOCIATION ,ADULT_SNACK_AM,22,65,0,11,76,878,0,148,1026,46.6364
SAN DIEGO,Oct 2015,CACF,2016,NEIGHBORHOOD HOUSE ASSOCIATION ,ADULT_SNACK_PM,22,65,0,11,76,850,0,144,994,45.1818
SAN DIEGO,Oct 2015,CACF,2016,NEIGHBORHOOD HOUSE ASSOCIATION ,HS_CHILD_BREAKFAST,22,2221,0,0,2221,25002,0,0,25002,1136.4545
SAN DIEGO,Oct 2015,CACF,2016,NEIGHBORHOOD HOUSE ASSOCIATION ,HS_CHILD_LUNCH,22,2221,0,0,2221,32762,0,0,32762,1489.1818
SAN DIEGO,Oct 2015,CACF,2016,NEIGHBORHOOD HOUSE ASSOCIATION ,HS_CHILD_SNACK_AM,22,2221,0,0,2221,325,0,0,325,14.7727
SAN DIEGO,Oct 2015,CACF,2016,NEIGHBORHOOD HOUSE ASSOCIATION ,HS_CHILD_SNACK_PM,22,2221,0,0,2221,19076,0,0,19076,867.0909
SAN DIEGO,Nov 2015,CACF,2016,NEIGHBORHOOD HOUSE ASSOCIATION ,ADULT_LUNCH,19,65,0,11,76,824,0,139,963,50.6842
SAN DIEGO,Nov 2015,CACF,2016,NEIGHBORHOOD HOUSE ASSOCIATION ,ADULT_SNACK_AM,19,65,0,11,76,817,0,138,955,50.2632
SAN DIEGO,Nov 2015,CACF,2016,NEIGHBORHOOD HOUSE ASSOCIATION ,ADULT_SNACK_PM,19,65,0,11,76,802,0,136,938,49.3684
SAN DIEGO,Nov 2015,CACF,2016,NEIGHBORHOOD HOUSE ASSOCIATION ,HS_CHILD_BREAKFAST,17,2221,0,0,2221,16848,0,0,16848,991.0588
SAN DIEGO,Nov 2015,CACF,2016,NEIGHBORHOOD HOUSE ASSOCIATION ,HS_CHILD_LUNCH,17,2221,0,0,2221,22286,0,0,22286,1310.9412
SAN DIEGO,Nov 2015,CACF,2016,NEIGHBORHOOD HOUSE ASSOCIATION ,HS_CHILD_SNACK_AM,17,2221,0,0,2221,244,0,0,244,14.3529
SAN DIEGO,Nov 2015,CACF,2016,NEIGHBORHOOD HOUSE ASSOCIATION ,HS_CHILD_SNACK_PM,17,2221,0,0,2221,12903,0,0,12903,759
SAN DIEGO,Dec 2015,CACF,2016,NEIGHBORHOOD HOUSE ASSOCIATION ,ADULT_LUNCH,21,65,0,11,76,894,0,151,1045,49.7619
SAN DIEGO,Dec 2015,CACF,2016,NEIGHBORHOOD HOUSE ASSOCIATION ,ADULT_SNACK_AM,21,65,0,11,76,882,0,149,1031,49.0952
SAN DIEGO,Dec 2015,CACF,2016,NEIGHBORHOOD HOUSE ASSOCIATION ,ADULT_SNACK_PM,21,65,0,11,76,873,0,148,1021,48.619
SAN DIEGO,Dec 2015,CACF,2016,NEIGHBORHOOD HOUSE ASSOCIATION ,HS_CHILD_BREAKFAST,17,2221,0,0,2221,14824,0,0,14824,872
SAN DIEGO,Dec 2015,CACF,2016,NEIGHBORHOOD HOUSE ASSOCIATION ,HS_CHILD_LUNCH,17,2221,0,0,2221,19452,0,0,19452,1144.2353
SAN DIEGO,Dec 2015,CACF,2016,NEIGHBORHOOD HOUSE ASSOCIATION ,HS_CHILD_SNACK_AM,17,2221,0,0,2221,187,0,0,187,11
SAN DIEGO,Dec 2015,CACF,2016,NEIGHBORHOOD HOUSE ASSOCIATION ,HS_CHILD_SNACK_PM,17,2221,0,0,2221,10474,0,0,10474,616.1176
SAN DIEGO,Jan 2016,CACF,2016,NEIGHBORHOOD HOUSE ASSOCIATION ,ADULT_LUNCH,20,65,0,11,76,840,0,142,982,49.1
SAN DIEGO,Jan 2016,CACF,2016,NEIGHBORHOOD HOUSE ASSOCIATION ,ADULT_SNACK_AM,20,65,0,11,76,831,0,141,972,48.6
SAN DIEGO,Jan 2016,CACF,2016,NEIGHBORHOOD HOUSE ASSOCIATION ,ADULT_SNACK_PM,20,65,0,11,76,818,0,138,956,47.8
SAN DIEGO,Jan 2016,CACF,2016,NEIGHBORHOOD HOUSE ASSOCIATION ,HS_CHILD_BREAKFAST,18,2221,0,0,2221,18850,0,0,18850,1047.2222
SAN DIEGO,Jan 2016,CACF,2016,NEIGHBORHOOD HOUSE ASSOCIATION ,HS_CHILD_LUNCH,18,2221,0,0,2221,24879,0,0,24879,1382.1667
SAN DIEGO,Jan 2016,CACF,2016,NEIGHBORHOOD HOUSE ASSOCIATION ,HS_CHILD_SNACK_AM,18,2221,0,0,2221,239,0,0,239,13.2778
SAN DIEGO,Jan 2016,CACF,2016,NEIGHBORHOOD HOUSE ASSOCIATION ,HS_CHILD_SNACK_PM,18,2221,0,0,2221,14403,0,0,14403,800.1667
SAN DIEGO,Feb 2016,CACF,2016,NEIGHBORHOOD HOUSE ASSOCIATION ,ADULT_LUNCH,21,65,0,11,76,873,0,148,1021,48.619
SAN DIEGO,Feb 2016,CACF,2016,NEIGHBORHOOD HOUSE ASSOCIATION ,ADULT_SNACK_AM,21,65,0,11,76,866,0,147,1013,48.2381
SAN DIEGO,Feb 2016,CACF,2016,NEIGHBORHOOD HOUSE ASSOCIATION ,ADULT_SNACK_PM,21,65,0,11,76,848,0,144,992,47.2381
SAN DIEGO,Feb 2016,CACF,2016,NEIGHBORHOOD HOUSE ASSOCIATION ,HS_CHILD_BREAKFAST,19,2221,0,0,2221,21539,0,0,21539,1133.6316
SAN DIEGO,Feb 2016,CACF,2016,NEIGHBORHOOD HOUSE ASSOCIATION ,HS_CHILD_LUNCH,19,2221,0,0,2221,28602,0,0,28602,1505.3684
SAN DIEGO,Feb 2016,CACF,2016,NEIGHBORHOOD HOUSE ASSOCIATION ,HS_CHILD_SNACK_AM,19,2221,0,0,2221,282,0,0,282,14.8421
SAN DIEGO,Feb 2016,CACF,2016,NEIGHBORHOOD HOUSE ASSOCIATION ,HS_CHILD_SNACK_PM,19,2221,0,0,2221,16324,0,0,16324,859.1579
SAN DIEGO,Mar 2016,CACF,2016,NEIGHBORHOOD HOUSE ASSOCIATION ,ADULT_LUNCH,23,65,0,11,76,910,0,154,1064,46.2609
SAN DIEGO,Mar 2016,CACF,2016,NEIGHBORHOOD HOUSE ASSOCIATION ,ADULT_SNACK_AM,23,65,0,11,76,907,0,153,1060,46.087
SAN DIEGO,Mar 2016,CACF,2016,NEIGHBORHOOD HOUSE ASSOCIATION ,ADULT_SNACK_PM,23,65,0,11,76,893,0,151,1044,45.3913
SAN DIEGO,Mar 2016,CACF,2016,NEIGHBORHOOD HOUSE ASSOCIATION ,HS_CHILD_BREAKFAST,21,2221,0,0,2221,21451,0,0,21451,1021.4762
SAN DIEGO,Mar 2016,CACF,2016,NEIGHBORHOOD HOUSE ASSOCIATION ,HS_CHILD_LUNCH,21,2221,0,0,2221,28331,0,0,28331,1349.0952
SAN DIEGO,Mar 2016,CACF,2016,NEIGHBORHOOD HOUSE ASSOCIATION ,HS_CHILD_SNACK_AM,21,2221,0,0,2221,269,0,0,269,12.8095
SAN DIEGO,Mar 2016,CACF,2016,NEIGHBORHOOD HOUSE ASSOCIATION ,HS_CHILD_SNACK_PM,21,2221,0,0,2221,16019,0,0,16019,762.8095
SAN DIEGO,Apr 2016,CACF,2016,NEIGHBORHOOD HOUSE ASSOCIATION ,ADULT_LUNCH,21,65,0,11,76,852,0,144,996,47.4286
SAN DIEGO,Apr 2016,CACF,2016,NEIGHBORHOOD HOUSE ASSOCIATION ,ADULT_SNACK_AM,21,65,0,11,76,848,0,144,992,47.2381
SAN DIEGO,Apr 2016,CACF,2016,NEIGHBORHOOD HOUSE ASSOCIATION ,ADULT_SNACK_PM,21,65,0,11,76,830,0,141,971,46.2381
SAN DIEGO,Apr 2016,CACF,2016,NEIGHBORHOOD HOUSE ASSOCIATION ,HS_CHILD_BREAKFAST,21,2221,0,0,2221,22484,0,0,22484,1070.6667
SAN DIEGO,Apr 2016,CACF,2016,NEIGHBORHOOD HOUSE ASSOCIATION ,HS_CHILD_LUNCH,21,2221,0,0,2221,29914,0,0,29914,1424.4762
SAN DIEGO,Apr 2016,CACF,2016,NEIGHBORHOOD HOUSE ASSOCIATION ,HS_CHILD_SNACK_AM,21,2221,0,0,2221,302,0,0,302,14.381
SAN DIEGO,Apr 2016,CACF,2016,NEIGHBORHOOD HOUSE ASSOCIATION ,HS_CHILD_SNACK_PM,21,2221,0,0,2221,16595,0,0,16595,790.2381
SAN DIEGO,May 2016,CACF,2016,NEIGHBORHOOD HOUSE ASSOCIATION ,ADULT_LUNCH,21,65,0,11,76,870,0,147,1017,48.4286
SAN DIEGO,May 2016,CACF,2016,NEIGHBORHOOD HOUSE ASSOCIATION ,ADULT_SNACK_AM,21,65,0,11,76,864,0,146,1010,48.0952
SAN DIEGO,May 2016,CACF,2016,NEIGHBORHOOD HOUSE ASSOCIATION ,ADULT_SNACK_PM,21,65,0,11,76,845,0,143,988,47.0476
SAN DIEGO,May 2016,CACF,2016,NEIGHBORHOOD HOUSE ASSOCIATION ,HS_CHILD_BREAKFAST,21,2221,0,0,2221,23256,0,0,23256,1107.4286
SAN DIEGO,May 2016,CACF,2016,NEIGHBORHOOD HOUSE ASSOCIATION ,HS_CHILD_LUNCH,21,2221,0,0,2221,30972,0,0,30972,1474.8571
SAN DIEGO,May 2016,CACF,2016,NEIGHBORHOOD HOUSE ASSOCIATION ,HS_CHILD_SNACK_AM,21,2221,0,0,2221,86,0,0,86,4.0952
SAN DIEGO,May 2016,CACF,2016,NEIGHBORHOOD HOUSE ASSOCIATION ,HS_CHILD_SNACK_PM,21,2221,0,0,2221,17334,0,0,17334,825.4286
SAN DIEGO,Jun 2016,CACF,2016,NEIGHBORHOOD HOUSE ASSOCIATION ,ADULT_LUNCH,22,65,0,11,76,890,0,151,1041,47.3182
SAN DIEGO,Jun 2016,CACF,2016,NEIGHBORHOOD HOUSE ASSOCIATION ,ADULT_SNACK_AM,22,65,0,11,76,885,0,150,1035,47.0455
SAN DIEGO,Jun 2016,CACF,2016,NEIGHBORHOOD HOUSE ASSOCIATION ,ADULT_SNACK_PM,22,65,0,11,76,854,0,145,999,45.4091
SAN DIEGO,Jun 2016,CACF,2016,NEIGHBORHOOD HOUSE ASSOCIATION ,HS_CHILD_BREAKFAST,22,2221,0,0,2221,13753,0,0,13753,625.1364
SAN DIEGO,Jun 2016,CACF,2016,NEIGHBORHOOD HOUSE ASSOCIATION ,HS_CHILD_LUNCH,22,2221,0,0,2221,16989,0,0,16989,772.2273
SAN DIEGO,Jun 2016,CACF,2016,NEIGHBORHOOD HOUSE ASSOCIATION ,HS_CHILD_SNACK_AM,22,2221,0,0,2221,50,0,0,50,2.2727
SAN DIEGO,Jun 2016,CACF,2016,NEIGHBORHOOD HOUSE ASSOCIATION ,HS_CHILD_SNACK_PM,22,2221,0,0,2221,9166,0,0,9166,416.6364
SAN DIEGO,Jul 2016,CACF,2016,NEIGHBORHOOD HOUSE ASSOCIATION ,ADULT_LUNCH,20,65,0,11,76,783,0,133,916,45.8
SAN DIEGO,Jul 2016,CACF,2016,NEIGHBORHOOD HOUSE ASSOCIATION ,ADULT_SNACK_AM,20,65,0,11,76,779,0,132,911,45.55
SAN DIEGO,Jul 2016,CACF,2016,NEIGHBORHOOD HOUSE ASSOCIATION ,ADULT_SNACK_PM,20,65,0,11,76,754,0,128,882,44.1
SAN DIEGO,Jul 2016,CACF,2016,NEIGHBORHOOD HOUSE ASSOCIATION ,HS_CHILD_BREAKFAST,19,2221,0,0,2221,1680,0,0,1680,88.4211
SAN DIEGO,Jul 2016,CACF,2016,NEIGHBORHOOD HOUSE ASSOCIATION ,HS_CHILD_LUNCH,19,2221,0,0,2221,1886,0,0,1886,99.2632
SAN DIEGO,Jul 2016,CACF,2016,NEIGHBORHOOD HOUSE ASSOCIATION ,HS_CHILD_SNACK_AM,19,2221,0,0,2221,17,0,0,17,0.8947
SAN DIEGO,Jul 2016,CACF,2016,NEIGHBORHOOD HOUSE ASSOCIATION ,HS_CHILD_SNACK_PM,19,2221,0,0,2221,1041,0,0,1041,54.7895
SAN DIEGO,Oct 2015,CACF,2016,NEXT GENERATION EDUC CTR INC,CHILD_BREAKFAST,21,36,1,62,99,295,8,507,810,38.5714
SAN DIEGO,Oct 2015,CACF,2016,NEXT GENERATION EDUC CTR INC,CHILD_LUNCH,21,36,1,62,99,570,16,983,1569,74.7143
SAN DIEGO,Oct 2015,CACF,2016,NEXT GENERATION EDUC CTR INC,CHILD_SNACK_AM,21,36,1,62,99,531,15,914,1460,69.5238
SAN DIEGO,Oct 2015,CACF,2016,NEXT GENERATION EDUC CTR INC,CHILD_SNACK_PM,21,36,1,62,99,254,7,437,698,33.2381
SAN DIEGO,Oct 2015,CACF,2016,NEXT GENERATION EDUC CTR INC,OSCH_CHILD_BREAKFAST,21,13,0,12,25,87,0,80,167,7.9524
SAN DIEGO,Oct 2015,CACF,2016,NEXT GENERATION EDUC CTR INC,OSCH_CHILD_LUNCH,21,13,0,12,25,2,0,2,4,0.1905
SAN DIEGO,Oct 2015,CACF,2016,NEXT GENERATION EDUC CTR INC,OSCH_CHILD_SNACK_AM,21,13,0,12,25,2,0,1,3,0.1429
SAN DIEGO,Oct 2015,CACF,2016,NEXT GENERATION EDUC CTR INC,OSCH_CHILD_SNACK_PM,21,13,0,12,25,185,0,170,355,16.9048
SAN DIEGO,Nov 2015,CACF,2016,NEXT GENERATION EDUC CTR INC,CHILD_BREAKFAST,19,36,1,62,99,311,9,536,856,45.0526
SAN DIEGO,Nov 2015,CACF,2016,NEXT GENERATION EDUC CTR INC,CHILD_LUNCH,19,36,1,62,99,506,14,872,1392,73.2632
SAN DIEGO,Nov 2015,CACF,2016,NEXT GENERATION EDUC CTR INC,CHILD_SNACK_AM,19,36,1,62,99,454,13,781,1248,65.6842
SAN DIEGO,Nov 2015,CACF,2016,NEXT GENERATION EDUC CTR INC,CHILD_SNACK_PM,19,36,1,62,99,177,5,305,487,25.6316
SAN DIEGO,Nov 2015,CACF,2016,NEXT GENERATION EDUC CTR INC,OSCH_CHILD_BREAKFAST,19,13,0,12,25,82,0,75,157,8.2632
SAN DIEGO,Nov 2015,CACF,2016,NEXT GENERATION EDUC CTR INC,OSCH_CHILD_LUNCH,19,13,0,12,25,29,0,27,56,2.9474
SAN DIEGO,Nov 2015,CACF,2016,NEXT GENERATION EDUC CTR INC,OSCH_CHILD_SNACK_AM,19,13,0,12,25,25,0,23,48,2.5263
SAN DIEGO,Nov 2015,CACF,2016,NEXT GENERATION EDUC CTR INC,OSCH_CHILD_SNACK_PM,19,13,0,12,25,105,0,96,201,10.5789
SAN DIEGO,Dec 2015,CACF,2016,NEXT GENERATION EDUC CTR INC,CHILD_BREAKFAST,22,49,1,65,115,291,6,386,683,31.0455
SAN DIEGO,Dec 2015,CACF,2016,NEXT GENERATION EDUC CTR INC,CHILD_LUNCH,22,49,1,65,115,615,13,816,1444,65.6364
SAN DIEGO,Dec 2015,CACF,2016,NEXT GENERATION EDUC CTR INC,CHILD_SNACK_AM,22,49,1,65,115,553,11,733,1297,58.9545
SAN DIEGO,Dec 2015,CACF,2016,NEXT GENERATION EDUC CTR INC,CHILD_SNACK_PM,22,49,1,65,115,248,5,330,583,26.5
SAN DIEGO,Dec 2015,CACF,2016,NEXT GENERATION EDUC CTR INC,OSCH_CHILD_BREAKFAST,22,16,0,15,31,87,0,81,168,7.6364
SAN DIEGO,Dec 2015,CACF,2016,NEXT GENERATION EDUC CTR INC,OSCH_CHILD_LUNCH,22,16,0,15,31,52,0,48,100,4.5455
SAN DIEGO,Dec 2015,CACF,2016,NEXT GENERATION EDUC CTR INC,OSCH_CHILD_SNACK_AM,22,16,0,15,31,47,0,44,91,4.1364
SAN DIEGO,Dec 2015,CACF,2016,NEXT GENERATION EDUC CTR INC,OSCH_CHILD_SNACK_PM,22,16,0,15,31,135,0,126,261,11.8636
SAN DIEGO,Jan 2016,CACF,2016,NEXT GENERATION EDUC CTR INC,CHILD_BREAKFAST,20,53,2,62,117,361,14,423,798,39.9
SAN DIEGO,Jan 2016,CACF,2016,NEXT GENERATION EDUC CTR INC,CHILD_LUNCH,20,53,2,62,117,703,27,821,1551,77.55
SAN DIEGO,Jan 2016,CACF,2016,NEXT GENERATION EDUC CTR INC,CHILD_SNACK_AM,20,53,2,62,117,649,25,759,1433,71.65
SAN DIEGO,Jan 2016,CACF,2016,NEXT GENERATION EDUC CTR INC,CHILD_SNACK_PM,20,53,2,62,117,280,11,326,617,30.85
SAN DIEGO,Jan 2016,CACF,2016,NEXT GENERATION EDUC CTR INC,OSCH_CHILD_BREAKFAST,20,16,0,15,31,73,0,68,141,7.05
SAN DIEGO,Jan 2016,CACF,2016,NEXT GENERATION EDUC CTR INC,OSCH_CHILD_LUNCH,20,16,0,15,31,40,0,38,78,3.9
SAN DIEGO,Jan 2016,CACF,2016,NEXT GENERATION EDUC CTR INC,OSCH_CHILD_SNACK_AM,20,16,0,15,31,33,0,31,64,3.2
SAN DIEGO,Jan 2016,CACF,2016,NEXT GENERATION EDUC CTR INC,OSCH_CHILD_SNACK_PM,20,16,0,15,31,147,0,138,285,14.25
SAN DIEGO,Feb 2016,CACF,2016,NEXT GENERATION EDUC CTR INC,CHILD_BREAKFAST,20,53,2,62,117,365,14,426,805,40.25
SAN DIEGO,Feb 2016,CACF,2016,NEXT GENERATION EDUC CTR INC,CHILD_LUNCH,20,53,2,62,117,698,26,816,1540,77
SAN DIEGO,Feb 2016,CACF,2016,NEXT GENERATION EDUC CTR INC,CHILD_SNACK_AM,20,53,2,62,117,641,24,751,1416,70.8
SAN DIEGO,Feb 2016,CACF,2016,NEXT GENERATION EDUC CTR INC,CHILD_SNACK_PM,20,53,2,62,117,273,10,320,603,30.15
SAN DIEGO,Feb 2016,CACF,2016,NEXT GENERATION EDUC CTR INC,OSCH_CHILD_BREAKFAST,20,16,0,15,31,41,0,39,80,4
SAN DIEGO,Feb 2016,CACF,2016,NEXT GENERATION EDUC CTR INC,OSCH_CHILD_LUNCH,20,16,0,15,31,8,0,8,16,0.8
SAN DIEGO,Feb 2016,CACF,2016,NEXT GENERATION EDUC CTR INC,OSCH_CHILD_SNACK_AM,20,16,0,15,31,7,0,6,13,0.65
SAN DIEGO,Feb 2016,CACF,2016,NEXT GENERATION EDUC CTR INC,OSCH_CHILD_SNACK_PM,20,16,0,15,31,157,0,147,304,15.2
SAN DIEGO,May 2016,CACF,2016,NEXT GENERATION EDUC CTR INC,CHILD_BREAKFAST,21,53,2,62,117,316,12,370,698,33.2381
SAN DIEGO,May 2016,CACF,2016,NEXT GENERATION EDUC CTR INC,CHILD_LUNCH,21,53,2,62,117,724,27,848,1599,76.1429
SAN DIEGO,May 2016,CACF,2016,NEXT GENERATION EDUC CTR INC,CHILD_SNACK_AM,21,53,2,62,117,636,24,745,1405,66.9048
SAN DIEGO,May 2016,CACF,2016,NEXT GENERATION EDUC CTR INC,CHILD_SNACK_PM,21,53,2,62,117,345,13,404,762,36.2857
SAN DIEGO,May 2016,CACF,2016,NEXT GENERATION EDUC CTR INC,OSCH_CHILD_BREAKFAST,21,16,0,15,31,28,0,27,55,2.619
SAN DIEGO,May 2016,CACF,2016,NEXT GENERATION EDUC CTR INC,OSCH_CHILD_SNACK_PM,21,16,0,15,31,110,0,103,213,10.1429
SAN DIEGO,Jun 2016,CACF,2016,NEXT GENERATION EDUC CTR INC,CHILD_BREAKFAST,22,53,2,62,117,295,11,345,651,29.5909
SAN DIEGO,Jun 2016,CACF,2016,NEXT GENERATION EDUC CTR INC,CHILD_LUNCH,22,53,2,62,117,593,22,694,1309,59.5
SAN DIEGO,Jun 2016,CACF,2016,NEXT GENERATION EDUC CTR INC,CHILD_SNACK_AM,22,53,2,62,117,591,22,691,1304,59.2727
SAN DIEGO,Jun 2016,CACF,2016,NEXT GENERATION EDUC CTR INC,CHILD_SNACK_PM,22,53,2,62,117,308,12,361,681,30.9545
SAN DIEGO,Jun 2016,CACF,2016,NEXT GENERATION EDUC CTR INC,OSCH_CHILD_BREAKFAST,22,16,0,15,31,34,0,31,65,2.9545
SAN DIEGO,Jun 2016,CACF,2016,NEXT GENERATION EDUC CTR INC,OSCH_CHILD_LUNCH,22,16,0,15,31,54,0,51,105,4.7727
SAN DIEGO,Jun 2016,CACF,2016,NEXT GENERATION EDUC CTR INC,OSCH_CHILD_SNACK_AM,22,16,0,15,31,52,0,48,100,4.5455
SAN DIEGO,Jun 2016,CACF,2016,NEXT GENERATION EDUC CTR INC,OSCH_CHILD_SNACK_PM,22,16,0,15,31,83,0,77,160,7.2727
SAN DIEGO,Jul 2016,CACF,2016,NEXT GENERATION EDUC CTR INC,CHILD_BREAKFAST,20,53,2,62,117,272,10,319,601,30.05
SAN DIEGO,Jul 2016,CACF,2016,NEXT GENERATION EDUC CTR INC,CHILD_LUNCH,20,53,2,62,117,607,23,709,1339,66.95
SAN DIEGO,Jul 2016,CACF,2016,NEXT GENERATION EDUC CTR INC,CHILD_SNACK_AM,20,53,2,62,117,545,21,637,1203,60.15
SAN DIEGO,Jul 2016,CACF,2016,NEXT GENERATION EDUC CTR INC,CHILD_SNACK_PM,20,53,2,62,117,224,8,263,495,24.75
SAN DIEGO,Jul 2016,CACF,2016,NEXT GENERATION EDUC CTR INC,OSCH_CHILD_BREAKFAST,20,16,0,15,31,38,0,36,74,3.7
SAN DIEGO,Jul 2016,CACF,2016,NEXT GENERATION EDUC CTR INC,OSCH_CHILD_LUNCH,20,16,0,15,31,141,0,133,274,13.7
SAN DIEGO,Jul 2016,CACF,2016,NEXT GENERATION EDUC CTR INC,OSCH_CHILD_SNACK_AM,20,16,0,15,31,65,0,61,126,6.3
SAN DIEGO,Jul 2016,CACF,2016,NEXT GENERATION EDUC CTR INC,OSCH_CHILD_SNACK_PM,20,16,0,15,31,44,0,42,86,4.3
SAN DIEGO,Oct 2015,CACF,2016,NORTH COUNTY COMMUNITY SERVICE ,CHILD_BREAKFAST,22,222,92,35,349,3226,1337,508,5071,230.5
SAN DIEGO,Oct 2015,CACF,2016,NORTH COUNTY COMMUNITY SERVICE ,CHILD_LUNCH,22,222,92,35,349,2796,1159,440,4395,199.7727
SAN DIEGO,Oct 2015,CACF,2016,NORTH COUNTY COMMUNITY SERVICE ,CHILD_SNACK_PM,22,222,92,35,349,2726,1130,430,4286,194.8182
SAN DIEGO,Nov 2015,CACF,2016,NORTH COUNTY COMMUNITY SERVICE ,CHILD_BREAKFAST,19,222,91,33,346,2564,1051,381,3996,210.3158
SAN DIEGO,Nov 2015,CACF,2016,NORTH COUNTY COMMUNITY SERVICE ,CHILD_LUNCH,19,222,91,33,346,2314,948,344,3606,189.7895
SAN DIEGO,Nov 2015,CACF,2016,NORTH COUNTY COMMUNITY SERVICE ,CHILD_SNACK_PM,19,222,91,33,346,2138,877,318,3333,175.4211
SAN DIEGO,Dec 2015,CACF,2016,NORTH COUNTY COMMUNITY SERVICE ,CHILD_BREAKFAST,20,218,95,33,346,2413,1052,365,3830,191.5
SAN DIEGO,Dec 2015,CACF,2016,NORTH COUNTY COMMUNITY SERVICE ,CHILD_LUNCH,20,218,95,33,346,2219,967,335,3521,176.05
SAN DIEGO,Dec 2015,CACF,2016,NORTH COUNTY COMMUNITY SERVICE ,CHILD_SNACK_PM,20,218,95,33,346,2095,913,317,3325,166.25
SAN DIEGO,Jan 2016,CACF,2016,NORTH COUNTY COMMUNITY SERVICE ,CHILD_BREAKFAST,19,218,95,33,346,2645,1153,400,4198,220.9474
SAN DIEGO,Jan 2016,CACF,2016,NORTH COUNTY COMMUNITY SERVICE ,CHILD_LUNCH,19,218,95,33,346,2328,1015,352,3695,194.4737
SAN DIEGO,Jan 2016,CACF,2016,NORTH COUNTY COMMUNITY SERVICE ,CHILD_SNACK_PM,19,218,95,33,346,2221,968,336,3525,185.5263
SAN DIEGO,Feb 2016,CACF,2016,NORTH COUNTY COMMUNITY SERVICE ,CHILD_BREAKFAST,20,218,95,33,346,2813,1226,426,4465,223.25
SAN DIEGO,Feb 2016,CACF,2016,NORTH COUNTY COMMUNITY SERVICE ,CHILD_LUNCH,20,218,95,33,346,2486,1084,376,3946,197.3
SAN DIEGO,Feb 2016,CACF,2016,NORTH COUNTY COMMUNITY SERVICE ,CHILD_SNACK_PM,20,218,95,33,346,2428,1058,368,3854,192.7
SAN DIEGO,Mar 2016,CACF,2016,NORTH COUNTY COMMUNITY SERVICE ,CHILD_BREAKFAST,23,218,95,33,346,3153,1374,477,5004,217.5652
SAN DIEGO,Mar 2016,CACF,2016,NORTH COUNTY COMMUNITY SERVICE ,CHILD_LUNCH,23,218,95,33,346,2922,1274,442,4638,201.6522
SAN DIEGO,Mar 2016,CACF,2016,NORTH COUNTY COMMUNITY SERVICE ,CHILD_SNACK_PM,23,218,95,33,346,2777,1210,420,4407,191.6087
SAN DIEGO,Apr 2016,CACF,2016,NORTH COUNTY COMMUNITY SERVICE ,CHILD_BREAKFAST,21,218,95,33,346,2958,1289,447,4694,223.5238
SAN DIEGO,Apr 2016,CACF,2016,NORTH COUNTY COMMUNITY SERVICE ,CHILD_LUNCH,21,218,95,33,346,2709,1181,410,4300,204.7619
SAN DIEGO,Apr 2016,CACF,2016,NORTH COUNTY COMMUNITY SERVICE ,CHILD_SNACK_PM,21,218,95,33,346,2660,1159,403,4222,201.0476
SAN DIEGO,May 2016,CACF,2016,NORTH COUNTY COMMUNITY SERVICE ,CHILD_BREAKFAST,21,218,95,33,346,3066,1336,464,4866,231.7143
SAN DIEGO,May 2016,CACF,2016,NORTH COUNTY COMMUNITY SERVICE ,CHILD_LUNCH,21,218,95,33,346,2754,1200,416,4370,208.0952
SAN DIEGO,May 2016,CACF,2016,NORTH COUNTY COMMUNITY SERVICE ,CHILD_SNACK_PM,21,218,95,33,346,2757,1202,417,4376,208.381
SAN DIEGO,Jun 2016,CACF,2016,NORTH COUNTY COMMUNITY SERVICE ,CHILD_BREAKFAST,22,218,95,33,346,2484,1082,376,3942,179.1818
SAN DIEGO,Jun 2016,CACF,2016,NORTH COUNTY COMMUNITY SERVICE ,CHILD_LUNCH,22,218,95,33,346,2481,1081,376,3938,179
SAN DIEGO,Jun 2016,CACF,2016,NORTH COUNTY COMMUNITY SERVICE ,CHILD_SNACK_PM,22,218,95,33,346,2242,977,339,3558,161.7273
SAN DIEGO,Jul 2016,CACF,2016,NORTH COUNTY COMMUNITY SERVICE ,CHILD_BREAKFAST,21,218,95,33,346,2357,1027,357,3741,178.1429
SAN DIEGO,Jul 2016,CACF,2016,NORTH COUNTY COMMUNITY SERVICE ,CHILD_LUNCH,21,218,95,33,346,2632,1147,398,4177,198.9048
SAN DIEGO,Jul 2016,CACF,2016,NORTH COUNTY COMMUNITY SERVICE ,CHILD_SNACK_PM,21,218,95,33,346,1965,856,297,3118,148.4762
SAN DIEGO,Oct 2015,CACF,2016,NORTH COUNTY SERENITY HOUSE INC ,CHILD_BREAKFAST,20,50,6,1,57,678,81,14,773,38.65
SAN DIEGO,Oct 2015,CACF,2016,NORTH COUNTY SERENITY HOUSE INC ,CHILD_LUNCH,20,50,6,1,57,819,98,17,934,46.7
SAN DIEGO,Oct 2015,CACF,2016,NORTH COUNTY SERENITY HOUSE INC ,CHILD_SNACK_PM,20,50,6,1,57,611,73,13,697,34.85
SAN DIEGO,Oct 2015,CACF,2016,OAK TREE ACADEMY LLC,CHILD_BREAKFAST,22,37,2,24,63,411,22,266,699,31.7727
SAN DIEGO,Oct 2015,CACF,2016,OAK TREE ACADEMY LLC,CHILD_LUNCH,22,37,2,24,63,601,32,391,1024,46.5455
SAN DIEGO,Oct 2015,CACF,2016,OAK TREE ACADEMY LLC,CHILD_SNACK_PM,22,37,2,24,63,503,27,326,856,38.9091
SAN DIEGO,Nov 2015,CACF,2016,OAK TREE ACADEMY LLC,CHILD_BREAKFAST,18,37,2,24,63,352,19,229,600,33.3333
SAN DIEGO,Nov 2015,CACF,2016,OAK TREE ACADEMY LLC,CHILD_LUNCH,18,37,2,24,63,466,25,302,793,44.0556
SAN DIEGO,Nov 2015,CACF,2016,OAK TREE ACADEMY LLC,CHILD_SNACK_PM,18,37,2,24,63,376,20,244,640,35.5556
SAN DIEGO,Jan 2016,CACF,2016,OAK TREE ACADEMY LLC,CHILD_BREAKFAST,19,35,2,26,63,320,18,238,576,30.3158
SAN DIEGO,Jan 2016,CACF,2016,OAK TREE ACADEMY LLC,CHILD_LUNCH,19,35,2,26,63,444,25,331,800,42.1053
SAN DIEGO,Jan 2016,CACF,2016,OAK TREE ACADEMY LLC,CHILD_SNACK_PM,19,35,2,26,63,353,20,263,636,33.4737
SAN DIEGO,Feb 2016,CACF,2016,OAK TREE ACADEMY LLC,CHILD_BREAKFAST,20,38,2,26,66,365,19,250,634,31.7
SAN DIEGO,Feb 2016,CACF,2016,OAK TREE ACADEMY LLC,CHILD_LUNCH,20,38,2,26,66,537,28,367,932,46.6
SAN DIEGO,Feb 2016,CACF,2016,OAK TREE ACADEMY LLC,CHILD_SNACK_PM,20,38,2,26,66,466,25,319,810,40.5
SAN DIEGO,Mar 2016,CACF,2016,OAK TREE ACADEMY LLC,CHILD_BREAKFAST,23,43,4,30,77,455,42,318,815,35.4348
SAN DIEGO,Mar 2016,CACF,2016,OAK TREE ACADEMY LLC,CHILD_LUNCH,23,43,4,30,77,615,57,429,1101,47.8696
SAN DIEGO,Mar 2016,CACF,2016,OAK TREE ACADEMY LLC,CHILD_SNACK_PM,23,43,4,30,77,568,53,396,1017,44.2174
SAN DIEGO,Apr 2016,CACF,2016,OAK TREE ACADEMY LLC,CHILD_BREAKFAST,21,46,5,28,79,451,49,275,775,36.9048
SAN DIEGO,Apr 2016,CACF,2016,OAK TREE ACADEMY LLC,CHILD_LUNCH,21,46,5,28,79,607,66,369,1042,49.619
SAN DIEGO,Apr 2016,CACF,2016,OAK TREE ACADEMY LLC,CHILD_SNACK_PM,21,46,5,28,79,530,58,323,911,43.381
SAN DIEGO,May 2016,CACF,2016,OAK TREE ACADEMY LLC,CHILD_BREAKFAST,21,55,4,27,86,606,44,297,947,45.0952
SAN DIEGO,May 2016,CACF,2016,OAK TREE ACADEMY LLC,CHILD_LUNCH,21,55,4,27,86,757,55,372,1184,56.381
SAN DIEGO,May 2016,CACF,2016,OAK TREE ACADEMY LLC,CHILD_SNACK_PM,21,55,4,27,86,631,46,309,986,46.9524
SAN DIEGO,Jun 2016,CACF,2016,OAK TREE ACADEMY LLC,CHILD_BREAKFAST,22,55,4,31,90,555,40,314,909,41.3182
SAN DIEGO,Jun 2016,CACF,2016,OAK TREE ACADEMY LLC,CHILD_LUNCH,22,55,4,31,90,716,52,404,1172,53.2727
SAN DIEGO,Jun 2016,CACF,2016,OAK TREE ACADEMY LLC,CHILD_SNACK_PM,22,55,4,31,90,607,44,342,993,45.1364
SAN DIEGO,Jul 2016,CACF,2016,OAK TREE ACADEMY LLC,CHILD_BREAKFAST,20,48,1,36,85,469,10,352,831,41.55
SAN DIEGO,Jul 2016,CACF,2016,OAK TREE ACADEMY LLC,CHILD_LUNCH,20,48,1,36,85,574,12,430,1016,50.8
SAN DIEGO,Jul 2016,CACF,2016,OAK TREE ACADEMY LLC,CHILD_SNACK_PM,20,48,1,36,85,479,10,360,849,42.45
SAN DIEGO,Oct 2015,CACF,2016,OCEAN BEACH CHILD CARE PROJECT CHILDRENS CIRCLE,CHILD_BREAKFAST,22,28,7,1,36,399,100,14,513,23.3182
SAN DIEGO,Oct 2015,CACF,2016,OCEAN BEACH CHILD CARE PROJECT CHILDRENS CIRCLE,CHILD_LUNCH,22,28,7,1,36,502,126,18,646,29.3636
SAN DIEGO,Oct 2015,CACF,2016,OCEAN BEACH CHILD CARE PROJECT CHILDRENS CIRCLE,CHILD_SNACK_PM,22,28,7,1,36,468,117,17,602,27.3636
SAN DIEGO,Nov 2015,CACF,2016,OCEAN BEACH CHILD CARE PROJECT CHILDRENS CIRCLE,CHILD_BREAKFAST,18,28,7,1,36,329,82,12,423,23.5
SAN DIEGO,Nov 2015,CACF,2016,OCEAN BEACH CHILD CARE PROJECT CHILDRENS CIRCLE,CHILD_LUNCH,18,28,7,1,36,422,105,15,542,30.1111
SAN DIEGO,Nov 2015,CACF,2016,OCEAN BEACH CHILD CARE PROJECT CHILDRENS CIRCLE,CHILD_SNACK_PM,18,28,7,1,36,399,100,14,513,28.5
SAN DIEGO,Dec 2015,CACF,2016,OCEAN BEACH CHILD CARE PROJECT CHILDRENS CIRCLE,CHILD_BREAKFAST,14,28,7,1,36,236,59,8,303,21.6429
SAN DIEGO,Dec 2015,CACF,2016,OCEAN BEACH CHILD CARE PROJECT CHILDRENS CIRCLE,CHILD_LUNCH,14,28,7,1,36,316,79,11,406,29
SAN DIEGO,Dec 2015,CACF,2016,OCEAN BEACH CHILD CARE PROJECT CHILDRENS CIRCLE,CHILD_SNACK_PM,14,28,7,1,36,285,71,10,366,26.1429
SAN DIEGO,Jan 2016,CACF,2016,OCEAN BEACH CHILD CARE PROJECT CHILDRENS CIRCLE,CHILD_BREAKFAST,20,28,7,1,36,395,99,14,508,25.4
SAN DIEGO,Jan 2016,CACF,2016,OCEAN BEACH CHILD CARE PROJECT CHILDRENS CIRCLE,CHILD_LUNCH,20,28,7,1,36,515,129,18,662,33.1
SAN DIEGO,Jan 2016,CACF,2016,OCEAN BEACH CHILD CARE PROJECT CHILDRENS CIRCLE,CHILD_SNACK_PM,20,28,7,1,36,476,119,17,612,30.6
SAN DIEGO,Feb 2016,CACF,2016,OCEAN BEACH CHILD CARE PROJECT CHILDRENS CIRCLE,CHILD_BREAKFAST,21,28,7,1,36,387,97,13,497,23.6667
SAN DIEGO,Feb 2016,CACF,2016,OCEAN BEACH CHILD CARE PROJECT CHILDRENS CIRCLE,CHILD_LUNCH,21,28,7,1,36,500,125,18,643,30.619
SAN DIEGO,Feb 2016,CACF,2016,OCEAN BEACH CHILD CARE PROJECT CHILDRENS CIRCLE,CHILD_SNACK_PM,21,28,7,1,36,464,116,17,597,28.4286
SAN DIEGO,Mar 2016,CACF,2016,OCEAN BEACH CHILD CARE PROJECT CHILDRENS CIRCLE,CHILD_BREAKFAST,23,28,7,1,36,442,110,16,568,24.6957
SAN DIEGO,Mar 2016,CACF,2016,OCEAN BEACH CHILD CARE PROJECT CHILDRENS CIRCLE,CHILD_LUNCH,23,28,7,1,36,572,143,21,736,32
SAN DIEGO,Mar 2016,CACF,2016,OCEAN BEACH CHILD CARE PROJECT CHILDRENS CIRCLE,CHILD_SNACK_PM,23,28,7,1,36,533,133,19,685,29.7826
SAN DIEGO,Apr 2016,CACF,2016,OCEAN BEACH CHILD CARE PROJECT CHILDRENS CIRCLE,CHILD_BREAKFAST,20,28,7,1,36,387,97,13,497,24.85
SAN DIEGO,Apr 2016,CACF,2016,OCEAN BEACH CHILD CARE PROJECT CHILDRENS CIRCLE,CHILD_LUNCH,20,28,7,1,36,545,136,20,701,35.05
SAN DIEGO,Apr 2016,CACF,2016,OCEAN BEACH CHILD CARE PROJECT CHILDRENS CIRCLE,CHILD_SNACK_PM,20,28,7,1,36,516,129,18,663,33.15
SAN DIEGO,May 2016,CACF,2016,OCEAN BEACH CHILD CARE PROJECT CHILDRENS CIRCLE,CHILD_BREAKFAST,21,28,7,1,36,416,104,15,535,25.4762
SAN DIEGO,May 2016,CACF,2016,OCEAN BEACH CHILD CARE PROJECT CHILDRENS CIRCLE,CHILD_LUNCH,21,28,7,1,36,568,142,20,730,34.7619
SAN DIEGO,May 2016,CACF,2016,OCEAN BEACH CHILD CARE PROJECT CHILDRENS CIRCLE,CHILD_SNACK_PM,21,28,7,1,36,519,130,18,667,31.7619
SAN DIEGO,Jun 2016,CACF,2016,OCEAN BEACH CHILD CARE PROJECT CHILDRENS CIRCLE,CHILD_BREAKFAST,21,28,7,1,36,387,97,14,498,23.7143
SAN DIEGO,Jun 2016,CACF,2016,OCEAN BEACH CHILD CARE PROJECT CHILDRENS CIRCLE,CHILD_LUNCH,21,28,7,1,36,529,132,19,680,32.381
SAN DIEGO,Jun 2016,CACF,2016,OCEAN BEACH CHILD CARE PROJECT CHILDRENS CIRCLE,CHILD_SNACK_PM,21,28,7,1,36,506,126,18,650,30.9524
SAN DIEGO,Jul 2016,CACF,2016,OCEAN BEACH CHILD CARE PROJECT CHILDRENS CIRCLE,CHILD_BREAKFAST,20,28,7,1,36,413,103,15,531,26.55
SAN DIEGO,Jul 2016,CACF,2016,OCEAN BEACH CHILD CARE PROJECT CHILDRENS CIRCLE,CHILD_LUNCH,20,28,7,1,36,521,130,19,670,33.5
SAN DIEGO,Jul 2016,CACF,2016,OCEAN BEACH CHILD CARE PROJECT CHILDRENS CIRCLE,CHILD_SNACK_PM,20,28,7,1,36,471,118,17,606,30.3
SAN DIEGO,Oct 2015,CACF,2016,Oceanside Unified School District,ATRISK_CHILD_SUPPER,22,1177,0,0,1177,20479,0,0,20479,930.8636
SAN DIEGO,Nov 2015,CACF,2016,Oceanside Unified School District,ATRISK_CHILD_SUPPER,15,1152,0,0,1152,13935,0,0,13935,929
SAN DIEGO,Dec 2015,CACF,2016,Oceanside Unified School District,ATRISK_CHILD_SUPPER,14,1279,0,0,1279,11763,0,0,11763,840.2143
SAN DIEGO,Jan 2016,CACF,2016,Oceanside Unified School District,ATRISK_CHILD_SUPPER,19,1183,0,0,1183,16577,0,0,16577,872.4737
SAN DIEGO,Feb 2016,CACF,2016,Oceanside Unified School District,ATRISK_CHILD_SUPPER,16,1117,0,0,1117,13584,0,0,13584,849
SAN DIEGO,Mar 2016,CACF,2016,Oceanside Unified School District,ATRISK_CHILD_SUPPER,23,1233,0,0,1233,20048,0,0,20048,871.6522
SAN DIEGO,Apr 2016,CACF,2016,Oceanside Unified School District,ATRISK_CHILD_SUPPER,16,1244,0,0,1244,13126,0,0,13126,820.375
SAN DIEGO,May 2016,CACF,2016,Oceanside Unified School District,ATRISK_CHILD_SUPPER,21,1253,0,0,1253,17084,0,0,17084,813.5238
SAN DIEGO,Jun 2016,CACF,2016,Oceanside Unified School District,ATRISK_CHILD_SUPPER,2,1195,0,0,1195,1097,0,0,1097,548.5
SAN DIEGO,Oct 2015,CACF,2016,OPEN ARMS ADHC INC,ADULT_BREAKFAST,22,158,0,0,158,1476,0,0,1476,67.0909
SAN DIEGO,Oct 2015,CACF,2016,OPEN ARMS ADHC INC,ADULT_LUNCH,22,158,0,0,158,1476,0,0,1476,67.0909
SAN DIEGO,Oct 2015,CACF,2016,OPEN ARMS ADHC INC,ADULT_SNACK_PM,22,158,0,0,158,709,0,0,709,32.2273
SAN DIEGO,Nov 2015,CACF,2016,OPEN ARMS ADHC INC,ADULT_BREAKFAST,19,155,0,0,155,1290,0,0,1290,67.8947
SAN DIEGO,Nov 2015,CACF,2016,OPEN ARMS ADHC INC,ADULT_LUNCH,19,155,0,0,155,1290,0,0,1290,67.8947
SAN DIEGO,Nov 2015,CACF,2016,OPEN ARMS ADHC INC,ADULT_SNACK_PM,19,155,0,0,155,603,0,0,603,31.7368
SAN DIEGO,Dec 2015,CACF,2016,OPEN ARMS ADHC INC,ADULT_BREAKFAST,22,160,0,0,160,1479,0,0,1479,67.2273
SAN DIEGO,Dec 2015,CACF,2016,OPEN ARMS ADHC INC,ADULT_LUNCH,22,160,0,0,160,1479,0,0,1479,67.2273
SAN DIEGO,Dec 2015,CACF,2016,OPEN ARMS ADHC INC,ADULT_SNACK_PM,22,160,0,0,160,692,0,0,692,31.4545
SAN DIEGO,Jan 2016,CACF,2016,OPEN ARMS ADHC INC,ADULT_BREAKFAST,20,163,0,0,163,1338,0,0,1338,66.9
SAN DIEGO,Jan 2016,CACF,2016,OPEN ARMS ADHC INC,ADULT_LUNCH,20,163,0,0,163,1337,0,0,1337,66.85
SAN DIEGO,Jan 2016,CACF,2016,OPEN ARMS ADHC INC,ADULT_SNACK_PM,20,163,0,0,163,626,0,0,626,31.3
SAN DIEGO,Feb 2016,CACF,2016,OPEN ARMS ADHC INC,ADULT_BREAKFAST,21,165,0,3,168,1459,0,27,1486,70.7619
SAN DIEGO,Feb 2016,CACF,2016,OPEN ARMS ADHC INC,ADULT_LUNCH,21,165,0,3,168,1459,0,27,1486,70.7619
SAN DIEGO,Feb 2016,CACF,2016,OPEN ARMS ADHC INC,ADULT_SNACK_PM,21,165,0,3,168,668,0,12,680,32.381
SAN DIEGO,Mar 2016,CACF,2016,OPEN ARMS ADHC INC,ADULT_BREAKFAST,23,161,0,3,164,1600,0,30,1630,70.8696
SAN DIEGO,Mar 2016,CACF,2016,OPEN ARMS ADHC INC,ADULT_LUNCH,23,161,0,3,164,1600,0,30,1630,70.8696
SAN DIEGO,Mar 2016,CACF,2016,OPEN ARMS ADHC INC,ADULT_SNACK_PM,23,161,0,3,164,683,0,13,696,30.2609
SAN DIEGO,Apr 2016,CACF,2016,OPEN ARMS ADHC INC,ADULT_BREAKFAST,21,164,0,6,170,1481,0,54,1535,73.0952
SAN DIEGO,Apr 2016,CACF,2016,OPEN ARMS ADHC INC,ADULT_LUNCH,21,164,0,6,170,1481,0,54,1535,73.0952
SAN DIEGO,Apr 2016,CACF,2016,OPEN ARMS ADHC INC,ADULT_SNACK_PM,21,164,0,6,170,638,0,23,661,31.4762
SAN DIEGO,May 2016,CACF,2016,OPEN ARMS ADHC INC,ADULT_BREAKFAST,22,167,0,5,172,1504,0,45,1549,70.4091
SAN DIEGO,May 2016,CACF,2016,OPEN ARMS ADHC INC,ADULT_LUNCH,22,167,0,5,172,1504,0,45,1549,70.4091
SAN DIEGO,May 2016,CACF,2016,OPEN ARMS ADHC INC,ADULT_SNACK_PM,22,167,0,5,172,621,0,19,640,29.0909
SAN DIEGO,Jun 2016,CACF,2016,OPEN ARMS ADHC INC,ADULT_BREAKFAST,22,165,0,4,169,1657,0,40,1697,77.1364
SAN DIEGO,Jun 2016,CACF,2016,OPEN ARMS ADHC INC,ADULT_LUNCH,22,165,0,4,169,1657,0,40,1697,77.1364
SAN DIEGO,Jun 2016,CACF,2016,OPEN ARMS ADHC INC,ADULT_SNACK_PM,22,165,0,4,169,671,0,16,687,31.2273
SAN DIEGO,Jul 2016,CACF,2016,OPEN ARMS ADHC INC,ADULT_BREAKFAST,20,172,0,4,176,1450,0,34,1484,74.2
SAN DIEGO,Jul 2016,CACF,2016,OPEN ARMS ADHC INC,ADULT_LUNCH,20,172,0,4,176,1450,0,34,1484,74.2
SAN DIEGO,Jul 2016,CACF,2016,OPEN ARMS ADHC INC,ADULT_SNACK_PM,20,172,0,4,176,571,0,13,584,29.2
SAN DIEGO,Oct 2015,CACF,2016,PALOMAR COMMUNITY COLLEGE DISTRICT CDC,CHILD_BREAKFAST,22,56,29,111,196,562,291,1113,1966,89.3636
SAN DIEGO,Oct 2015,CACF,2016,PALOMAR COMMUNITY COLLEGE DISTRICT CDC,CHILD_LUNCH,22,56,29,111,196,394,204,781,1379,62.6818
SAN DIEGO,Oct 2015,CACF,2016,PALOMAR COMMUNITY COLLEGE DISTRICT CDC,CHILD_SNACK_PM,22,56,29,111,196,498,258,988,1744,79.2727
SAN DIEGO,Nov 2015,CACF,2016,PALOMAR COMMUNITY COLLEGE DISTRICT CDC,CHILD_BREAKFAST,18,56,29,111,196,454,235,901,1590,88.3333
SAN DIEGO,Nov 2015,CACF,2016,PALOMAR COMMUNITY COLLEGE DISTRICT CDC,CHILD_LUNCH,18,56,29,111,196,325,168,643,1136,63.1111
SAN DIEGO,Nov 2015,CACF,2016,PALOMAR COMMUNITY COLLEGE DISTRICT CDC,CHILD_SNACK_PM,18,56,29,111,196,426,221,843,1490,82.7778
SAN DIEGO,Dec 2015,CACF,2016,PALOMAR COMMUNITY COLLEGE DISTRICT CDC,CHILD_BREAKFAST,13,56,29,111,196,319,165,633,1117,85.9231
SAN DIEGO,Dec 2015,CACF,2016,PALOMAR COMMUNITY COLLEGE DISTRICT CDC,CHILD_LUNCH,13,56,29,111,196,229,119,453,801,61.6154
SAN DIEGO,Dec 2015,CACF,2016,PALOMAR COMMUNITY COLLEGE DISTRICT CDC,CHILD_SNACK_PM,13,56,29,111,196,304,158,603,1065,81.9231
SAN DIEGO,Jan 2016,CACF,2016,PALOMAR COMMUNITY COLLEGE DISTRICT CDC,CHILD_BREAKFAST,19,56,29,111,196,433,225,859,1517,79.8421
SAN DIEGO,Jan 2016,CACF,2016,PALOMAR COMMUNITY COLLEGE DISTRICT CDC,CHILD_LUNCH,19,56,29,111,196,307,159,610,1076,56.6316
SAN DIEGO,Jan 2016,CACF,2016,PALOMAR COMMUNITY COLLEGE DISTRICT CDC,CHILD_SNACK_PM,19,56,29,111,196,417,216,828,1461,76.8947
SAN DIEGO,Feb 2016,CACF,2016,PALOMAR COMMUNITY COLLEGE DISTRICT CDC,CHILD_BREAKFAST,19,56,29,111,196,693,359,1375,2427,127.7368
SAN DIEGO,Feb 2016,CACF,2016,PALOMAR COMMUNITY COLLEGE DISTRICT CDC,CHILD_LUNCH,19,56,29,111,196,479,248,949,1676,88.2105
SAN DIEGO,Feb 2016,CACF,2016,PALOMAR COMMUNITY COLLEGE DISTRICT CDC,CHILD_SNACK_PM,19,56,29,111,196,478,247,947,1672,88
SAN DIEGO,Mar 2016,CACF,2016,PALOMAR COMMUNITY COLLEGE DISTRICT CDC,CHILD_BREAKFAST,18,56,29,111,196,438,227,869,1534,85.2222
SAN DIEGO,Mar 2016,CACF,2016,PALOMAR COMMUNITY COLLEGE DISTRICT CDC,CHILD_LUNCH,18,56,29,111,196,314,163,621,1098,61
SAN DIEGO,Mar 2016,CACF,2016,PALOMAR COMMUNITY COLLEGE DISTRICT CDC,CHILD_SNACK_PM,18,56,29,111,196,442,229,876,1547,85.9444
SAN DIEGO,Apr 2016,CACF,2016,PALOMAR COMMUNITY COLLEGE DISTRICT CDC,CHILD_BREAKFAST,21,56,29,111,196,507,262,1004,1773,84.4286
SAN DIEGO,Apr 2016,CACF,2016,PALOMAR COMMUNITY COLLEGE DISTRICT CDC,CHILD_LUNCH,21,56,29,111,196,392,203,778,1373,65.381
SAN DIEGO,Apr 2016,CACF,2016,PALOMAR COMMUNITY COLLEGE DISTRICT CDC,CHILD_SNACK_PM,21,56,29,111,196,534,277,1058,1869,89
SAN DIEGO,May 2016,CACF,2016,PALOMAR COMMUNITY COLLEGE DISTRICT CDC,CHILD_BREAKFAST,21,56,29,111,196,515,267,1021,1803,85.8571
SAN DIEGO,May 2016,CACF,2016,PALOMAR COMMUNITY COLLEGE DISTRICT CDC,CHILD_LUNCH,21,56,29,111,196,370,192,734,1296,61.7143
SAN DIEGO,May 2016,CACF,2016,PALOMAR COMMUNITY COLLEGE DISTRICT CDC,CHILD_SNACK_PM,21,56,29,111,196,518,268,1027,1813,86.3333
SAN DIEGO,Jun 2016,CACF,2016,PALOMAR COMMUNITY COLLEGE DISTRICT CDC,CHILD_BREAKFAST,21,56,29,111,196,415,215,824,1454,69.2381
SAN DIEGO,Jun 2016,CACF,2016,PALOMAR COMMUNITY COLLEGE DISTRICT CDC,CHILD_LUNCH,21,56,29,111,196,287,149,569,1005,47.8571
SAN DIEGO,Jun 2016,CACF,2016,PALOMAR COMMUNITY COLLEGE DISTRICT CDC,CHILD_SNACK_PM,21,56,29,111,196,444,230,879,1553,73.9524
SAN DIEGO,Jul 2016,CACF,2016,PALOMAR COMMUNITY COLLEGE DISTRICT CDC,CHILD_BREAKFAST,20,56,29,111,196,377,195,746,1318,65.9
SAN DIEGO,Jul 2016,CACF,2016,PALOMAR COMMUNITY COLLEGE DISTRICT CDC,CHILD_LUNCH,20,56,29,111,196,271,140,536,947,47.35
SAN DIEGO,Jul 2016,CACF,2016,PALOMAR COMMUNITY COLLEGE DISTRICT CDC,CHILD_SNACK_PM,20,56,29,111,196,288,149,571,1008,50.4
SAN DIEGO,Oct 2015,CACF,2016,POWAY ADHC CENTER ,ADULT_BREAKFAST,22,145,0,26,171,1097,0,197,1294,58.8182
SAN DIEGO,Oct 2015,CACF,2016,POWAY ADHC CENTER ,ADULT_LUNCH,22,145,0,26,171,1332,0,239,1571,71.4091
SAN DIEGO,Oct 2015,CACF,2016,POWAY ADHC CENTER ,ADULT_SNACK_PM,22,145,0,26,171,159,0,29,188,8.5455
SAN DIEGO,Nov 2015,CACF,2016,POWAY ADHC CENTER ,ADULT_BREAKFAST,19,145,0,26,171,1017,0,182,1199,63.1053
SAN DIEGO,Nov 2015,CACF,2016,POWAY ADHC CENTER ,ADULT_LUNCH,19,145,0,26,171,1225,0,219,1444,76
SAN DIEGO,Nov 2015,CACF,2016,POWAY ADHC CENTER ,ADULT_SNACK_PM,19,145,0,26,171,153,0,28,181,9.5263
SAN DIEGO,Dec 2015,CACF,2016,POWAY ADHC CENTER ,ADULT_BREAKFAST,20,145,0,26,171,1018,0,183,1201,60.05
SAN DIEGO,Dec 2015,CACF,2016,POWAY ADHC CENTER ,ADULT_LUNCH,20,145,0,26,171,1251,0,224,1475,73.75
SAN DIEGO,Dec 2015,CACF,2016,POWAY ADHC CENTER ,ADULT_SNACK_PM,20,145,0,26,171,162,0,29,191,9.55
SAN DIEGO,Jan 2016,CACF,2016,POWAY ADHC CENTER ,ADULT_BREAKFAST,20,145,0,26,171,985,0,177,1162,58.1
SAN DIEGO,Jan 2016,CACF,2016,POWAY ADHC CENTER ,ADULT_LUNCH,20,145,0,26,171,1197,0,214,1411,70.55
SAN DIEGO,Jan 2016,CACF,2016,POWAY ADHC CENTER ,ADULT_SNACK_PM,20,145,0,26,171,176,0,32,208,10.4
SAN DIEGO,Feb 2016,CACF,2016,POWAY ADHC CENTER ,ADULT_BREAKFAST,21,145,0,26,171,1102,0,198,1300,61.9048
SAN DIEGO,Feb 2016,CACF,2016,POWAY ADHC CENTER ,ADULT_LUNCH,21,145,0,26,171,1315,0,236,1551,73.8571
SAN DIEGO,Feb 2016,CACF,2016,POWAY ADHC CENTER ,ADULT_SNACK_PM,21,145,0,26,171,163,0,29,192,9.1429
SAN DIEGO,Mar 2016,CACF,2016,POWAY ADHC CENTER ,ADULT_BREAKFAST,23,145,0,26,171,1159,0,208,1367,59.4348
SAN DIEGO,Mar 2016,CACF,2016,POWAY ADHC CENTER ,ADULT_LUNCH,23,145,0,26,171,1417,0,254,1671,72.6522
SAN DIEGO,Mar 2016,CACF,2016,POWAY ADHC CENTER ,ADULT_SNACK_PM,23,145,0,26,171,282,0,51,333,14.4783
SAN DIEGO,Apr 2016,CACF,2016,POWAY ADHC CENTER ,ADULT_BREAKFAST,21,145,0,26,171,1043,0,187,1230,58.5714
SAN DIEGO,Apr 2016,CACF,2016,POWAY ADHC CENTER ,ADULT_LUNCH,21,145,0,26,171,1241,0,223,1464,69.7143
SAN DIEGO,Apr 2016,CACF,2016,POWAY ADHC CENTER ,ADULT_SNACK_PM,21,145,0,26,171,150,0,27,177,8.4286
SAN DIEGO,May 2016,CACF,2016,POWAY ADHC CENTER ,ADULT_BREAKFAST,21,145,0,26,171,1057,0,190,1247,59.381
SAN DIEGO,May 2016,CACF,2016,POWAY ADHC CENTER ,ADULT_LUNCH,21,145,0,26,171,1248,0,224,1472,70.0952
SAN DIEGO,May 2016,CACF,2016,POWAY ADHC CENTER ,ADULT_SNACK_PM,21,145,0,26,171,159,0,29,188,8.9524
SAN DIEGO,Jun 2016,CACF,2016,POWAY ADHC CENTER ,ADULT_BREAKFAST,22,145,0,26,171,1101,0,197,1298,59
SAN DIEGO,Jun 2016,CACF,2016,POWAY ADHC CENTER ,ADULT_LUNCH,22,145,0,26,171,1289,0,231,1520,69.0909
SAN DIEGO,Jun 2016,CACF,2016,POWAY ADHC CENTER ,ADULT_SNACK_PM,22,145,0,26,171,196,0,35,231,10.5
SAN DIEGO,Jul 2016,CACF,2016,POWAY ADHC CENTER ,ADULT_BREAKFAST,20,145,0,26,171,953,0,171,1124,56.2
SAN DIEGO,Jul 2016,CACF,2016,POWAY ADHC CENTER ,ADULT_LUNCH,20,145,0,26,171,1120,0,201,1321,66.05
SAN DIEGO,Jul 2016,CACF,2016,POWAY ADHC CENTER ,ADULT_SNACK_PM,20,145,0,26,171,153,0,28,181,9.05
SAN DIEGO,Oct 2015,CACF,2016,QUALITY CHILDREN'S SERVICES ,CHILD_BREAKFAST,22,962,246,71,1279,10956,2801,808,14565,662.0455
SAN DIEGO,Oct 2015,CACF,2016,QUALITY CHILDREN'S SERVICES ,CHILD_LUNCH,22,962,246,71,1279,10934,2795,807,14536,660.7273
SAN DIEGO,Oct 2015,CACF,2016,QUALITY CHILDREN'S SERVICES ,CHILD_SNACK_AM,22,962,246,71,1279,11774,3010,869,15653,711.5
SAN DIEGO,Oct 2015,CACF,2016,QUALITY CHILDREN'S SERVICES ,CHILD_SNACK_PM,22,962,246,71,1279,5978,1528,441,7947,361.2273
SAN DIEGO,Nov 2015,CACF,2016,QUALITY CHILDREN'S SERVICES ,CHILD_BREAKFAST,19,962,246,71,1279,8811,2252,650,11713,616.4737
SAN DIEGO,Nov 2015,CACF,2016,QUALITY CHILDREN'S SERVICES ,CHILD_LUNCH,19,962,246,71,1279,8997,2300,664,11961,629.5263
SAN DIEGO,Nov 2015,CACF,2016,QUALITY CHILDREN'S SERVICES ,CHILD_SNACK_AM,19,962,246,71,1279,9567,2446,706,12719,669.4211
SAN DIEGO,Nov 2015,CACF,2016,QUALITY CHILDREN'S SERVICES ,CHILD_SNACK_PM,19,962,246,71,1279,5004,1279,369,6652,350.1053
SAN DIEGO,Dec 2015,CACF,2016,QUALITY CHILDREN'S SERVICES ,CHILD_BREAKFAST,20,962,246,71,1279,7316,1870,540,9726,486.3
SAN DIEGO,Dec 2015,CACF,2016,QUALITY CHILDREN'S SERVICES ,CHILD_LUNCH,20,962,246,71,1279,7645,1955,564,10164,508.2
SAN DIEGO,Dec 2015,CACF,2016,QUALITY CHILDREN'S SERVICES ,CHILD_SNACK_AM,20,962,246,71,1279,8067,2062,595,10724,536.2
SAN DIEGO,Dec 2015,CACF,2016,QUALITY CHILDREN'S SERVICES ,CHILD_SNACK_PM,20,962,246,71,1279,3784,967,280,5031,251.55
SAN DIEGO,Jan 2016,CACF,2016,QUALITY CHILDREN'S SERVICES ,CHILD_BREAKFAST,20,962,246,71,1279,8482,2168,626,11276,563.8
SAN DIEGO,Jan 2016,CACF,2016,QUALITY CHILDREN'S SERVICES ,CHILD_LUNCH,20,962,246,71,1279,9113,2330,672,12115,605.75
SAN DIEGO,Jan 2016,CACF,2016,QUALITY CHILDREN'S SERVICES ,CHILD_SNACK_AM,20,962,246,71,1279,9415,2407,694,12516,625.8
SAN DIEGO,Jan 2016,CACF,2016,QUALITY CHILDREN'S SERVICES ,CHILD_SNACK_PM,20,962,246,71,1279,4968,1270,366,6604,330.2
SAN DIEGO,Feb 2016,CACF,2016,QUALITY CHILDREN'S SERVICES ,CHILD_BREAKFAST,20,962,246,71,1279,9107,2328,672,12107,605.35
SAN DIEGO,Feb 2016,CACF,2016,QUALITY CHILDREN'S SERVICES ,CHILD_LUNCH,20,962,246,71,1279,9414,2407,694,12515,625.75
SAN DIEGO,Feb 2016,CACF,2016,QUALITY CHILDREN'S SERVICES ,CHILD_SNACK_AM,20,962,246,71,1279,9886,2527,730,13143,657.15
SAN DIEGO,Feb 2016,CACF,2016,QUALITY CHILDREN'S SERVICES ,CHILD_SNACK_PM,20,962,246,71,1279,5362,1371,396,7129,356.45
SAN DIEGO,Mar 2016,CACF,2016,QUALITY CHILDREN'S SERVICES ,CHILD_BREAKFAST,23,962,246,71,1279,10601,2710,782,14093,612.7391
SAN DIEGO,Mar 2016,CACF,2016,QUALITY CHILDREN'S SERVICES ,CHILD_LUNCH,23,962,246,71,1279,11138,2847,822,14807,643.7826
SAN DIEGO,Mar 2016,CACF,2016,QUALITY CHILDREN'S SERVICES ,CHILD_SNACK_AM,23,962,246,71,1279,11304,2890,834,15028,653.3913
SAN DIEGO,Mar 2016,CACF,2016,QUALITY CHILDREN'S SERVICES ,CHILD_SNACK_PM,23,962,246,71,1279,6244,1596,461,8301,360.913
SAN DIEGO,Apr 2016,CACF,2016,QUALITY CHILDREN'S SERVICES ,CHILD_BREAKFAST,21,962,246,71,1279,10014,2560,739,13313,633.9524
SAN DIEGO,Apr 2016,CACF,2016,QUALITY CHILDREN'S SERVICES ,CHILD_LUNCH,21,962,246,71,1279,10508,2686,776,13970,665.2381
SAN DIEGO,Apr 2016,CACF,2016,QUALITY CHILDREN'S SERVICES ,CHILD_SNACK_AM,21,962,246,71,1279,10909,2789,805,14503,690.619
SAN DIEGO,Apr 2016,CACF,2016,QUALITY CHILDREN'S SERVICES ,CHILD_SNACK_PM,21,962,246,71,1279,5796,1482,428,7706,366.9524
SAN DIEGO,May 2016,CACF,2016,QUALITY CHILDREN'S SERVICES ,CHILD_BREAKFAST,21,962,246,71,1279,10007,2558,738,13303,633.4762
SAN DIEGO,May 2016,CACF,2016,QUALITY CHILDREN'S SERVICES ,CHILD_LUNCH,21,962,246,71,1279,10606,2711,783,14100,671.4286
SAN DIEGO,May 2016,CACF,2016,QUALITY CHILDREN'S SERVICES ,CHILD_SNACK_AM,21,962,246,71,1279,10943,2798,807,14548,692.7619
SAN DIEGO,May 2016,CACF,2016,QUALITY CHILDREN'S SERVICES ,CHILD_SNACK_PM,21,962,246,71,1279,5807,1485,428,7720,367.619
SAN DIEGO,Jun 2016,CACF,2016,QUALITY CHILDREN'S SERVICES ,CHILD_BREAKFAST,22,962,246,71,1279,8460,2163,624,11247,511.2273
SAN DIEGO,Jun 2016,CACF,2016,QUALITY CHILDREN'S SERVICES ,CHILD_LUNCH,22,962,246,71,1279,9437,2413,696,12546,570.2727
SAN DIEGO,Jun 2016,CACF,2016,QUALITY CHILDREN'S SERVICES ,CHILD_SNACK_AM,22,962,246,71,1279,9380,2398,692,12470,566.8182
SAN DIEGO,Jun 2016,CACF,2016,QUALITY CHILDREN'S SERVICES ,CHILD_SNACK_PM,22,962,246,71,1279,5120,1309,378,6807,309.4091
SAN DIEGO,Jul 2016,CACF,2016,QUALITY CHILDREN'S SERVICES ,CHILD_BREAKFAST,20,962,246,71,1279,3498,894,258,4650,232.5
SAN DIEGO,Jul 2016,CACF,2016,QUALITY CHILDREN'S SERVICES ,CHILD_LUNCH,20,962,246,71,1279,4112,1051,304,5467,273.35
SAN DIEGO,Jul 2016,CACF,2016,QUALITY CHILDREN'S SERVICES ,CHILD_SNACK_AM,20,962,246,71,1279,4149,1061,306,5516,275.8
SAN DIEGO,Oct 2015,CACF,2016,READY SET GROW,CHILD_BREAKFAST,22,14,3,40,57,177,38,504,719,32.6818
SAN DIEGO,Oct 2015,CACF,2016,READY SET GROW,CHILD_LUNCH,22,14,3,40,57,180,39,515,734,33.3636
SAN DIEGO,Oct 2015,CACF,2016,READY SET GROW,CHILD_SNACK_PM,22,14,3,40,57,183,39,524,746,33.9091
SAN DIEGO,Oct 2015,CACF,2016,READY SET GROW,OSCH_CHILD_BREAKFAST,22,7,1,3,11,28,4,12,44,2
SAN DIEGO,Oct 2015,CACF,2016,READY SET GROW,OSCH_CHILD_LUNCH,22,7,1,3,11,1,0,0,1,0.0455
SAN DIEGO,Oct 2015,CACF,2016,READY SET GROW,OSCH_CHILD_SNACK_PM,22,7,1,3,11,87,12,37,136,6.1818
SAN DIEGO,Nov 2015,CACF,2016,READY SET GROW,CHILD_BREAKFAST,19,14,3,40,57,151,32,431,614,32.3158
SAN DIEGO,Nov 2015,CACF,2016,READY SET GROW,CHILD_LUNCH,19,14,3,40,57,166,35,473,674,35.4737
SAN DIEGO,Nov 2015,CACF,2016,READY SET GROW,CHILD_SNACK_PM,19,14,3,40,57,166,35,473,674,35.4737
SAN DIEGO,Nov 2015,CACF,2016,READY SET GROW,OSCH_CHILD_BREAKFAST,19,7,1,3,11,15,2,6,23,1.2105
SAN DIEGO,Nov 2015,CACF,2016,READY SET GROW,OSCH_CHILD_LUNCH,19,7,1,3,11,9,1,4,14,0.7368
SAN DIEGO,Nov 2015,CACF,2016,READY SET GROW,OSCH_CHILD_SNACK_PM,19,7,1,3,11,62,9,26,97,5.1053
SAN DIEGO,Dec 2015,CACF,2016,READY SET GROW,CHILD_BREAKFAST,21,14,3,40,57,162,35,462,659,31.381
SAN DIEGO,Dec 2015,CACF,2016,READY SET GROW,CHILD_LUNCH,21,14,3,40,57,173,37,494,704,33.5238
SAN DIEGO,Dec 2015,CACF,2016,READY SET GROW,CHILD_SNACK_PM,21,14,3,40,57,174,37,499,710,33.8095
SAN DIEGO,Dec 2015,CACF,2016,READY SET GROW,OSCH_CHILD_BREAKFAST,21,7,1,3,11,26,4,11,41,1.9524
SAN DIEGO,Dec 2015,CACF,2016,READY SET GROW,OSCH_CHILD_LUNCH,21,7,1,3,11,18,3,7,28,1.3333
SAN DIEGO,Dec 2015,CACF,2016,READY SET GROW,OSCH_CHILD_SNACK_PM,21,7,1,3,11,67,10,29,106,5.0476
SAN DIEGO,Jan 2016,CACF,2016,READY SET GROW,CHILD_BREAKFAST,20,14,3,40,57,189,40,539,768,38.4
SAN DIEGO,Jan 2016,CACF,2016,READY SET GROW,CHILD_LUNCH,20,14,3,40,57,200,43,570,813,40.65
SAN DIEGO,Jan 2016,CACF,2016,READY SET GROW,CHILD_SNACK_PM,20,14,3,40,57,203,44,580,827,41.35
SAN DIEGO,Jan 2016,CACF,2016,READY SET GROW,OSCH_CHILD_BREAKFAST,20,7,1,3,11,43,6,18,67,3.35
SAN DIEGO,Jan 2016,CACF,2016,READY SET GROW,OSCH_CHILD_LUNCH,20,7,1,3,11,9,1,4,14,0.7
SAN DIEGO,Jan 2016,CACF,2016,READY SET GROW,OSCH_CHILD_SNACK_PM,20,7,1,3,11,95,14,41,150,7.5
SAN DIEGO,Feb 2016,CACF,2016,READY SET GROW,CHILD_BREAKFAST,20,14,3,40,57,185,40,527,752,37.6
SAN DIEGO,Feb 2016,CACF,2016,READY SET GROW,CHILD_LUNCH,20,14,3,40,57,201,43,576,820,41
SAN DIEGO,Feb 2016,CACF,2016,READY SET GROW,CHILD_SNACK_PM,20,14,3,40,57,205,44,584,833,41.65
SAN DIEGO,Feb 2016,CACF,2016,READY SET GROW,OSCH_CHILD_BREAKFAST,20,7,1,3,11,42,6,18,66,3.3
SAN DIEGO,Feb 2016,CACF,2016,READY SET GROW,OSCH_CHILD_LUNCH,20,7,1,3,11,4,1,1,6,0.3
SAN DIEGO,Feb 2016,CACF,2016,READY SET GROW,OSCH_CHILD_SNACK_PM,20,7,1,3,11,111,16,47,174,8.7
SAN DIEGO,Mar 2016,CACF,2016,READY SET GROW,CHILD_BREAKFAST,23,14,3,40,57,192,41,549,782,34
SAN DIEGO,Mar 2016,CACF,2016,READY SET GROW,CHILD_LUNCH,23,14,3,40,57,223,48,636,907,39.4348
SAN DIEGO,Mar 2016,CACF,2016,READY SET GROW,CHILD_SNACK_PM,23,14,3,40,57,219,47,625,891,38.7391
SAN DIEGO,Mar 2016,CACF,2016,READY SET GROW,OSCH_CHILD_BREAKFAST,23,7,1,3,11,38,5,17,60,2.6087
SAN DIEGO,Mar 2016,CACF,2016,READY SET GROW,OSCH_CHILD_LUNCH,23,7,1,3,11,36,5,16,57,2.4783
SAN DIEGO,Mar 2016,CACF,2016,READY SET GROW,OSCH_CHILD_SNACK_PM,23,7,1,3,11,107,15,46,168,7.3043
SAN DIEGO,Apr 2016,CACF,2016,READY SET GROW,CHILD_BREAKFAST,21,15,3,41,59,183,37,500,720,34.2857
SAN DIEGO,Apr 2016,CACF,2016,READY SET GROW,CHILD_LUNCH,21,15,3,41,59,225,45,617,887,42.2381
SAN DIEGO,Apr 2016,CACF,2016,READY SET GROW,CHILD_SNACK_PM,21,15,3,41,59,230,46,627,903,43
SAN DIEGO,Apr 2016,CACF,2016,READY SET GROW,OSCH_CHILD_BREAKFAST,21,7,1,3,11,34,5,14,53,2.5238
SAN DIEGO,Apr 2016,CACF,2016,READY SET GROW,OSCH_CHILD_LUNCH,21,7,1,3,11,4,1,1,6,0.2857
SAN DIEGO,Apr 2016,CACF,2016,READY SET GROW,OSCH_CHILD_SNACK_PM,21,7,1,3,11,107,15,46,168,8
SAN DIEGO,May 2016,CACF,2016,READY SET GROW,CHILD_BREAKFAST,21,15,3,41,59,204,41,558,803,38.2381
SAN DIEGO,May 2016,CACF,2016,READY SET GROW,CHILD_LUNCH,21,15,3,41,59,238,48,651,937,44.619
SAN DIEGO,May 2016,CACF,2016,READY SET GROW,CHILD_SNACK_PM,21,15,3,41,59,241,48,660,949,45.1905
SAN DIEGO,May 2016,CACF,2016,READY SET GROW,OSCH_CHILD_BREAKFAST,21,7,1,3,11,36,5,15,56,2.6667
SAN DIEGO,May 2016,CACF,2016,READY SET GROW,OSCH_CHILD_SNACK_PM,21,7,1,3,11,100,14,43,157,7.4762
SAN DIEGO,Jun 2016,CACF,2016,READY SET GROW,CHILD_BREAKFAST,22,15,3,41,59,207,41,566,814,37
SAN DIEGO,Jun 2016,CACF,2016,READY SET GROW,CHILD_LUNCH,22,15,3,41,59,236,47,646,929,42.2273
SAN DIEGO,Jun 2016,CACF,2016,READY SET GROW,CHILD_SNACK_PM,22,15,3,41,59,234,47,638,919,41.7727
SAN DIEGO,Jun 2016,CACF,2016,READY SET GROW,OSCH_CHILD_BREAKFAST,22,7,1,3,11,49,7,21,77,3.5
SAN DIEGO,Jun 2016,CACF,2016,READY SET GROW,OSCH_CHILD_LUNCH,22,7,1,3,11,22,3,10,35,1.5909
SAN DIEGO,Jun 2016,CACF,2016,READY SET GROW,OSCH_CHILD_SNACK_PM,22,7,1,3,11,84,12,36,132,6
SAN DIEGO,Jul 2016,CACF,2016,READY SET GROW,CHILD_BREAKFAST,21,15,3,41,59,169,34,462,665,31.6667
SAN DIEGO,Jul 2016,CACF,2016,READY SET GROW,CHILD_LUNCH,21,15,3,41,59,199,40,542,781,37.1905
SAN DIEGO,Jul 2016,CACF,2016,READY SET GROW,CHILD_SNACK_PM,21,15,3,41,59,190,38,518,746,35.5238
SAN DIEGO,Jul 2016,CACF,2016,READY SET GROW,OSCH_CHILD_BREAKFAST,21,7,1,3,11,58,8,25,91,4.3333
SAN DIEGO,Jul 2016,CACF,2016,READY SET GROW,OSCH_CHILD_LUNCH,21,7,1,3,11,60,9,25,94,4.4762
SAN DIEGO,Jul 2016,CACF,2016,READY SET GROW,OSCH_CHILD_SNACK_PM,21,7,1,3,11,56,8,24,88,4.1905
SAN DIEGO,Apr 2016,CACF,2016,RISING STAR ACAD CHILDCARE CTR,CHILD_BREAKFAST,21,23,0,1,24,142,0,6,148,7.0476
SAN DIEGO,Apr 2016,CACF,2016,RISING STAR ACAD CHILDCARE CTR,CHILD_LUNCH,21,23,0,1,24,200,0,9,209,9.9524
SAN DIEGO,Apr 2016,CACF,2016,RISING STAR ACAD CHILDCARE CTR,CHILD_SNACK_PM,21,23,0,1,24,175,0,8,183,8.7143
SAN DIEGO,Apr 2016,CACF,2016,RISING STAR ACAD CHILDCARE CTR,OSCH_CHILD_BREAKFAST,21,5,0,0,5,16,0,0,16,0.7619
SAN DIEGO,Apr 2016,CACF,2016,RISING STAR ACAD CHILDCARE CTR,OSCH_CHILD_LUNCH,21,5,0,0,5,5,0,0,5,0.2381
SAN DIEGO,Apr 2016,CACF,2016,RISING STAR ACAD CHILDCARE CTR,OSCH_CHILD_SNACK_PM,21,5,0,0,5,67,0,0,67,3.1905
SAN DIEGO,May 2016,CACF,2016,RISING STAR ACAD CHILDCARE CTR,CHILD_BREAKFAST,21,23,0,1,24,192,0,8,200,9.5238
SAN DIEGO,May 2016,CACF,2016,RISING STAR ACAD CHILDCARE CTR,CHILD_LUNCH,21,23,0,1,24,238,0,10,248,11.8095
SAN DIEGO,May 2016,CACF,2016,RISING STAR ACAD CHILDCARE CTR,CHILD_SNACK_PM,21,23,0,1,24,198,0,9,207,9.8571
SAN DIEGO,May 2016,CACF,2016,RISING STAR ACAD CHILDCARE CTR,OSCH_CHILD_BREAKFAST,21,5,0,0,5,19,0,0,19,0.9048
SAN DIEGO,May 2016,CACF,2016,RISING STAR ACAD CHILDCARE CTR,OSCH_CHILD_SNACK_PM,21,5,0,0,5,72,0,0,72,3.4286
SAN DIEGO,Jun 2016,CACF,2016,RISING STAR ACAD CHILDCARE CTR,CHILD_BREAKFAST,21,23,0,1,24,242,0,11,253,12.0476
SAN DIEGO,Jun 2016,CACF,2016,RISING STAR ACAD CHILDCARE CTR,CHILD_LUNCH,21,23,0,1,24,359,0,16,375,17.8571
SAN DIEGO,Jun 2016,CACF,2016,RISING STAR ACAD CHILDCARE CTR,CHILD_SNACK_PM,21,23,0,1,24,311,0,14,325,15.4762
SAN DIEGO,Jun 2016,CACF,2016,RISING STAR ACAD CHILDCARE CTR,OSCH_CHILD_BREAKFAST,21,7,0,0,7,99,0,0,99,4.7143
SAN DIEGO,Jun 2016,CACF,2016,RISING STAR ACAD CHILDCARE CTR,OSCH_CHILD_LUNCH,21,7,0,0,7,118,0,0,118,5.619
SAN DIEGO,Jun 2016,CACF,2016,RISING STAR ACAD CHILDCARE CTR,OSCH_CHILD_SNACK_PM,21,7,0,0,7,101,0,0,101,4.8095
SAN DIEGO,Jul 2016,CACF,2016,RISING STAR ACAD CHILDCARE CTR,CHILD_BREAKFAST,20,23,0,1,24,299,0,13,312,15.6
SAN DIEGO,Jul 2016,CACF,2016,RISING STAR ACAD CHILDCARE CTR,CHILD_LUNCH,20,23,0,1,24,369,0,16,385,19.25
SAN DIEGO,Jul 2016,CACF,2016,RISING STAR ACAD CHILDCARE CTR,CHILD_SNACK_PM,20,23,0,1,24,312,0,14,326,16.3
SAN DIEGO,Jul 2016,CACF,2016,RISING STAR ACAD CHILDCARE CTR,OSCH_CHILD_BREAKFAST,20,7,0,0,7,90,0,0,90,4.5
SAN DIEGO,Jul 2016,CACF,2016,RISING STAR ACAD CHILDCARE CTR,OSCH_CHILD_LUNCH,20,7,0,0,7,113,0,0,113,5.65
SAN DIEGO,Jul 2016,CACF,2016,RISING STAR ACAD CHILDCARE CTR,OSCH_CHILD_SNACK_PM,20,7,0,0,7,87,0,0,87,4.35
SAN DIEGO,Oct 2015,CACF,2016,SAINT VINCENT DE PAUL VILLAGE,ES_CHILD_BREAKFAST,31,621,0,0,621,1611,0,0,1611,51.9677
SAN DIEGO,Oct 2015,CACF,2016,SAINT VINCENT DE PAUL VILLAGE,ES_CHILD_LUNCH,31,621,0,0,621,1465,0,0,1465,47.2581
SAN DIEGO,Oct 2015,CACF,2016,SAINT VINCENT DE PAUL VILLAGE,ES_CHILD_SUPPER,31,621,0,0,621,2621,0,0,2621,84.5484
SAN DIEGO,Nov 2015,CACF,2016,SAINT VINCENT DE PAUL VILLAGE,ES_CHILD_BREAKFAST,30,591,0,0,591,1352,0,0,1352,45.0667
SAN DIEGO,Nov 2015,CACF,2016,SAINT VINCENT DE PAUL VILLAGE,ES_CHILD_LUNCH,30,591,0,0,591,1424,0,0,1424,47.4667
SAN DIEGO,Nov 2015,CACF,2016,SAINT VINCENT DE PAUL VILLAGE,ES_CHILD_SUPPER,30,591,0,0,591,1937,0,0,1937,64.5667
SAN DIEGO,Dec 2015,CACF,2016,SAINT VINCENT DE PAUL VILLAGE,ES_CHILD_BREAKFAST,31,599,0,0,599,1417,0,0,1417,45.7097
SAN DIEGO,Dec 2015,CACF,2016,SAINT VINCENT DE PAUL VILLAGE,ES_CHILD_LUNCH,31,599,0,0,599,1803,0,0,1803,58.1613
SAN DIEGO,Dec 2015,CACF,2016,SAINT VINCENT DE PAUL VILLAGE,ES_CHILD_SUPPER,31,599,0,0,599,1644,0,0,1644,53.0323
SAN DIEGO,Jan 2016,CACF,2016,SAINT VINCENT DE PAUL VILLAGE,ES_CHILD_BREAKFAST,31,621,0,0,621,1313,0,0,1313,42.3548
SAN DIEGO,Jan 2016,CACF,2016,SAINT VINCENT DE PAUL VILLAGE,ES_CHILD_LUNCH,31,621,0,0,621,1687,0,0,1687,54.4194
SAN DIEGO,Jan 2016,CACF,2016,SAINT VINCENT DE PAUL VILLAGE,ES_CHILD_SUPPER,31,621,0,0,621,2801,0,0,2801,90.3548
SAN DIEGO,Feb 2016,CACF,2016,SAINT VINCENT DE PAUL VILLAGE,ES_CHILD_BREAKFAST,29,543,0,0,543,1275,0,0,1275,43.9655
SAN DIEGO,Feb 2016,CACF,2016,SAINT VINCENT DE PAUL VILLAGE,ES_CHILD_LUNCH,29,543,0,0,543,1161,0,0,1161,40.0345
SAN DIEGO,Feb 2016,CACF,2016,SAINT VINCENT DE PAUL VILLAGE,ES_CHILD_SUPPER,29,543,0,0,543,2738,0,0,2738,94.4138
SAN DIEGO,Mar 2016,CACF,2016,SAINT VINCENT DE PAUL VILLAGE,ES_CHILD_BREAKFAST,31,614,0,0,614,1173,0,0,1173,37.8387
SAN DIEGO,Mar 2016,CACF,2016,SAINT VINCENT DE PAUL VILLAGE,ES_CHILD_LUNCH,31,614,0,0,614,1357,0,0,1357,43.7742
SAN DIEGO,Mar 2016,CACF,2016,SAINT VINCENT DE PAUL VILLAGE,ES_CHILD_SUPPER,31,614,0,0,614,2815,0,0,2815,90.8065
SAN DIEGO,Apr 2016,CACF,2016,SAINT VINCENT DE PAUL VILLAGE,ES_CHILD_BREAKFAST,30,599,0,0,599,1256,0,0,1256,41.8667
SAN DIEGO,Apr 2016,CACF,2016,SAINT VINCENT DE PAUL VILLAGE,ES_CHILD_LUNCH,30,599,0,0,599,1359,0,0,1359,45.3
SAN DIEGO,Apr 2016,CACF,2016,SAINT VINCENT DE PAUL VILLAGE,ES_CHILD_SUPPER,30,599,0,0,599,2418,0,0,2418,80.6
SAN DIEGO,May 2016,CACF,2016,SAINT VINCENT DE PAUL VILLAGE,ES_CHILD_BREAKFAST,31,571,0,0,571,1527,0,0,1527,49.2581
SAN DIEGO,May 2016,CACF,2016,SAINT VINCENT DE PAUL VILLAGE,ES_CHILD_LUNCH,31,571,0,0,571,1402,0,0,1402,45.2258
SAN DIEGO,May 2016,CACF,2016,SAINT VINCENT DE PAUL VILLAGE,ES_CHILD_SUPPER,31,571,0,0,571,2550,0,0,2550,82.2581
SAN DIEGO,Jun 2016,CACF,2016,SAINT VINCENT DE PAUL VILLAGE,ES_CHILD_BREAKFAST,30,591,0,0,591,1318,0,0,1318,43.9333
SAN DIEGO,Jun 2016,CACF,2016,SAINT VINCENT DE PAUL VILLAGE,ES_CHILD_LUNCH,30,591,0,0,591,1422,0,0,1422,47.4
SAN DIEGO,Jun 2016,CACF,2016,SAINT VINCENT DE PAUL VILLAGE,ES_CHILD_SUPPER,30,591,0,0,591,2454,0,0,2454,81.8
SAN DIEGO,Jul 2016,CACF,2016,SAINT VINCENT DE PAUL VILLAGE,ES_CHILD_BREAKFAST,31,566,0,0,566,1059,0,0,1059,34.1613
SAN DIEGO,Jul 2016,CACF,2016,SAINT VINCENT DE PAUL VILLAGE,ES_CHILD_LUNCH,31,566,0,0,566,1703,0,0,1703,54.9355
SAN DIEGO,Jul 2016,CACF,2016,SAINT VINCENT DE PAUL VILLAGE,ES_CHILD_SUPPER,31,566,0,0,566,2293,0,0,2293,73.9677
SAN DIEGO,Jul 2016,CACF,2016,Salvation Army-San Diego A California Corporation,CHILD_BREAKFAST,19,20,1,84,105,217,11,909,1137,59.8421
SAN DIEGO,Jul 2016,CACF,2016,Salvation Army-San Diego A California Corporation,CHILD_LUNCH,19,20,1,84,105,230,11,967,1208,63.5789
SAN DIEGO,Jul 2016,CACF,2016,Salvation Army-San Diego A California Corporation,CHILD_SNACK_PM,19,20,1,84,105,211,11,888,1110,58.4211
SAN DIEGO,Oct 2015,CACF,2016,SAN DIEGO COMMUNITY COLL DIST ,CHILD_BREAKFAST,22,30,2,5,37,431,29,71,531,24.1364
SAN DIEGO,Oct 2015,CACF,2016,SAN DIEGO COMMUNITY COLL DIST ,CHILD_LUNCH,22,30,2,5,37,482,32,80,594,27
SAN DIEGO,Oct 2015,CACF,2016,SAN DIEGO COMMUNITY COLL DIST ,CHILD_SNACK_PM,22,30,2,5,37,178,12,30,220,10
SAN DIEGO,Oct 2015,CACF,2016,SAN DIEGO COMMUNITY COLL DIST ,HS_CHILD_BREAKFAST,22,116,0,0,116,1605,0,0,1605,72.9545
SAN DIEGO,Oct 2015,CACF,2016,SAN DIEGO COMMUNITY COLL DIST ,HS_CHILD_LUNCH,22,116,0,0,116,1866,0,0,1866,84.8182
SAN DIEGO,Oct 2015,CACF,2016,SAN DIEGO COMMUNITY COLL DIST ,HS_CHILD_SNACK_PM,22,116,0,0,116,973,0,0,973,44.2273
SAN DIEGO,Nov 2015,CACF,2016,SAN DIEGO COMMUNITY COLL DIST ,CHILD_BREAKFAST,15,29,2,5,36,283,20,48,351,23.4
SAN DIEGO,Nov 2015,CACF,2016,SAN DIEGO COMMUNITY COLL DIST ,CHILD_LUNCH,15,29,2,5,36,317,22,54,393,26.2
SAN DIEGO,Nov 2015,CACF,2016,SAN DIEGO COMMUNITY COLL DIST ,CHILD_SNACK_PM,15,29,2,5,36,123,9,21,153,10.2
SAN DIEGO,Nov 2015,CACF,2016,SAN DIEGO COMMUNITY COLL DIST ,HS_CHILD_BREAKFAST,15,119,0,0,119,1107,0,0,1107,73.8
SAN DIEGO,Nov 2015,CACF,2016,SAN DIEGO COMMUNITY COLL DIST ,HS_CHILD_LUNCH,15,119,0,0,119,1254,0,0,1254,83.6
SAN DIEGO,Nov 2015,CACF,2016,SAN DIEGO COMMUNITY COLL DIST ,HS_CHILD_SNACK_PM,15,119,0,0,119,711,0,0,711,47.4
SAN DIEGO,Dec 2015,CACF,2016,SAN DIEGO COMMUNITY COLL DIST ,CHILD_BREAKFAST,14,36,2,6,44,299,17,50,366,26.1429
SAN DIEGO,Dec 2015,CACF,2016,SAN DIEGO COMMUNITY COLL DIST ,CHILD_LUNCH,14,36,2,6,44,347,19,58,424,30.2857
SAN DIEGO,Dec 2015,CACF,2016,SAN DIEGO COMMUNITY COLL DIST ,CHILD_SNACK_PM,14,36,2,6,44,128,7,22,157,11.2143
SAN DIEGO,Dec 2015,CACF,2016,SAN DIEGO COMMUNITY COLL DIST ,HS_CHILD_BREAKFAST,14,112,0,0,112,998,0,0,998,71.2857
SAN DIEGO,Dec 2015,CACF,2016,SAN DIEGO COMMUNITY COLL DIST ,HS_CHILD_LUNCH,14,112,0,0,112,1125,0,0,1125,80.3571
SAN DIEGO,Dec 2015,CACF,2016,SAN DIEGO COMMUNITY COLL DIST ,HS_CHILD_SNACK_PM,14,112,0,0,112,581,0,0,581,41.5
SAN DIEGO,Jan 2016,CACF,2016,SAN DIEGO COMMUNITY COLL DIST ,CHILD_BREAKFAST,14,45,2,5,52,205,9,23,237,16.9286
SAN DIEGO,Jan 2016,CACF,2016,SAN DIEGO COMMUNITY COLL DIST ,CHILD_LUNCH,14,45,2,5,52,168,7,19,194,13.8571
SAN DIEGO,Jan 2016,CACF,2016,SAN DIEGO COMMUNITY COLL DIST ,CHILD_SNACK_PM,14,45,2,5,52,78,3,9,90,6.4286
SAN DIEGO,Jan 2016,CACF,2016,SAN DIEGO COMMUNITY COLL DIST ,HS_CHILD_BREAKFAST,14,113,0,0,113,459,0,0,459,32.7857
SAN DIEGO,Jan 2016,CACF,2016,SAN DIEGO COMMUNITY COLL DIST ,HS_CHILD_LUNCH,14,113,0,0,113,532,0,0,532,38
SAN DIEGO,Jan 2016,CACF,2016,SAN DIEGO COMMUNITY COLL DIST ,HS_CHILD_SNACK_PM,14,113,0,0,113,332,0,0,332,23.7143
SAN DIEGO,Feb 2016,CACF,2016,SAN DIEGO COMMUNITY COLL DIST ,CHILD_BREAKFAST,19,44,2,5,51,576,26,66,668,35.1579
SAN DIEGO,Feb 2016,CACF,2016,SAN DIEGO COMMUNITY COLL DIST ,CHILD_LUNCH,19,44,2,5,51,606,28,69,703,37
SAN DIEGO,Feb 2016,CACF,2016,SAN DIEGO COMMUNITY COLL DIST ,CHILD_SNACK_PM,19,44,2,5,51,275,13,31,319,16.7895
SAN DIEGO,Feb 2016,CACF,2016,SAN DIEGO COMMUNITY COLL DIST ,HS_CHILD_BREAKFAST,19,114,0,0,114,1351,0,0,1351,71.1053
SAN DIEGO,Feb 2016,CACF,2016,SAN DIEGO COMMUNITY COLL DIST ,HS_CHILD_LUNCH,19,114,0,0,114,1500,0,0,1500,78.9474
SAN DIEGO,Feb 2016,CACF,2016,SAN DIEGO COMMUNITY COLL DIST ,HS_CHILD_SNACK_PM,19,114,0,0,114,876,0,0,876,46.1053
SAN DIEGO,Mar 2016,CACF,2016,SAN DIEGO COMMUNITY COLL DIST ,CHILD_BREAKFAST,19,39,4,5,48,501,51,65,617,32.4737
SAN DIEGO,Mar 2016,CACF,2016,SAN DIEGO COMMUNITY COLL DIST ,CHILD_LUNCH,19,39,4,5,48,535,55,69,659,34.6842
SAN DIEGO,Mar 2016,CACF,2016,SAN DIEGO COMMUNITY COLL DIST ,CHILD_SNACK_PM,19,39,4,5,48,254,26,33,313,16.4737
SAN DIEGO,Mar 2016,CACF,2016,SAN DIEGO COMMUNITY COLL DIST ,HS_CHILD_BREAKFAST,19,115,0,0,115,1314,0,0,1314,69.1579
SAN DIEGO,Mar 2016,CACF,2016,SAN DIEGO COMMUNITY COLL DIST ,HS_CHILD_LUNCH,19,115,0,0,115,1476,0,0,1476,77.6842
SAN DIEGO,Mar 2016,CACF,2016,SAN DIEGO COMMUNITY COLL DIST ,HS_CHILD_SNACK_PM,19,115,0,0,115,850,0,0,850,44.7368
SAN DIEGO,Apr 2016,CACF,2016,SAN DIEGO COMMUNITY COLL DIST ,CHILD_BREAKFAST,20,38,4,5,47,550,58,72,680,34
SAN DIEGO,Apr 2016,CACF,2016,SAN DIEGO COMMUNITY COLL DIST ,CHILD_LUNCH,20,38,4,5,47,635,67,84,786,39.3
SAN DIEGO,Apr 2016,CACF,2016,SAN DIEGO COMMUNITY COLL DIST ,CHILD_SNACK_PM,20,38,4,5,47,273,29,36,338,16.9
SAN DIEGO,Apr 2016,CACF,2016,SAN DIEGO COMMUNITY COLL DIST ,HS_CHILD_BREAKFAST,20,115,0,0,115,1427,0,0,1427,71.35
SAN DIEGO,Apr 2016,CACF,2016,SAN DIEGO COMMUNITY COLL DIST ,HS_CHILD_LUNCH,20,115,0,0,115,1602,0,0,1602,80.1
SAN DIEGO,Apr 2016,CACF,2016,SAN DIEGO COMMUNITY COLL DIST ,HS_CHILD_SNACK_PM,20,115,0,0,115,899,0,0,899,44.95
SAN DIEGO,May 2016,CACF,2016,SAN DIEGO COMMUNITY COLL DIST ,CHILD_BREAKFAST,15,37,4,5,46,426,46,58,530,35.3333
SAN DIEGO,May 2016,CACF,2016,SAN DIEGO COMMUNITY COLL DIST ,CHILD_LUNCH,15,37,4,5,46,471,51,63,585,39
SAN DIEGO,May 2016,CACF,2016,SAN DIEGO COMMUNITY COLL DIST ,CHILD_SNACK_PM,15,37,4,5,46,216,23,29,268,17.8667
SAN DIEGO,May 2016,CACF,2016,SAN DIEGO COMMUNITY COLL DIST ,HS_CHILD_BREAKFAST,15,115,0,0,115,1049,0,0,1049,69.9333
SAN DIEGO,May 2016,CACF,2016,SAN DIEGO COMMUNITY COLL DIST ,HS_CHILD_LUNCH,15,115,0,0,115,1197,0,0,1197,79.8
SAN DIEGO,May 2016,CACF,2016,SAN DIEGO COMMUNITY COLL DIST ,HS_CHILD_SNACK_PM,15,115,0,0,115,712,0,0,712,47.4667
SAN DIEGO,Dec 2015,CACF,2016,San Diego County Office of Education,HS_CHILD_BREAKFAST,10,31,0,0,31,178,0,0,178,17.8
SAN DIEGO,Dec 2015,CACF,2016,San Diego County Office of Education,HS_CHILD_LUNCH,10,31,0,0,31,184,0,0,184,18.4
SAN DIEGO,Dec 2015,CACF,2016,San Diego County Office of Education,HS_CHILD_SNACK_PM,10,31,0,0,31,51,0,0,51,5.1
SAN DIEGO,Jan 2016,CACF,2016,San Diego County Office of Education,HS_CHILD_BREAKFAST,18,41,0,0,41,248,0,0,248,13.7778
SAN DIEGO,Jan 2016,CACF,2016,San Diego County Office of Education,HS_CHILD_LUNCH,18,41,0,0,41,230,0,0,230,12.7778
SAN DIEGO,Jan 2016,CACF,2016,San Diego County Office of Education,HS_CHILD_SNACK_PM,18,41,0,0,41,111,0,0,111,6.1667
SAN DIEGO,Feb 2016,CACF,2016,San Diego County Office of Education,HS_CHILD_BREAKFAST,18,41,0,0,41,306,0,0,306,17
SAN DIEGO,Feb 2016,CACF,2016,San Diego County Office of Education,HS_CHILD_LUNCH,18,41,0,0,41,312,0,0,312,17.3333
SAN DIEGO,Feb 2016,CACF,2016,San Diego County Office of Education,HS_CHILD_SNACK_PM,18,41,0,0,41,190,0,0,190,10.5556
SAN DIEGO,Mar 2016,CACF,2016,San Diego County Office of Education,HS_CHILD_BREAKFAST,17,41,0,0,41,319,0,0,319,18.7647
SAN DIEGO,Mar 2016,CACF,2016,San Diego County Office of Education,HS_CHILD_LUNCH,17,41,0,0,41,309,0,0,309,18.1765
SAN DIEGO,Mar 2016,CACF,2016,San Diego County Office of Education,HS_CHILD_SNACK_PM,17,41,0,0,41,157,0,0,157,9.2353
SAN DIEGO,Apr 2016,CACF,2016,San Diego County Office of Education,HS_CHILD_BREAKFAST,20,48,0,0,48,353,0,0,353,17.65
SAN DIEGO,Apr 2016,CACF,2016,San Diego County Office of Education,HS_CHILD_LUNCH,20,48,0,0,48,373,0,0,373,18.65
SAN DIEGO,Apr 2016,CACF,2016,San Diego County Office of Education,HS_CHILD_SNACK_PM,20,48,0,0,48,228,0,0,228,11.4
SAN DIEGO,May 2016,CACF,2016,San Diego County Office of Education,HS_CHILD_BREAKFAST,19,37,0,0,37,380,0,0,380,20
SAN DIEGO,May 2016,CACF,2016,San Diego County Office of Education,HS_CHILD_LUNCH,19,37,0,0,37,380,0,0,380,20
SAN DIEGO,May 2016,CACF,2016,San Diego County Office of Education,HS_CHILD_SNACK_PM,19,37,0,0,37,276,0,0,276,14.5263
SAN DIEGO,Jun 2016,CACF,2016,San Diego County Office of Education,HS_CHILD_BREAKFAST,14,31,0,0,31,224,0,0,224,16
SAN DIEGO,Jun 2016,CACF,2016,San Diego County Office of Education,HS_CHILD_LUNCH,14,31,0,0,31,213,0,0,213,15.2143
SAN DIEGO,Jun 2016,CACF,2016,San Diego County Office of Education,HS_CHILD_SNACK_PM,14,31,0,0,31,160,0,0,160,11.4286
SAN DIEGO,Oct 2015,CACF,2016,San Diego Unified School District,ATRISK_CHILD_SUPPER,22,20267,0,0,20267,215686,0,0,215686,9803.9091
SAN DIEGO,Nov 2015,CACF,2016,San Diego Unified School District,ATRISK_CHILD_SUPPER,15,22663,0,0,22663,151773,0,0,151773,10118.2
SAN DIEGO,Dec 2015,CACF,2016,San Diego Unified School District,ATRISK_CHILD_SUPPER,14,23134,0,0,23134,141501,0,0,141501,10107.2143
SAN DIEGO,Jan 2016,CACF,2016,San Diego Unified School District,ATRISK_CHILD_SUPPER,19,22091,0,0,22091,159286,0,0,159286,8383.4737
SAN DIEGO,Feb 2016,CACF,2016,San Diego Unified School District,ATRISK_CHILD_SUPPER,19,23323,0,0,23323,192176,0,0,192176,10114.5263
SAN DIEGO,Mar 2016,CACF,2016,San Diego Unified School District,ATRISK_CHILD_SUPPER,23,44351,0,0,44351,190472,0,0,190472,8281.3913
SAN DIEGO,Apr 2016,CACF,2016,San Diego Unified School District,ATRISK_CHILD_SUPPER,20,44678,0,0,44678,165306,0,0,165306,8265.3
SAN DIEGO,May 2016,CACF,2016,San Diego Unified School District,ATRISK_CHILD_SUPPER,21,44822,0,0,44822,197343,0,0,197343,9397.2857
SAN DIEGO,Jun 2016,CACF,2016,San Diego Unified School District,ATRISK_CHILD_SUPPER,22,46529,0,0,46529,156124,0,0,156124,7096.5455
SAN DIEGO,Jul 2016,CACF,2016,San Diego Unified School District,ATRISK_CHILD_SUPPER,17,15268,0,0,15268,39234,0,0,39234,2307.8824
SAN DIEGO,Oct 2015,CACF,2016,San Marcos Unified School District,ATRISK_CHILD_SUPPER,22,937,0,0,937,17184,0,0,17184,781.0909
SAN DIEGO,Nov 2015,CACF,2016,San Marcos Unified School District,ATRISK_CHILD_SUPPER,15,918,0,0,918,10757,0,0,10757,717.1333
SAN DIEGO,Dec 2015,CACF,2016,San Marcos Unified School District,ATRISK_CHILD_SUPPER,14,889,0,0,889,10202,0,0,10202,728.7143
SAN DIEGO,Jan 2016,CACF,2016,San Marcos Unified School District,ATRISK_CHILD_SUPPER,18,890,0,0,890,9794,0,0,9794,544.1111
SAN DIEGO,Feb 2016,CACF,2016,San Marcos Unified School District,ATRISK_CHILD_SUPPER,19,918,0,0,918,13738,0,0,13738,723.0526
SAN DIEGO,Mar 2016,CACF,2016,San Marcos Unified School District,ATRISK_CHILD_SUPPER,19,888,0,0,888,12978,0,0,12978,683.0526
SAN DIEGO,Apr 2016,CACF,2016,San Marcos Unified School District,ATRISK_CHILD_SUPPER,20,882,0,0,882,13692,0,0,13692,684.6
SAN DIEGO,May 2016,CACF,2016,San Marcos Unified School District,ATRISK_CHILD_SUPPER,21,2475,0,0,2475,13815,0,0,13815,657.8571
SAN DIEGO,Jun 2016,CACF,2016,San Marcos Unified School District,ATRISK_CHILD_SUPPER,16,791,0,0,791,8416,0,0,8416,526
SAN DIEGO,Oct 2015,CACF,2016,SANTEE SCHOOL DISTRICT,ATRISK_CHILD_SNACK,22,393,0,0,393,2430,0,0,2430,110.4545
SAN DIEGO,Oct 2015,CACF,2016,SANTEE SCHOOL DISTRICT,ATRISK_CHILD_SNACK_AM,22,393,0,0,393,681,0,0,681,30.9545
SAN DIEGO,Oct 2015,CACF,2016,SANTEE SCHOOL DISTRICT,ATRISK_CHILD_SUPPER,22,393,0,0,393,3721,0,0,3721,169.1364
SAN DIEGO,Nov 2015,CACF,2016,SANTEE SCHOOL DISTRICT,ATRISK_CHILD_SNACK,18,390,0,0,390,1810,0,0,1810,100.5556
SAN DIEGO,Nov 2015,CACF,2016,SANTEE SCHOOL DISTRICT,ATRISK_CHILD_SNACK_AM,18,390,0,0,390,539,0,0,539,29.9444
SAN DIEGO,Nov 2015,CACF,2016,SANTEE SCHOOL DISTRICT,ATRISK_CHILD_SUPPER,18,390,0,0,390,2350,0,0,2350,130.5556
SAN DIEGO,Dec 2015,CACF,2016,SANTEE SCHOOL DISTRICT,ATRISK_CHILD_SNACK,19,394,0,0,394,1655,0,0,1655,87.1053
SAN DIEGO,Dec 2015,CACF,2016,SANTEE SCHOOL DISTRICT,ATRISK_CHILD_SNACK_AM,19,394,0,0,394,537,0,0,537,28.2632
SAN DIEGO,Dec 2015,CACF,2016,SANTEE SCHOOL DISTRICT,ATRISK_CHILD_SUPPER,19,394,0,0,394,2288,0,0,2288,120.4211
SAN DIEGO,Jan 2016,CACF,2016,SANTEE SCHOOL DISTRICT,ATRISK_CHILD_SNACK,19,390,0,0,390,2187,0,0,2187,115.1053
SAN DIEGO,Jan 2016,CACF,2016,SANTEE SCHOOL DISTRICT,ATRISK_CHILD_SNACK_AM,19,390,0,0,390,568,0,0,568,29.8947
SAN DIEGO,Jan 2016,CACF,2016,SANTEE SCHOOL DISTRICT,ATRISK_CHILD_SUPPER,19,390,0,0,390,2884,0,0,2884,151.7895
SAN DIEGO,Feb 2016,CACF,2016,SANTEE SCHOOL DISTRICT,ATRISK_CHILD_SNACK,19,382,0,0,382,2178,0,0,2178,114.6316
SAN DIEGO,Feb 2016,CACF,2016,SANTEE SCHOOL DISTRICT,ATRISK_CHILD_SNACK_AM,19,382,0,0,382,565,0,0,565,29.7368
SAN DIEGO,Feb 2016,CACF,2016,SANTEE SCHOOL DISTRICT,ATRISK_CHILD_SUPPER,19,382,0,0,382,2577,0,0,2577,135.6316
SAN DIEGO,Mar 2016,CACF,2016,SANTEE SCHOOL DISTRICT,ATRISK_CHILD_SNACK,23,384,0,0,384,3046,0,0,3046,132.4348
SAN DIEGO,Mar 2016,CACF,2016,SANTEE SCHOOL DISTRICT,ATRISK_CHILD_SNACK_AM,23,384,0,0,384,1073,0,0,1073,46.6522
SAN DIEGO,Mar 2016,CACF,2016,SANTEE SCHOOL DISTRICT,ATRISK_CHILD_SUPPER,23,384,0,0,384,2909,0,0,2909,126.4783
SAN DIEGO,Apr 2016,CACF,2016,SANTEE SCHOOL DISTRICT,ATRISK_CHILD_SNACK,21,383,0,0,383,2472,0,0,2472,117.7143
SAN DIEGO,Apr 2016,CACF,2016,SANTEE SCHOOL DISTRICT,ATRISK_CHILD_SNACK_AM,21,383,0,0,383,688,0,0,688,32.7619
SAN DIEGO,Apr 2016,CACF,2016,SANTEE SCHOOL DISTRICT,ATRISK_CHILD_SUPPER,21,383,0,0,383,3014,0,0,3014,143.5238
SAN DIEGO,May 2016,CACF,2016,SANTEE SCHOOL DISTRICT,ATRISK_CHILD_SNACK,21,397,0,0,397,2347,0,0,2347,111.7619
SAN DIEGO,May 2016,CACF,2016,SANTEE SCHOOL DISTRICT,ATRISK_CHILD_SNACK_AM,21,397,0,0,397,638,0,0,638,30.381
SAN DIEGO,May 2016,CACF,2016,SANTEE SCHOOL DISTRICT,ATRISK_CHILD_SUPPER,21,397,0,0,397,2802,0,0,2802,133.4286
SAN DIEGO,Jun 2016,CACF,2016,SANTEE SCHOOL DISTRICT,ATRISK_CHILD_SNACK,16,374,0,0,374,1548,0,0,1548,96.75
SAN DIEGO,Jun 2016,CACF,2016,SANTEE SCHOOL DISTRICT,ATRISK_CHILD_SNACK_AM,16,374,0,0,374,474,0,0,474,29.625
SAN DIEGO,Jun 2016,CACF,2016,SANTEE SCHOOL DISTRICT,ATRISK_CHILD_SUPPER,16,374,0,0,374,1963,0,0,1963,122.6875
SAN DIEGO,Oct 2015,CACF,2016,SELF DISCOVERY INC,CHILD_BREAKFAST,21,44,5,11,60,198,22,50,270,12.8571
SAN DIEGO,Oct 2015,CACF,2016,SELF DISCOVERY INC,CHILD_LUNCH,21,44,5,11,60,738,84,184,1006,47.9048
SAN DIEGO,Oct 2015,CACF,2016,SELF DISCOVERY INC,CHILD_SNACK_AM,21,44,5,11,60,329,37,83,449,21.381
SAN DIEGO,Oct 2015,CACF,2016,SELF DISCOVERY INC,CHILD_SNACK_PM,21,44,5,11,60,473,54,118,645,30.7143
SAN DIEGO,Oct 2015,CACF,2016,SELF DISCOVERY INC,CHILD_SUPPER,21,44,5,11,60,402,46,100,548,26.0952
SAN DIEGO,Nov 2015,CACF,2016,SELF DISCOVERY INC,CHILD_BREAKFAST,18,44,5,11,60,172,19,43,234,13
SAN DIEGO,Nov 2015,CACF,2016,SELF DISCOVERY INC,CHILD_LUNCH,18,44,5,11,60,569,65,142,776,43.1111
SAN DIEGO,Nov 2015,CACF,2016,SELF DISCOVERY INC,CHILD_SNACK_AM,18,44,5,11,60,271,31,67,369,20.5
SAN DIEGO,Nov 2015,CACF,2016,SELF DISCOVERY INC,CHILD_SNACK_PM,18,44,5,11,60,347,39,87,473,26.2778
SAN DIEGO,Nov 2015,CACF,2016,SELF DISCOVERY INC,CHILD_SUPPER,18,44,5,11,60,300,34,75,409,22.7222
SAN DIEGO,Dec 2015,CACF,2016,SELF DISCOVERY INC,CHILD_BREAKFAST,20,44,5,11,60,191,22,48,261,13.05
SAN DIEGO,Dec 2015,CACF,2016,SELF DISCOVERY INC,CHILD_LUNCH,20,44,5,11,60,644,73,161,878,43.9
SAN DIEGO,Dec 2015,CACF,2016,SELF DISCOVERY INC,CHILD_SNACK_AM,20,44,5,11,60,332,38,83,453,22.65
SAN DIEGO,Dec 2015,CACF,2016,SELF DISCOVERY INC,CHILD_SNACK_PM,20,44,5,11,60,356,40,89,485,24.25
SAN DIEGO,Dec 2015,CACF,2016,SELF DISCOVERY INC,CHILD_SUPPER,20,44,5,11,60,301,34,75,410,20.5
SAN DIEGO,Jan 2016,CACF,2016,SELF DISCOVERY INC,CHILD_BREAKFAST,19,44,5,11,60,170,19,43,232,12.2105
SAN DIEGO,Jan 2016,CACF,2016,SELF DISCOVERY INC,CHILD_LUNCH,19,44,5,11,60,573,65,144,782,41.1579
SAN DIEGO,Jan 2016,CACF,2016,SELF DISCOVERY INC,CHILD_SNACK_AM,19,44,5,11,60,287,33,71,391,20.5789
SAN DIEGO,Jan 2016,CACF,2016,SELF DISCOVERY INC,CHILD_SNACK_PM,19,44,5,11,60,341,39,85,465,24.4737
SAN DIEGO,Jan 2016,CACF,2016,SELF DISCOVERY INC,CHILD_SUPPER,19,44,5,11,60,288,33,72,393,20.6842
SAN DIEGO,Feb 2016,CACF,2016,SELF DISCOVERY INC,CHILD_BREAKFAST,19,44,5,11,60,175,20,43,238,12.5263
SAN DIEGO,Feb 2016,CACF,2016,SELF DISCOVERY INC,CHILD_LUNCH,19,44,5,11,60,604,69,150,823,43.3158
SAN DIEGO,Feb 2016,CACF,2016,SELF DISCOVERY INC,CHILD_SNACK_AM,19,44,5,11,60,261,30,65,356,18.7368
SAN DIEGO,Feb 2016,CACF,2016,SELF DISCOVERY INC,CHILD_SNACK_PM,19,44,5,11,60,389,44,97,530,27.8947
SAN DIEGO,Feb 2016,CACF,2016,SELF DISCOVERY INC,CHILD_SUPPER,19,44,5,11,60,342,39,86,467,24.5789
SAN DIEGO,Mar 2016,CACF,2016,SELF DISCOVERY INC,CHILD_BREAKFAST,21,44,5,11,60,210,24,52,286,13.619
SAN DIEGO,Mar 2016,CACF,2016,SELF DISCOVERY INC,CHILD_LUNCH,21,44,5,11,60,715,81,179,975,46.4286
SAN DIEGO,Mar 2016,CACF,2016,SELF DISCOVERY INC,CHILD_SNACK_AM,21,44,5,11,60,313,36,78,427,20.3333
SAN DIEGO,Mar 2016,CACF,2016,SELF DISCOVERY INC,CHILD_SNACK_PM,21,44,5,11,60,472,54,118,644,30.6667
SAN DIEGO,Mar 2016,CACF,2016,SELF DISCOVERY INC,CHILD_SUPPER,21,44,5,11,60,395,45,98,538,25.619
SAN DIEGO,Apr 2016,CACF,2016,SELF DISCOVERY INC,CHILD_BREAKFAST,21,44,5,11,60,230,26,57,313,14.9048
SAN DIEGO,Apr 2016,CACF,2016,SELF DISCOVERY INC,CHILD_LUNCH,21,44,5,11,60,626,71,157,854,40.6667
SAN DIEGO,Apr 2016,CACF,2016,SELF DISCOVERY INC,CHILD_SNACK_AM,21,44,5,11,60,564,64,141,769,36.619
SAN DIEGO,Apr 2016,CACF,2016,SELF DISCOVERY INC,CHILD_SNACK_PM,21,44,5,11,60,455,52,113,620,29.5238
SAN DIEGO,Apr 2016,CACF,2016,SELF DISCOVERY INC,CHILD_SUPPER,21,44,5,11,60,171,19,43,233,11.0952
SAN DIEGO,May 2016,CACF,2016,SELF DISCOVERY INC,CHILD_BREAKFAST,21,44,5,11,60,181,21,45,247,11.7619
SAN DIEGO,May 2016,CACF,2016,SELF DISCOVERY INC,CHILD_LUNCH,21,44,5,11,60,701,80,175,956,45.5238
SAN DIEGO,May 2016,CACF,2016,SELF DISCOVERY INC,CHILD_SNACK_AM,21,44,5,11,60,345,39,87,471,22.4286
SAN DIEGO,May 2016,CACF,2016,SELF DISCOVERY INC,CHILD_SNACK_PM,21,44,5,11,60,475,54,119,648,30.8571
SAN DIEGO,May 2016,CACF,2016,SELF DISCOVERY INC,CHILD_SUPPER,21,44,5,11,60,352,40,88,480,22.8571
SAN DIEGO,Jun 2016,CACF,2016,SELF DISCOVERY INC,CHILD_BREAKFAST,22,44,5,11,60,170,19,43,232,10.5455
SAN DIEGO,Jun 2016,CACF,2016,SELF DISCOVERY INC,CHILD_LUNCH,22,44,5,11,60,659,75,164,898,40.8182
SAN DIEGO,Jun 2016,CACF,2016,SELF DISCOVERY INC,CHILD_SNACK_AM,22,44,5,11,60,319,36,80,435,19.7727
SAN DIEGO,Jun 2016,CACF,2016,SELF DISCOVERY INC,CHILD_SNACK_PM,22,44,5,11,60,438,50,109,597,27.1364
SAN DIEGO,Jun 2016,CACF,2016,SELF DISCOVERY INC,CHILD_SUPPER,22,44,5,11,60,331,38,83,452,20.5455
SAN DIEGO,Jul 2016,CACF,2016,SELF DISCOVERY INC,CHILD_BREAKFAST,20,44,5,11,60,155,18,38,211,10.55
SAN DIEGO,Jul 2016,CACF,2016,SELF DISCOVERY INC,CHILD_LUNCH,20,44,5,11,60,564,64,141,769,38.45
SAN DIEGO,Jul 2016,CACF,2016,SELF DISCOVERY INC,CHILD_SNACK_AM,20,44,5,11,60,246,28,62,336,16.8
SAN DIEGO,Jul 2016,CACF,2016,SELF DISCOVERY INC,CHILD_SNACK_PM,20,44,5,11,60,366,42,91,499,24.95
SAN DIEGO,Jul 2016,CACF,2016,SELF DISCOVERY INC,CHILD_SUPPER,20,44,5,11,60,312,35,78,425,21.25
SAN DIEGO,Oct 2015,CACF,2016,South Bay Union School District,HS_CHILD_SNACK_AM,20,164,0,0,164,2041,0,0,2041,102.05
SAN DIEGO,Oct 2015,CACF,2016,South Bay Union School District,HS_CHILD_SNACK_PM,20,164,0,0,164,1087,0,0,1087,54.35
SAN DIEGO,Nov 2015,CACF,2016,South Bay Union School District,HS_CHILD_SNACK_AM,15,165,0,0,165,1750,0,0,1750,116.6667
SAN DIEGO,Nov 2015,CACF,2016,South Bay Union School District,HS_CHILD_SNACK_PM,15,165,0,0,165,871,0,0,871,58.0667
SAN DIEGO,Dec 2015,CACF,2016,South Bay Union School District,HS_CHILD_SNACK_AM,14,164,0,0,164,1430,0,0,1430,102.1429
SAN DIEGO,Dec 2015,CACF,2016,South Bay Union School District,HS_CHILD_SNACK_PM,14,164,0,0,164,790,0,0,790,56.4286
SAN DIEGO,Jan 2016,CACF,2016,South Bay Union School District,HS_CHILD_SNACK_AM,14,163,0,0,163,1419,0,0,1419,101.3571
SAN DIEGO,Jan 2016,CACF,2016,South Bay Union School District,HS_CHILD_SNACK_PM,14,163,0,0,163,700,0,0,700,50
SAN DIEGO,Feb 2016,CACF,2016,South Bay Union School District,HS_CHILD_SNACK_AM,19,166,0,0,166,1910,0,0,1910,100.5263
SAN DIEGO,Feb 2016,CACF,2016,South Bay Union School District,HS_CHILD_SNACK_PM,19,166,0,0,166,1035,0,0,1035,54.4737
SAN DIEGO,Mar 2016,CACF,2016,South Bay Union School District,HS_CHILD_SNACK_AM,14,167,0,0,167,1384,0,0,1384,98.8571
SAN DIEGO,Mar 2016,CACF,2016,South Bay Union School District,HS_CHILD_SNACK_PM,14,167,0,0,167,686,0,0,686,49
SAN DIEGO,Apr 2016,CACF,2016,South Bay Union School District,HS_CHILD_SNACK_AM,20,163,0,0,163,2008,0,0,2008,100.4
SAN DIEGO,Apr 2016,CACF,2016,South Bay Union School District,HS_CHILD_SNACK_PM,20,163,0,0,163,1089,0,0,1089,54.45
SAN DIEGO,May 2016,CACF,2016,South Bay Union School District,HS_CHILD_SNACK_AM,21,162,0,0,162,2045,0,0,2045,97.381
SAN DIEGO,May 2016,CACF,2016,South Bay Union School District,HS_CHILD_SNACK_PM,21,162,0,0,162,1121,0,0,1121,53.381
SAN DIEGO,Jun 2016,CACF,2016,South Bay Union School District,HS_CHILD_SNACK_AM,3,163,0,0,163,291,0,0,291,97
SAN DIEGO,Jun 2016,CACF,2016,South Bay Union School District,HS_CHILD_SNACK_PM,3,163,0,0,163,161,0,0,161,53.6667
SAN DIEGO,Jul 2016,CACF,2016,South Bay Union School District,HS_CHILD_SNACK_AM,4,156,0,0,156,404,0,0,404,101
SAN DIEGO,Jul 2016,CACF,2016,South Bay Union School District,HS_CHILD_SNACK_PM,4,156,0,0,156,214,0,0,214,53.5
SAN DIEGO,Oct 2015,CACF,2016,SOUTHERN CALIF TRIBAL CHAIR ASSOC-RINCON COMM DAYCARE CTR,CHILD_BREAKFAST,22,9,3,1,13,143,48,15,206,9.3636
SAN DIEGO,Oct 2015,CACF,2016,SOUTHERN CALIF TRIBAL CHAIR ASSOC-RINCON COMM DAYCARE CTR,CHILD_LUNCH,22,9,3,1,13,151,50,17,218,9.9091
SAN DIEGO,Oct 2015,CACF,2016,SOUTHERN CALIF TRIBAL CHAIR ASSOC-RINCON COMM DAYCARE CTR,CHILD_SNACK_PM,22,9,3,1,13,112,37,13,162,7.3636
SAN DIEGO,Nov 2015,CACF,2016,SOUTHERN CALIF TRIBAL CHAIR ASSOC-RINCON COMM DAYCARE CTR,CHILD_BREAKFAST,19,9,3,1,13,111,37,12,160,8.4211
SAN DIEGO,Nov 2015,CACF,2016,SOUTHERN CALIF TRIBAL CHAIR ASSOC-RINCON COMM DAYCARE CTR,CHILD_LUNCH,19,9,3,1,13,120,40,14,174,9.1579
SAN DIEGO,Nov 2015,CACF,2016,SOUTHERN CALIF TRIBAL CHAIR ASSOC-RINCON COMM DAYCARE CTR,CHILD_SNACK_PM,19,9,3,1,13,86,29,9,124,6.5263
SAN DIEGO,Dec 2015,CACF,2016,SOUTHERN CALIF TRIBAL CHAIR ASSOC-RINCON COMM DAYCARE CTR,CHILD_BREAKFAST,17,8,1,4,13,74,9,37,120,7.0588
SAN DIEGO,Dec 2015,CACF,2016,SOUTHERN CALIF TRIBAL CHAIR ASSOC-RINCON COMM DAYCARE CTR,CHILD_LUNCH,17,8,1,4,13,81,10,40,131,7.7059
SAN DIEGO,Dec 2015,CACF,2016,SOUTHERN CALIF TRIBAL CHAIR ASSOC-RINCON COMM DAYCARE CTR,CHILD_SNACK_PM,17,8,1,4,13,50,6,26,82,4.8235
SAN DIEGO,Jan 2016,CACF,2016,SOUTHERN CALIF TRIBAL CHAIR ASSOC-RINCON COMM DAYCARE CTR,CHILD_BREAKFAST,20,10,2,4,16,101,20,41,162,8.1
SAN DIEGO,Jan 2016,CACF,2016,SOUTHERN CALIF TRIBAL CHAIR ASSOC-RINCON COMM DAYCARE CTR,CHILD_LUNCH,20,10,2,4,16,114,23,46,183,9.15
SAN DIEGO,Jan 2016,CACF,2016,SOUTHERN CALIF TRIBAL CHAIR ASSOC-RINCON COMM DAYCARE CTR,CHILD_SNACK_PM,20,10,2,4,16,66,13,27,106,5.3
SAN DIEGO,Feb 2016,CACF,2016,SOUTHERN CALIF TRIBAL CHAIR ASSOC-RINCON COMM DAYCARE CTR,CHILD_BREAKFAST,20,10,4,3,17,122,49,36,207,10.35
SAN DIEGO,Feb 2016,CACF,2016,SOUTHERN CALIF TRIBAL CHAIR ASSOC-RINCON COMM DAYCARE CTR,CHILD_LUNCH,20,10,4,3,17,136,55,41,232,11.6
SAN DIEGO,Feb 2016,CACF,2016,SOUTHERN CALIF TRIBAL CHAIR ASSOC-RINCON COMM DAYCARE CTR,CHILD_SNACK_PM,20,10,4,3,17,84,34,25,143,7.15
SAN DIEGO,Mar 2016,CACF,2016,SOUTHERN CALIF TRIBAL CHAIR ASSOC-RINCON COMM DAYCARE CTR,CHILD_BREAKFAST,22,10,4,3,17,132,53,39,224,10.1818
SAN DIEGO,Mar 2016,CACF,2016,SOUTHERN CALIF TRIBAL CHAIR ASSOC-RINCON COMM DAYCARE CTR,CHILD_LUNCH,22,10,4,3,17,146,59,44,249,11.3182
SAN DIEGO,Mar 2016,CACF,2016,SOUTHERN CALIF TRIBAL CHAIR ASSOC-RINCON COMM DAYCARE CTR,CHILD_SNACK_PM,22,10,4,3,17,88,35,27,150,6.8182
SAN DIEGO,Apr 2016,CACF,2016,SOUTHERN CALIF TRIBAL CHAIR ASSOC-RINCON COMM DAYCARE CTR,CHILD_BREAKFAST,21,10,4,3,17,125,50,38,213,10.1429
SAN DIEGO,Apr 2016,CACF,2016,SOUTHERN CALIF TRIBAL CHAIR ASSOC-RINCON COMM DAYCARE CTR,CHILD_LUNCH,21,10,4,3,17,139,56,42,237,11.2857
SAN DIEGO,Apr 2016,CACF,2016,SOUTHERN CALIF TRIBAL CHAIR ASSOC-RINCON COMM DAYCARE CTR,CHILD_SNACK_PM,21,10,4,3,17,88,35,26,149,7.0952
SAN DIEGO,May 2016,CACF,2016,SOUTHERN CALIF TRIBAL CHAIR ASSOC-RINCON COMM DAYCARE CTR,CHILD_BREAKFAST,21,10,4,3,17,114,46,34,194,9.2381
SAN DIEGO,May 2016,CACF,2016,SOUTHERN CALIF TRIBAL CHAIR ASSOC-RINCON COMM DAYCARE CTR,CHILD_LUNCH,21,10,4,3,17,124,50,37,211,10.0476
SAN DIEGO,May 2016,CACF,2016,SOUTHERN CALIF TRIBAL CHAIR ASSOC-RINCON COMM DAYCARE CTR,CHILD_SNACK_PM,21,10,4,3,17,82,33,24,139,6.619
SAN DIEGO,Jun 2016,CACF,2016,SOUTHERN CALIF TRIBAL CHAIR ASSOC-RINCON COMM DAYCARE CTR,CHILD_BREAKFAST,22,10,4,3,17,96,39,29,164,7.4545
SAN DIEGO,Jun 2016,CACF,2016,SOUTHERN CALIF TRIBAL CHAIR ASSOC-RINCON COMM DAYCARE CTR,CHILD_LUNCH,22,10,4,3,17,81,32,24,137,6.2273
SAN DIEGO,Jun 2016,CACF,2016,SOUTHERN CALIF TRIBAL CHAIR ASSOC-RINCON COMM DAYCARE CTR,CHILD_SNACK_PM,22,10,4,3,17,62,25,19,106,4.8182
SAN DIEGO,Jul 2016,CACF,2016,SOUTHERN CALIF TRIBAL CHAIR ASSOC-RINCON COMM DAYCARE CTR,CHILD_BREAKFAST,20,10,4,3,17,75,30,22,127,6.35
SAN DIEGO,Jul 2016,CACF,2016,SOUTHERN CALIF TRIBAL CHAIR ASSOC-RINCON COMM DAYCARE CTR,CHILD_LUNCH,20,10,4,3,17,92,37,27,156,7.8
SAN DIEGO,Jul 2016,CACF,2016,SOUTHERN CALIF TRIBAL CHAIR ASSOC-RINCON COMM DAYCARE CTR,CHILD_SNACK_PM,20,10,4,3,17,71,28,22,121,6.05
SAN DIEGO,Oct 2015,CACF,2016,SWEET BUSY BEES,CHILD_BREAKFAST,22,8,3,1,12,173,65,21,259,11.7727
SAN DIEGO,Oct 2015,CACF,2016,SWEET BUSY BEES,CHILD_LUNCH,22,8,3,1,12,173,65,21,259,11.7727
SAN DIEGO,Oct 2015,CACF,2016,SWEET BUSY BEES,CHILD_SNACK_AM,22,8,3,1,12,173,65,21,259,11.7727
SAN DIEGO,Nov 2015,CACF,2016,SWEET BUSY BEES,CHILD_BREAKFAST,17,14,2,2,18,163,23,23,209,12.2941
SAN DIEGO,Nov 2015,CACF,2016,SWEET BUSY BEES,CHILD_LUNCH,17,14,2,2,18,163,23,23,209,12.2941
SAN DIEGO,Nov 2015,CACF,2016,SWEET BUSY BEES,CHILD_SNACK_AM,17,14,2,2,18,163,23,23,209,12.2941
SAN DIEGO,Dec 2015,CACF,2016,SWEET BUSY BEES,CHILD_BREAKFAST,20,14,2,3,19,272,39,58,369,18.45
SAN DIEGO,Dec 2015,CACF,2016,SWEET BUSY BEES,CHILD_LUNCH,20,14,2,3,19,272,39,58,369,18.45
SAN DIEGO,Dec 2015,CACF,2016,SWEET BUSY BEES,CHILD_SNACK_AM,20,14,2,3,19,272,39,58,369,18.45
SAN DIEGO,Jan 2016,CACF,2016,SWEET BUSY BEES,CHILD_BREAKFAST,19,16,2,3,21,258,32,49,339,17.8421
SAN DIEGO,Jan 2016,CACF,2016,SWEET BUSY BEES,CHILD_LUNCH,19,16,2,3,21,258,32,49,339,17.8421
SAN DIEGO,Jan 2016,CACF,2016,SWEET BUSY BEES,CHILD_SNACK_AM,19,16,2,3,21,258,32,49,339,17.8421
SAN DIEGO,Feb 2016,CACF,2016,SWEET BUSY BEES,CHILD_BREAKFAST,20,16,2,3,21,258,32,49,339,16.95
SAN DIEGO,Feb 2016,CACF,2016,SWEET BUSY BEES,CHILD_LUNCH,20,16,2,3,21,258,32,49,339,16.95
SAN DIEGO,Feb 2016,CACF,2016,SWEET BUSY BEES,CHILD_SNACK_AM,20,16,2,3,21,258,32,49,339,16.95
SAN DIEGO,Mar 2016,CACF,2016,SWEET BUSY BEES,CHILD_BREAKFAST,23,16,2,3,21,330,41,62,433,18.8261
SAN DIEGO,Mar 2016,CACF,2016,SWEET BUSY BEES,CHILD_LUNCH,23,16,2,3,21,330,41,62,433,18.8261
SAN DIEGO,Mar 2016,CACF,2016,SWEET BUSY BEES,CHILD_SNACK_AM,23,16,2,3,21,330,41,62,433,18.8261
SAN DIEGO,Apr 2016,CACF,2016,SWEET BUSY BEES,CHILD_BREAKFAST,21,16,2,3,21,273,34,51,358,17.0476
SAN DIEGO,Apr 2016,CACF,2016,SWEET BUSY BEES,CHILD_LUNCH,21,16,2,3,21,273,34,51,358,17.0476
SAN DIEGO,Apr 2016,CACF,2016,SWEET BUSY BEES,CHILD_SNACK_AM,21,16,2,3,21,273,34,51,358,17.0476
SAN DIEGO,May 2016,CACF,2016,SWEET BUSY BEES,CHILD_BREAKFAST,21,17,2,2,21,301,35,36,372,17.7143
SAN DIEGO,May 2016,CACF,2016,SWEET BUSY BEES,CHILD_LUNCH,21,17,2,2,21,301,35,36,372,17.7143
SAN DIEGO,May 2016,CACF,2016,SWEET BUSY BEES,CHILD_SNACK_AM,21,17,2,2,21,301,35,36,372,17.7143
SAN DIEGO,Jun 2016,CACF,2016,SWEET BUSY BEES,CHILD_BREAKFAST,22,17,2,2,21,324,38,38,400,18.1818
SAN DIEGO,Jun 2016,CACF,2016,SWEET BUSY BEES,CHILD_LUNCH,22,17,2,2,21,324,38,38,400,18.1818
SAN DIEGO,Jun 2016,CACF,2016,SWEET BUSY BEES,CHILD_SNACK_AM,22,17,2,2,21,324,38,38,400,18.1818
SAN DIEGO,Jul 2016,CACF,2016,SWEET BUSY BEES,CHILD_BREAKFAST,20,17,2,2,21,320,38,37,395,19.75
SAN DIEGO,Jul 2016,CACF,2016,SWEET BUSY BEES,CHILD_LUNCH,20,17,2,2,21,320,38,37,395,19.75
SAN DIEGO,Jul 2016,CACF,2016,SWEET BUSY BEES,CHILD_SNACK_AM,20,17,2,2,21,320,38,37,395,19.75
SAN DIEGO,Oct 2015,CACF,2016,Sweetwater Union High School District,ATRISK_CHILD_SUPPER,19,32328,0,0,32328,32328,0,0,32328,1701.4737
SAN DIEGO,Nov 2015,CACF,2016,Sweetwater Union High School District,ATRISK_CHILD_SUPPER,15,27783,0,0,27783,27783,0,0,27783,1852.2
SAN DIEGO,Dec 2015,CACF,2016,Sweetwater Union High School District,ATRISK_CHILD_SUPPER,14,21398,0,0,21398,21398,0,0,21398,1528.4286
SAN DIEGO,Jan 2016,CACF,2016,Sweetwater Union High School District,ATRISK_CHILD_SUPPER,13,18726,0,0,18726,18726,0,0,18726,1440.4615
SAN DIEGO,Feb 2016,CACF,2016,Sweetwater Union High School District,ATRISK_CHILD_SUPPER,19,32806,0,0,32806,32806,0,0,32806,1726.6316
SAN DIEGO,Mar 2016,CACF,2016,Sweetwater Union High School District,ATRISK_CHILD_SUPPER,14,24102,0,0,24102,24102,0,0,24102,1721.5714
SAN DIEGO,Apr 2016,CACF,2016,Sweetwater Union High School District,ATRISK_CHILD_SUPPER,21,32036,0,0,32036,32036,0,0,32036,1525.5238
SAN DIEGO,May 2016,CACF,2016,Sweetwater Union High School District,ATRISK_CHILD_SUPPER,21,28634,0,0,28634,28634,0,0,28634,1363.5238
SAN DIEGO,Jun 2016,CACF,2016,Sweetwater Union High School District,ATRISK_CHILD_SUPPER,3,792,0,0,792,792,0,0,792,264
SAN DIEGO,Jul 2016,CACF,2016,Sweetwater Union High School District,ATRISK_CHILD_SUPPER,13,5523,0,0,5523,5523,0,0,5523,424.8462
SAN DIEGO,Oct 2015,CACF,2016,The Vine Learning Center,CHILD_BREAKFAST,22,16,0,30,46,215,0,404,619,28.1364
SAN DIEGO,Oct 2015,CACF,2016,The Vine Learning Center,CHILD_LUNCH,22,16,0,30,46,287,0,539,826,37.5455
SAN DIEGO,Oct 2015,CACF,2016,The Vine Learning Center,CHILD_SNACK_PM,22,16,0,30,46,271,0,509,780,35.4545
SAN DIEGO,Nov 2015,CACF,2016,The Vine Learning Center,CHILD_BREAKFAST,18,16,0,30,46,172,0,323,495,27.5
SAN DIEGO,Nov 2015,CACF,2016,The Vine Learning Center,CHILD_LUNCH,18,16,0,30,46,239,0,448,687,38.1667
SAN DIEGO,Nov 2015,CACF,2016,The Vine Learning Center,CHILD_SNACK_PM,18,16,0,30,46,233,0,436,669,37.1667
SAN DIEGO,Dec 2015,CACF,2016,The Vine Learning Center,CHILD_BREAKFAST,21,16,0,30,46,195,0,367,562,26.7619
SAN DIEGO,Dec 2015,CACF,2016,The Vine Learning Center,CHILD_LUNCH,21,16,0,30,46,289,0,542,831,39.5714
SAN DIEGO,Dec 2015,CACF,2016,The Vine Learning Center,CHILD_SNACK_PM,21,16,0,30,46,278,0,520,798,38
SAN DIEGO,Jan 2016,CACF,2016,The Vine Learning Center,CHILD_BREAKFAST,21,16,0,30,46,223,0,417,640,30.4762
SAN DIEGO,Jan 2016,CACF,2016,The Vine Learning Center,CHILD_LUNCH,21,16,0,30,46,316,0,592,908,43.2381
SAN DIEGO,Jan 2016,CACF,2016,The Vine Learning Center,CHILD_SNACK_PM,21,16,0,30,46,299,0,562,861,41
SAN DIEGO,Feb 2016,CACF,2016,The Vine Learning Center,CHILD_BREAKFAST,20,18,0,45,63,203,0,507,710,35.5
SAN DIEGO,Feb 2016,CACF,2016,The Vine Learning Center,CHILD_LUNCH,20,18,0,45,63,294,0,734,1028,51.4
SAN DIEGO,Feb 2016,CACF,2016,The Vine Learning Center,CHILD_SNACK_PM,20,18,0,45,63,284,0,711,995,49.75
SAN DIEGO,Mar 2016,CACF,2016,The Vine Learning Center,CHILD_BREAKFAST,23,18,0,45,63,220,0,549,769,33.4348
SAN DIEGO,Mar 2016,CACF,2016,The Vine Learning Center,CHILD_LUNCH,23,18,0,45,63,319,0,797,1116,48.5217
SAN DIEGO,Mar 2016,CACF,2016,The Vine Learning Center,CHILD_SNACK_PM,23,18,0,45,63,297,0,744,1041,45.2609
SAN DIEGO,Apr 2016,CACF,2016,The Vine Learning Center,CHILD_BREAKFAST,21,18,0,45,63,207,0,517,724,34.4762
SAN DIEGO,Apr 2016,CACF,2016,The Vine Learning Center,CHILD_LUNCH,21,18,0,45,63,301,0,752,1053,50.1429
SAN DIEGO,Apr 2016,CACF,2016,The Vine Learning Center,CHILD_SNACK_PM,21,18,0,45,63,283,0,708,991,47.1905
SAN DIEGO,May 2016,CACF,2016,The Vine Learning Center,CHILD_BREAKFAST,21,18,0,45,63,201,0,504,705,33.5714
SAN DIEGO,May 2016,CACF,2016,The Vine Learning Center,CHILD_LUNCH,21,18,0,45,63,300,0,749,1049,49.9524
SAN DIEGO,May 2016,CACF,2016,The Vine Learning Center,CHILD_SNACK_PM,21,18,0,45,63,281,0,703,984,46.8571
SAN DIEGO,Jun 2016,CACF,2016,The Vine Learning Center,CHILD_BREAKFAST,22,18,0,45,63,223,0,557,780,35.4545
SAN DIEGO,Jun 2016,CACF,2016,The Vine Learning Center,CHILD_LUNCH,22,18,0,45,63,337,0,844,1181,53.6818
SAN DIEGO,Jun 2016,CACF,2016,The Vine Learning Center,CHILD_SNACK_PM,22,18,0,45,63,322,0,806,1128,51.2727
SAN DIEGO,Oct 2015,CACF,2016,TODDLER TOWN LLC ,CHILD_BREAKFAST,22,44,5,16,65,719,82,261,1062,48.2727
SAN DIEGO,Oct 2015,CACF,2016,TODDLER TOWN LLC ,CHILD_LUNCH,22,44,5,16,65,771,88,280,1139,51.7727
SAN DIEGO,Oct 2015,CACF,2016,TODDLER TOWN LLC ,CHILD_SNACK_PM,22,44,5,16,65,635,72,231,938,42.6364
SAN DIEGO,Nov 2015,CACF,2016,TODDLER TOWN LLC ,CHILD_BREAKFAST,19,44,5,16,65,577,66,209,852,44.8421
SAN DIEGO,Nov 2015,CACF,2016,TODDLER TOWN LLC ,CHILD_LUNCH,19,44,5,16,65,573,65,209,847,44.5789
SAN DIEGO,Nov 2015,CACF,2016,TODDLER TOWN LLC ,CHILD_SNACK_PM,19,44,5,16,65,494,56,180,730,38.4211
SAN DIEGO,Dec 2015,CACF,2016,TODDLER TOWN LLC ,CHILD_BREAKFAST,21,44,5,16,65,516,59,187,762,36.2857
SAN DIEGO,Dec 2015,CACF,2016,TODDLER TOWN LLC ,CHILD_LUNCH,21,44,5,16,65,574,65,209,848,40.381
SAN DIEGO,Dec 2015,CACF,2016,TODDLER TOWN LLC ,CHILD_SNACK_PM,21,44,5,16,65,468,53,171,692,32.9524
SAN DIEGO,Oct 2015,CACF,2016,TUTOR TIME LEARNING CENTERS LLC,CHILD_BREAKFAST,22,155,18,194,367,1725,200,2160,4085,185.6818
SAN DIEGO,Oct 2015,CACF,2016,TUTOR TIME LEARNING CENTERS LLC,CHILD_LUNCH,22,155,18,194,367,2261,262,2831,5354,243.3636
SAN DIEGO,Oct 2015,CACF,2016,TUTOR TIME LEARNING CENTERS LLC,CHILD_SNACK_PM,22,155,18,194,367,1978,230,2477,4685,212.9545
SAN DIEGO,Oct 2015,CACF,2016,TUTOR TIME LEARNING CENTERS LLC,OSCH_CHILD_BREAKFAST,22,55,11,74,140,123,25,164,312,14.1818
SAN DIEGO,Oct 2015,CACF,2016,TUTOR TIME LEARNING CENTERS LLC,OSCH_CHILD_LUNCH,22,55,11,74,140,289,58,389,736,33.4545
SAN DIEGO,Oct 2015,CACF,2016,TUTOR TIME LEARNING CENTERS LLC,OSCH_CHILD_SNACK_PM,22,55,11,74,140,807,161,1086,2054,93.3636
SAN DIEGO,Nov 2015,CACF,2016,TUTOR TIME LEARNING CENTERS LLC,CHILD_BREAKFAST,19,197,31,340,568,1682,265,2902,4849,255.2105
SAN DIEGO,Nov 2015,CACF,2016,TUTOR TIME LEARNING CENTERS LLC,CHILD_LUNCH,19,197,31,340,568,2176,343,3755,6274,330.2105
SAN DIEGO,Nov 2015,CACF,2016,TUTOR TIME LEARNING CENTERS LLC,CHILD_SNACK_PM,19,197,31,340,568,1956,308,3377,5641,296.8947
SAN DIEGO,Nov 2015,CACF,2016,TUTOR TIME LEARNING CENTERS LLC,OSCH_CHILD_BREAKFAST,19,88,25,107,220,150,43,183,376,19.7895
SAN DIEGO,Nov 2015,CACF,2016,TUTOR TIME LEARNING CENTERS LLC,OSCH_CHILD_LUNCH,19,88,25,107,220,354,101,431,886,46.6316
SAN DIEGO,Nov 2015,CACF,2016,TUTOR TIME LEARNING CENTERS LLC,OSCH_CHILD_SNACK_PM,19,88,25,107,220,845,240,1027,2112,111.1579
SAN DIEGO,Dec 2015,CACF,2016,TUTOR TIME LEARNING CENTERS LLC,CHILD_BREAKFAST,22,215,40,405,660,1974,367,3719,6060,275.4545
SAN DIEGO,Dec 2015,CACF,2016,TUTOR TIME LEARNING CENTERS LLC,CHILD_LUNCH,22,215,40,405,660,2779,517,5234,8530,387.7273
SAN DIEGO,Dec 2015,CACF,2016,TUTOR TIME LEARNING CENTERS LLC,CHILD_SNACK_PM,22,215,40,405,660,2464,458,4640,7562,343.7273
SAN DIEGO,Dec 2015,CACF,2016,TUTOR TIME LEARNING CENTERS LLC,OSCH_CHILD_BREAKFAST,22,92,28,132,252,191,58,274,523,23.7727
SAN DIEGO,Dec 2015,CACF,2016,TUTOR TIME LEARNING CENTERS LLC,OSCH_CHILD_LUNCH,22,92,28,132,252,411,125,590,1126,51.1818
SAN DIEGO,Dec 2015,CACF,2016,TUTOR TIME LEARNING CENTERS LLC,OSCH_CHILD_SNACK_PM,22,92,28,132,252,941,286,1351,2578,117.1818
SAN DIEGO,Jan 2016,CACF,2016,TUTOR TIME LEARNING CENTERS LLC,CHILD_BREAKFAST,20,215,40,405,660,2103,391,3960,6454,322.7
SAN DIEGO,Jan 2016,CACF,2016,TUTOR TIME LEARNING CENTERS LLC,CHILD_LUNCH,20,215,40,405,660,2781,517,5237,8535,426.75
SAN DIEGO,Jan 2016,CACF,2016,TUTOR TIME LEARNING CENTERS LLC,CHILD_SNACK_PM,20,215,40,405,660,2564,477,4828,7869,393.45
SAN DIEGO,Jan 2016,CACF,2016,TUTOR TIME LEARNING CENTERS LLC,OSCH_CHILD_BREAKFAST,20,92,28,132,252,160,49,228,437,21.85
SAN DIEGO,Jan 2016,CACF,2016,TUTOR TIME LEARNING CENTERS LLC,OSCH_CHILD_LUNCH,20,92,28,132,252,322,98,463,883,44.15
SAN DIEGO,Jan 2016,CACF,2016,TUTOR TIME LEARNING CENTERS LLC,OSCH_CHILD_SNACK_PM,20,92,28,132,252,984,300,1412,2696,134.8
SAN DIEGO,Feb 2016,CACF,2016,TUTOR TIME LEARNING CENTERS LLC,CHILD_BREAKFAST,20,215,40,405,660,1665,310,3137,5112,255.6
SAN DIEGO,Feb 2016,CACF,2016,TUTOR TIME LEARNING CENTERS LLC,CHILD_LUNCH,20,215,40,405,660,2237,416,4213,6866,343.3
SAN DIEGO,Feb 2016,CACF,2016,TUTOR TIME LEARNING CENTERS LLC,CHILD_SNACK_PM,20,215,40,405,660,2008,374,3782,6164,308.2
SAN DIEGO,Feb 2016,CACF,2016,TUTOR TIME LEARNING CENTERS LLC,OSCH_CHILD_BREAKFAST,20,92,28,132,252,126,38,180,344,17.2
SAN DIEGO,Feb 2016,CACF,2016,TUTOR TIME LEARNING CENTERS LLC,OSCH_CHILD_LUNCH,20,92,28,132,252,221,67,317,605,30.25
SAN DIEGO,Feb 2016,CACF,2016,TUTOR TIME LEARNING CENTERS LLC,OSCH_CHILD_SNACK_PM,20,92,28,132,252,858,261,1231,2350,117.5
SAN DIEGO,Mar 2016,CACF,2016,TUTOR TIME LEARNING CENTERS LLC,CHILD_BREAKFAST,23,215,40,405,660,1922,357,3620,5899,256.4783
SAN DIEGO,Mar 2016,CACF,2016,TUTOR TIME LEARNING CENTERS LLC,CHILD_LUNCH,23,215,40,405,660,2686,500,5058,8244,358.4348
SAN DIEGO,Mar 2016,CACF,2016,TUTOR TIME LEARNING CENTERS LLC,CHILD_SNACK_PM,23,215,40,405,660,2305,429,4340,7074,307.5652
SAN DIEGO,Mar 2016,CACF,2016,TUTOR TIME LEARNING CENTERS LLC,OSCH_CHILD_BREAKFAST,23,92,28,132,252,170,52,244,466,20.2609
SAN DIEGO,Mar 2016,CACF,2016,TUTOR TIME LEARNING CENTERS LLC,OSCH_CHILD_LUNCH,23,92,28,132,252,426,130,611,1167,50.7391
SAN DIEGO,Mar 2016,CACF,2016,TUTOR TIME LEARNING CENTERS LLC,OSCH_CHILD_SNACK_PM,23,92,28,132,252,926,282,1327,2535,110.2174
SAN DIEGO,Apr 2016,CACF,2016,TUTOR TIME LEARNING CENTERS LLC,CHILD_BREAKFAST,21,215,40,405,660,1796,334,3382,5512,262.4762
SAN DIEGO,Apr 2016,CACF,2016,TUTOR TIME LEARNING CENTERS LLC,CHILD_LUNCH,21,215,40,405,660,2586,481,4871,7938,378
SAN DIEGO,Apr 2016,CACF,2016,TUTOR TIME LEARNING CENTERS LLC,CHILD_SNACK_PM,21,215,40,405,660,2277,424,4289,6990,332.8571
SAN DIEGO,Apr 2016,CACF,2016,TUTOR TIME LEARNING CENTERS LLC,OSCH_CHILD_BREAKFAST,21,92,28,132,252,95,29,137,261,12.4286
SAN DIEGO,Apr 2016,CACF,2016,TUTOR TIME LEARNING CENTERS LLC,OSCH_CHILD_LUNCH,21,92,28,132,252,218,66,313,597,28.4286
SAN DIEGO,Apr 2016,CACF,2016,TUTOR TIME LEARNING CENTERS LLC,OSCH_CHILD_SNACK_PM,21,92,28,132,252,893,272,1282,2447,116.5238
SAN DIEGO,May 2016,CACF,2016,TUTOR TIME LEARNING CENTERS LLC,CHILD_BREAKFAST,21,215,40,405,660,2343,436,4411,7190,342.381
SAN DIEGO,May 2016,CACF,2016,TUTOR TIME LEARNING CENTERS LLC,CHILD_LUNCH,21,215,40,405,660,3158,587,5947,9692,461.5238
SAN DIEGO,May 2016,CACF,2016,TUTOR TIME LEARNING CENTERS LLC,CHILD_SNACK_PM,21,215,40,405,660,2785,518,5246,8549,407.0952
SAN DIEGO,May 2016,CACF,2016,TUTOR TIME LEARNING CENTERS LLC,OSCH_CHILD_BREAKFAST,21,92,28,132,252,94,29,135,258,12.2857
SAN DIEGO,May 2016,CACF,2016,TUTOR TIME LEARNING CENTERS LLC,OSCH_CHILD_LUNCH,21,92,28,132,252,272,83,391,746,35.5238
SAN DIEGO,May 2016,CACF,2016,TUTOR TIME LEARNING CENTERS LLC,OSCH_CHILD_SNACK_PM,21,92,28,132,252,966,294,1386,2646,126
SAN DIEGO,Jun 2016,CACF,2016,TUTOR TIME LEARNING CENTERS LLC,CHILD_BREAKFAST,22,215,40,405,660,2076,386,3909,6371,289.5909
SAN DIEGO,Jun 2016,CACF,2016,TUTOR TIME LEARNING CENTERS LLC,CHILD_LUNCH,22,215,40,405,660,2971,553,5594,9118,414.4545
SAN DIEGO,Jun 2016,CACF,2016,TUTOR TIME LEARNING CENTERS LLC,CHILD_SNACK_PM,22,215,40,405,660,2526,470,4757,7753,352.4091
SAN DIEGO,Jun 2016,CACF,2016,TUTOR TIME LEARNING CENTERS LLC,OSCH_CHILD_BREAKFAST,22,92,28,132,252,520,158,747,1425,64.7727
SAN DIEGO,Jun 2016,CACF,2016,TUTOR TIME LEARNING CENTERS LLC,OSCH_CHILD_LUNCH,22,92,28,132,252,874,266,1254,2394,108.8182
SAN DIEGO,Jun 2016,CACF,2016,TUTOR TIME LEARNING CENTERS LLC,OSCH_CHILD_SNACK_PM,22,92,28,132,252,956,291,1371,2618,119
SAN DIEGO,Jul 2016,CACF,2016,TUTOR TIME LEARNING CENTERS LLC,CHILD_BREAKFAST,20,291,34,431,756,2344,274,3473,6091,304.55
SAN DIEGO,Jul 2016,CACF,2016,TUTOR TIME LEARNING CENTERS LLC,CHILD_LUNCH,20,291,34,431,756,3504,410,5189,9103,455.15
SAN DIEGO,Jul 2016,CACF,2016,TUTOR TIME LEARNING CENTERS LLC,CHILD_SNACK_PM,20,291,34,431,756,2985,349,4420,7754,387.7
SAN DIEGO,Jul 2016,CACF,2016,TUTOR TIME LEARNING CENTERS LLC,OSCH_CHILD_BREAKFAST,20,103,30,151,284,708,206,1037,1951,97.55
SAN DIEGO,Jul 2016,CACF,2016,TUTOR TIME LEARNING CENTERS LLC,OSCH_CHILD_LUNCH,20,103,30,151,284,1055,307,1547,2909,145.45
SAN DIEGO,Jul 2016,CACF,2016,TUTOR TIME LEARNING CENTERS LLC,OSCH_CHILD_SNACK_PM,20,103,30,151,284,1039,302,1523,2864,143.2
SAN DIEGO,Oct 2015,CACF,2016,UNITED CHURCH/CHRIST LA MESA CHARLEY BROWNS CHILDREN CENTER,CHILD_BREAKFAST,22,2,0,84,86,25,0,1050,1075,48.8636
SAN DIEGO,Oct 2015,CACF,2016,UNITED CHURCH/CHRIST LA MESA CHARLEY BROWNS CHILDREN CENTER,CHILD_LUNCH,22,2,0,84,86,29,0,1207,1236,56.1818
SAN DIEGO,Oct 2015,CACF,2016,UNITED CHURCH/CHRIST LA MESA CHARLEY BROWNS CHILDREN CENTER,CHILD_SNACK_PM,22,2,0,84,86,25,0,1059,1084,49.2727
SAN DIEGO,Nov 2015,CACF,2016,UNITED CHURCH/CHRIST LA MESA CHARLEY BROWNS CHILDREN CENTER,CHILD_BREAKFAST,19,2,0,84,86,23,0,969,992,52.2105
SAN DIEGO,Nov 2015,CACF,2016,UNITED CHURCH/CHRIST LA MESA CHARLEY BROWNS CHILDREN CENTER,CHILD_LUNCH,19,2,0,84,86,25,0,1052,1077,56.6842
SAN DIEGO,Nov 2015,CACF,2016,UNITED CHURCH/CHRIST LA MESA CHARLEY BROWNS CHILDREN CENTER,CHILD_SNACK_PM,19,2,0,84,86,22,0,921,943,49.6316
SAN DIEGO,Dec 2015,CACF,2016,UNITED CHURCH/CHRIST LA MESA CHARLEY BROWNS CHILDREN CENTER,CHILD_BREAKFAST,20,2,0,84,86,23,0,963,986,49.3
SAN DIEGO,Dec 2015,CACF,2016,UNITED CHURCH/CHRIST LA MESA CHARLEY BROWNS CHILDREN CENTER,CHILD_LUNCH,20,2,0,84,86,26,0,1108,1134,56.7
SAN DIEGO,Dec 2015,CACF,2016,UNITED CHURCH/CHRIST LA MESA CHARLEY BROWNS CHILDREN CENTER,CHILD_SNACK_PM,20,2,0,84,86,22,0,910,932,46.6
SAN DIEGO,Jan 2016,CACF,2016,UNITED CHURCH/CHRIST LA MESA CHARLEY BROWNS CHILDREN CENTER,CHILD_BREAKFAST,19,2,0,84,86,23,0,957,980,51.5789
SAN DIEGO,Jan 2016,CACF,2016,UNITED CHURCH/CHRIST LA MESA CHARLEY BROWNS CHILDREN CENTER,CHILD_LUNCH,19,2,0,84,86,25,0,1039,1064,56
SAN DIEGO,Jan 2016,CACF,2016,UNITED CHURCH/CHRIST LA MESA CHARLEY BROWNS CHILDREN CENTER,CHILD_SNACK_PM,19,2,0,84,86,23,0,944,967,50.8947
SAN DIEGO,Feb 2016,CACF,2016,UNITED CHURCH/CHRIST LA MESA CHARLEY BROWNS CHILDREN CENTER,CHILD_BREAKFAST,21,2,0,84,86,26,0,1085,1111,52.9048
SAN DIEGO,Feb 2016,CACF,2016,UNITED CHURCH/CHRIST LA MESA CHARLEY BROWNS CHILDREN CENTER,CHILD_LUNCH,21,2,0,84,86,30,0,1268,1298,61.8095
SAN DIEGO,Feb 2016,CACF,2016,UNITED CHURCH/CHRIST LA MESA CHARLEY BROWNS CHILDREN CENTER,CHILD_SNACK_PM,21,2,0,84,86,27,0,1141,1168,55.619
SAN DIEGO,Mar 2016,CACF,2016,UNITED CHURCH/CHRIST LA MESA CHARLEY BROWNS CHILDREN CENTER,CHILD_BREAKFAST,23,2,0,84,86,28,0,1178,1206,52.4348
SAN DIEGO,Mar 2016,CACF,2016,UNITED CHURCH/CHRIST LA MESA CHARLEY BROWNS CHILDREN CENTER,CHILD_LUNCH,23,2,0,84,86,34,0,1424,1458,63.3913
SAN DIEGO,Mar 2016,CACF,2016,UNITED CHURCH/CHRIST LA MESA CHARLEY BROWNS CHILDREN CENTER,CHILD_SNACK_PM,23,2,0,84,86,30,0,1264,1294,56.2609
SAN DIEGO,Apr 2016,CACF,2016,UNITED CHURCH/CHRIST LA MESA CHARLEY BROWNS CHILDREN CENTER,CHILD_BREAKFAST,21,2,0,84,86,26,0,1089,1115,53.0952
SAN DIEGO,Apr 2016,CACF,2016,UNITED CHURCH/CHRIST LA MESA CHARLEY BROWNS CHILDREN CENTER,CHILD_LUNCH,21,2,0,84,86,31,0,1297,1328,63.2381
SAN DIEGO,Apr 2016,CACF,2016,UNITED CHURCH/CHRIST LA MESA CHARLEY BROWNS CHILDREN CENTER,CHILD_SNACK_PM,21,2,0,84,86,28,0,1178,1206,57.4286
SAN DIEGO,May 2016,CACF,2016,UNITED CHURCH/CHRIST LA MESA CHARLEY BROWNS CHILDREN CENTER,CHILD_BREAKFAST,21,2,0,84,86,26,0,1104,1130,53.8095
SAN DIEGO,May 2016,CACF,2016,UNITED CHURCH/CHRIST LA MESA CHARLEY BROWNS CHILDREN CENTER,CHILD_LUNCH,21,2,0,84,86,32,0,1331,1363,64.9048
SAN DIEGO,May 2016,CACF,2016,UNITED CHURCH/CHRIST LA MESA CHARLEY BROWNS CHILDREN CENTER,CHILD_SNACK_PM,21,2,0,84,86,28,0,1172,1200,57.1429
SAN DIEGO,Jun 2016,CACF,2016,UNITED CHURCH/CHRIST LA MESA CHARLEY BROWNS CHILDREN CENTER,CHILD_BREAKFAST,22,2,0,84,86,24,0,1010,1034,47
SAN DIEGO,Jun 2016,CACF,2016,UNITED CHURCH/CHRIST LA MESA CHARLEY BROWNS CHILDREN CENTER,CHILD_LUNCH,22,2,0,84,86,29,0,1235,1264,57.4545
SAN DIEGO,Jun 2016,CACF,2016,UNITED CHURCH/CHRIST LA MESA CHARLEY BROWNS CHILDREN CENTER,CHILD_SNACK_PM,22,2,0,84,86,26,0,1094,1120,50.9091
SAN DIEGO,Jul 2016,CACF,2016,UNITED CHURCH/CHRIST LA MESA CHARLEY BROWNS CHILDREN CENTER,CHILD_BREAKFAST,20,2,0,84,86,21,0,886,907,45.35
SAN DIEGO,Jul 2016,CACF,2016,UNITED CHURCH/CHRIST LA MESA CHARLEY BROWNS CHILDREN CENTER,CHILD_LUNCH,20,2,0,84,86,26,0,1083,1109,55.45
SAN DIEGO,Jul 2016,CACF,2016,UNITED CHURCH/CHRIST LA MESA CHARLEY BROWNS CHILDREN CENTER,CHILD_SNACK_PM,20,2,0,84,86,22,0,942,964,48.2
SAN DIEGO,Oct 2015,CACF,2016,"University of California, San Diego",CHILD_BREAKFAST,22,34,10,139,183,354,104,1445,1903,86.5
SAN DIEGO,Oct 2015,CACF,2016,"University of California, San Diego",CHILD_LUNCH,22,34,10,139,183,648,190,2651,3489,158.5909
SAN DIEGO,Oct 2015,CACF,2016,"University of California, San Diego",CHILD_SNACK_PM,22,34,10,139,183,618,182,2525,3325,151.1364
SAN DIEGO,Nov 2015,CACF,2016,"University of California, San Diego",CHILD_BREAKFAST,18,34,10,139,183,309,91,1264,1664,92.4444
SAN DIEGO,Nov 2015,CACF,2016,"University of California, San Diego",CHILD_LUNCH,18,34,10,139,183,535,157,2188,2880,160
SAN DIEGO,Nov 2015,CACF,2016,"University of California, San Diego",CHILD_SNACK_PM,18,34,10,139,183,510,150,2083,2743,152.3889
SAN DIEGO,Dec 2015,CACF,2016,"University of California, San Diego",CHILD_BREAKFAST,17,34,10,139,183,254,75,1039,1368,80.4706
SAN DIEGO,Dec 2015,CACF,2016,"University of California, San Diego",CHILD_LUNCH,17,34,10,139,183,489,144,1997,2630,154.7059
SAN DIEGO,Dec 2015,CACF,2016,"University of California, San Diego",CHILD_SNACK_PM,17,34,10,139,183,454,133,1858,2445,143.8235
SAN DIEGO,Jan 2016,CACF,2016,"University of California, San Diego",CHILD_BREAKFAST,19,34,10,139,183,293,86,1198,1577,83
SAN DIEGO,Jan 2016,CACF,2016,"University of California, San Diego",CHILD_LUNCH,19,34,10,139,183,532,156,2176,2864,150.7368
SAN DIEGO,Jan 2016,CACF,2016,"University of California, San Diego",CHILD_SNACK_PM,19,34,10,139,183,498,146,2036,2680,141.0526
SAN DIEGO,Feb 2016,CACF,2016,"University of California, San Diego",CHILD_BREAKFAST,20,34,10,139,183,335,98,1371,1804,90.2
SAN DIEGO,Feb 2016,CACF,2016,"University of California, San Diego",CHILD_LUNCH,20,34,10,139,183,591,174,2414,3179,158.95
SAN DIEGO,Feb 2016,CACF,2016,"University of California, San Diego",CHILD_SNACK_PM,20,34,10,139,183,562,165,2297,3024,151.2
SAN DIEGO,Mar 2016,CACF,2016,"University of California, San Diego",CHILD_BREAKFAST,21,34,10,139,183,378,111,1546,2035,96.9048
SAN DIEGO,Mar 2016,CACF,2016,"University of California, San Diego",CHILD_LUNCH,21,34,10,139,183,705,207,2883,3795,180.7143
SAN DIEGO,Mar 2016,CACF,2016,"University of California, San Diego",CHILD_SNACK_PM,21,34,10,139,183,658,194,2692,3544,168.7619
SAN DIEGO,Apr 2016,CACF,2016,"University of California, San Diego",CHILD_BREAKFAST,21,34,15,158,207,345,152,1602,2099,99.9524
SAN DIEGO,Apr 2016,CACF,2016,"University of California, San Diego",CHILD_LUNCH,21,34,15,158,207,649,287,3017,3953,188.2381
SAN DIEGO,Apr 2016,CACF,2016,"University of California, San Diego",CHILD_SNACK_PM,21,34,15,158,207,618,273,2871,3762,179.1429
SAN DIEGO,May 2016,CACF,2016,"University of California, San Diego",CHILD_BREAKFAST,21,34,15,158,207,330,146,1534,2010,95.7143
SAN DIEGO,May 2016,CACF,2016,"University of California, San Diego",CHILD_LUNCH,21,34,15,158,207,624,275,2896,3795,180.7143
SAN DIEGO,May 2016,CACF,2016,"University of California, San Diego",CHILD_SNACK_PM,21,34,15,158,207,597,263,2774,3634,173.0476
SAN DIEGO,Jun 2016,CACF,2016,"University of California, San Diego",CHILD_BREAKFAST,22,34,15,158,207,319,141,1483,1943,88.3182
SAN DIEGO,Jun 2016,CACF,2016,"University of California, San Diego",CHILD_LUNCH,22,34,15,158,207,586,258,2720,3564,162
SAN DIEGO,Jun 2016,CACF,2016,"University of California, San Diego",CHILD_SNACK_PM,22,34,15,158,207,556,245,2585,3386,153.9091
SAN DIEGO,Jul 2016,CACF,2016,"University of California, San Diego",CHILD_BREAKFAST,20,34,15,158,207,259,114,1202,1575,78.75
SAN DIEGO,Jul 2016,CACF,2016,"University of California, San Diego",CHILD_LUNCH,20,34,15,158,207,488,216,2269,2973,148.65
SAN DIEGO,Jul 2016,CACF,2016,"University of California, San Diego",CHILD_SNACK_PM,20,34,15,158,207,459,202,2132,2793,139.65
SAN DIEGO,Oct 2015,CACF,2016,VISIONS OF GOD CHRISTIAN FELLOWSHIP,CHILD_BREAKFAST,22,21,7,18,46,274,91,236,601,27.3182
SAN DIEGO,Oct 2015,CACF,2016,VISIONS OF GOD CHRISTIAN FELLOWSHIP,CHILD_LUNCH,22,21,7,18,46,353,118,302,773,35.1364
SAN DIEGO,Oct 2015,CACF,2016,VISIONS OF GOD CHRISTIAN FELLOWSHIP,CHILD_SNACK_PM,22,21,7,18,46,297,99,255,651,29.5909
SAN DIEGO,Nov 2015,CACF,2016,VISIONS OF GOD CHRISTIAN FELLOWSHIP,CHILD_BREAKFAST,18,21,7,18,46,249,83,213,545,30.2778
SAN DIEGO,Nov 2015,CACF,2016,VISIONS OF GOD CHRISTIAN FELLOWSHIP,CHILD_LUNCH,18,21,7,18,46,310,103,266,679,37.7222
SAN DIEGO,Nov 2015,CACF,2016,VISIONS OF GOD CHRISTIAN FELLOWSHIP,CHILD_SNACK_PM,18,21,7,18,46,255,85,219,559,31.0556
SAN DIEGO,Dec 2015,CACF,2016,VISIONS OF GOD CHRISTIAN FELLOWSHIP,CHILD_BREAKFAST,17,21,7,18,46,225,75,193,493,29
SAN DIEGO,Dec 2015,CACF,2016,VISIONS OF GOD CHRISTIAN FELLOWSHIP,CHILD_LUNCH,17,21,7,18,46,289,96,249,634,37.2941
SAN DIEGO,Dec 2015,CACF,2016,VISIONS OF GOD CHRISTIAN FELLOWSHIP,CHILD_SNACK_PM,17,21,7,18,46,245,82,209,536,31.5294
SAN DIEGO,Jan 2016,CACF,2016,VISIONS OF GOD CHRISTIAN FELLOWSHIP,CHILD_BREAKFAST,19,21,7,18,46,252,84,216,552,29.0526
SAN DIEGO,Jan 2016,CACF,2016,VISIONS OF GOD CHRISTIAN FELLOWSHIP,CHILD_LUNCH,19,21,7,18,46,333,111,286,730,38.4211
SAN DIEGO,Jan 2016,CACF,2016,VISIONS OF GOD CHRISTIAN FELLOWSHIP,CHILD_SNACK_PM,19,21,7,18,46,282,94,242,618,32.5263
SAN DIEGO,Feb 2016,CACF,2016,VISIONS OF GOD CHRISTIAN FELLOWSHIP,CHILD_BREAKFAST,20,21,7,18,46,254,85,218,557,27.85
SAN DIEGO,Feb 2016,CACF,2016,VISIONS OF GOD CHRISTIAN FELLOWSHIP,CHILD_LUNCH,20,21,7,18,46,321,107,276,704,35.2
SAN DIEGO,Feb 2016,CACF,2016,VISIONS OF GOD CHRISTIAN FELLOWSHIP,CHILD_SNACK_PM,20,21,7,18,46,270,90,232,592,29.6
SAN DIEGO,Mar 2016,CACF,2016,VISIONS OF GOD CHRISTIAN FELLOWSHIP,CHILD_BREAKFAST,23,21,7,18,46,267,89,229,585,25.4348
SAN DIEGO,Mar 2016,CACF,2016,VISIONS OF GOD CHRISTIAN FELLOWSHIP,CHILD_LUNCH,23,21,7,18,46,340,113,291,744,32.3478
SAN DIEGO,Mar 2016,CACF,2016,VISIONS OF GOD CHRISTIAN FELLOWSHIP,CHILD_SNACK_PM,23,21,7,18,46,287,96,246,629,27.3478
SAN DIEGO,Apr 2016,CACF,2016,VISIONS OF GOD CHRISTIAN FELLOWSHIP,CHILD_BREAKFAST,21,21,7,18,46,275,92,235,602,28.6667
SAN DIEGO,Apr 2016,CACF,2016,VISIONS OF GOD CHRISTIAN FELLOWSHIP,CHILD_LUNCH,21,21,7,18,46,351,117,300,768,36.5714
SAN DIEGO,Apr 2016,CACF,2016,VISIONS OF GOD CHRISTIAN FELLOWSHIP,CHILD_SNACK_PM,21,21,7,18,46,294,98,253,645,30.7143
SAN DIEGO,May 2016,CACF,2016,VISIONS OF GOD CHRISTIAN FELLOWSHIP,CHILD_BREAKFAST,21,21,7,18,46,271,90,233,594,28.2857
SAN DIEGO,May 2016,CACF,2016,VISIONS OF GOD CHRISTIAN FELLOWSHIP,CHILD_LUNCH,21,21,7,18,46,332,111,285,728,34.6667
SAN DIEGO,May 2016,CACF,2016,VISIONS OF GOD CHRISTIAN FELLOWSHIP,CHILD_SNACK_PM,21,21,7,18,46,270,90,231,591,28.1429
SAN DIEGO,Jun 2016,CACF,2016,VISIONS OF GOD CHRISTIAN FELLOWSHIP,CHILD_BREAKFAST,22,21,7,18,46,307,102,264,673,30.5909
SAN DIEGO,Jun 2016,CACF,2016,VISIONS OF GOD CHRISTIAN FELLOWSHIP,CHILD_LUNCH,22,21,7,18,46,385,128,330,843,38.3182
SAN DIEGO,Jun 2016,CACF,2016,VISIONS OF GOD CHRISTIAN FELLOWSHIP,CHILD_SNACK_PM,22,21,7,18,46,321,107,276,704,32
SAN DIEGO,Jul 2016,CACF,2016,VISIONS OF GOD CHRISTIAN FELLOWSHIP,CHILD_BREAKFAST,20,21,7,18,46,210,70,181,461,23.05
SAN DIEGO,Jul 2016,CACF,2016,VISIONS OF GOD CHRISTIAN FELLOWSHIP,CHILD_LUNCH,20,21,7,18,46,310,103,266,679,33.95
SAN DIEGO,Jul 2016,CACF,2016,VISIONS OF GOD CHRISTIAN FELLOWSHIP,CHILD_SNACK_PM,20,21,7,18,46,247,82,211,540,27
SAN DIEGO,Oct 2015,CACF,2016,VISTA UNIFIED SCHOOL DISTRICT,ATRISK_CHILD_SUPPER,22,7981,0,0,7981,39325,0,0,39325,1787.5
SAN DIEGO,Nov 2015,CACF,2016,VISTA UNIFIED SCHOOL DISTRICT,ATRISK_CHILD_SUPPER,17,8133,0,0,8133,27784,0,0,27784,1634.3529
SAN DIEGO,Dec 2015,CACF,2016,VISTA UNIFIED SCHOOL DISTRICT,ATRISK_CHILD_SUPPER,17,8364,0,0,8364,25234,0,0,25234,1484.3529
SAN DIEGO,Jan 2016,CACF,2016,VISTA UNIFIED SCHOOL DISTRICT,ATRISK_CHILD_SUPPER,19,8494,0,0,8494,31095,0,0,31095,1636.5789
SAN DIEGO,Feb 2016,CACF,2016,VISTA UNIFIED SCHOOL DISTRICT,ATRISK_CHILD_SUPPER,20,8600,0,0,8600,34466,0,0,34466,1723.3
SAN DIEGO,Mar 2016,CACF,2016,VISTA UNIFIED SCHOOL DISTRICT,ATRISK_CHILD_SUPPER,23,8609,0,0,8609,35046,0,0,35046,1523.7391
SAN DIEGO,Apr 2016,CACF,2016,VISTA UNIFIED SCHOOL DISTRICT,ATRISK_CHILD_SUPPER,21,8415,0,0,8415,36839,0,0,36839,1754.2381
SAN DIEGO,May 2016,CACF,2016,VISTA UNIFIED SCHOOL DISTRICT,ATRISK_CHILD_SUPPER,21,8501,0,0,8501,37773,0,0,37773,1798.7143
SAN DIEGO,Jun 2016,CACF,2016,VISTA UNIFIED SCHOOL DISTRICT,ATRISK_CHILD_SUPPER,2,8290,0,0,8290,2315,0,0,2315,1157.5
SAN DIEGO,Oct 2015,CACF,2016,VOLUNTEERS OF AMERICA SOUTHWEST CA CORP,CHILD_BREAKFAST,22,152,23,11,186,2059,312,149,2520,114.5455
SAN DIEGO,Oct 2015,CACF,2016,VOLUNTEERS OF AMERICA SOUTHWEST CA CORP,CHILD_LUNCH,22,152,23,11,186,1925,291,140,2356,107.0909
SAN DIEGO,Oct 2015,CACF,2016,VOLUNTEERS OF AMERICA SOUTHWEST CA CORP,CHILD_SNACK_PM,22,152,23,11,186,990,150,71,1211,55.0455
SAN DIEGO,Oct 2015,CACF,2016,VOLUNTEERS OF AMERICA SOUTHWEST CA CORP,HS_CHILD_BREAKFAST,22,226,0,0,226,938,0,0,938,42.6364
SAN DIEGO,Oct 2015,CACF,2016,VOLUNTEERS OF AMERICA SOUTHWEST CA CORP,HS_CHILD_LUNCH,22,226,0,0,226,1073,0,0,1073,48.7727
SAN DIEGO,Oct 2015,CACF,2016,VOLUNTEERS OF AMERICA SOUTHWEST CA CORP,HS_CHILD_SNACK_PM,22,226,0,0,226,611,0,0,611,27.7727
SAN DIEGO,Nov 2015,CACF,2016,VOLUNTEERS OF AMERICA SOUTHWEST CA CORP,CHILD_BREAKFAST,19,152,23,11,186,1677,254,121,2052,108
SAN DIEGO,Nov 2015,CACF,2016,VOLUNTEERS OF AMERICA SOUTHWEST CA CORP,CHILD_LUNCH,19,152,23,11,186,1518,230,110,1858,97.7895
SAN DIEGO,Nov 2015,CACF,2016,VOLUNTEERS OF AMERICA SOUTHWEST CA CORP,CHILD_SNACK_PM,19,152,23,11,186,790,120,57,967,50.8947
SAN DIEGO,Nov 2015,CACF,2016,VOLUNTEERS OF AMERICA SOUTHWEST CA CORP,HS_CHILD_BREAKFAST,19,226,0,0,226,752,0,0,752,39.5789
SAN DIEGO,Nov 2015,CACF,2016,VOLUNTEERS OF AMERICA SOUTHWEST CA CORP,HS_CHILD_LUNCH,19,226,0,0,226,857,0,0,857,45.1053
SAN DIEGO,Nov 2015,CACF,2016,VOLUNTEERS OF AMERICA SOUTHWEST CA CORP,HS_CHILD_SNACK_PM,19,226,0,0,226,517,0,0,517,27.2105
SAN DIEGO,Dec 2015,CACF,2016,VOLUNTEERS OF AMERICA SOUTHWEST CA CORP,CHILD_BREAKFAST,17,152,23,11,186,1196,181,87,1464,86.1176
SAN DIEGO,Dec 2015,CACF,2016,VOLUNTEERS OF AMERICA SOUTHWEST CA CORP,CHILD_LUNCH,17,152,23,11,186,1137,172,82,1391,81.8235
SAN DIEGO,Dec 2015,CACF,2016,VOLUNTEERS OF AMERICA SOUTHWEST CA CORP,CHILD_SNACK_PM,17,152,23,11,186,513,78,37,628,36.9412
SAN DIEGO,Dec 2015,CACF,2016,VOLUNTEERS OF AMERICA SOUTHWEST CA CORP,HS_CHILD_BREAKFAST,14,226,0,0,226,557,0,0,557,39.7857
SAN DIEGO,Dec 2015,CACF,2016,VOLUNTEERS OF AMERICA SOUTHWEST CA CORP,HS_CHILD_LUNCH,14,226,0,0,226,632,0,0,632,45.1429
SAN DIEGO,Dec 2015,CACF,2016,VOLUNTEERS OF AMERICA SOUTHWEST CA CORP,HS_CHILD_SNACK_PM,14,226,0,0,226,342,0,0,342,24.4286
SAN DIEGO,Jan 2016,CACF,2016,VOLUNTEERS OF AMERICA SOUTHWEST CA CORP,CHILD_BREAKFAST,19,152,23,11,186,1555,235,113,1903,100.1579
SAN DIEGO,Jan 2016,CACF,2016,VOLUNTEERS OF AMERICA SOUTHWEST CA CORP,CHILD_LUNCH,19,152,23,11,186,1497,227,108,1832,96.4211
SAN DIEGO,Jan 2016,CACF,2016,VOLUNTEERS OF AMERICA SOUTHWEST CA CORP,CHILD_SNACK_PM,19,152,23,11,186,824,125,59,1008,53.0526
SAN DIEGO,Jan 2016,CACF,2016,VOLUNTEERS OF AMERICA SOUTHWEST CA CORP,HS_CHILD_BREAKFAST,19,226,0,0,226,679,0,0,679,35.7368
SAN DIEGO,Jan 2016,CACF,2016,VOLUNTEERS OF AMERICA SOUTHWEST CA CORP,HS_CHILD_LUNCH,19,226,0,0,226,810,0,0,810,42.6316
SAN DIEGO,Jan 2016,CACF,2016,VOLUNTEERS OF AMERICA SOUTHWEST CA CORP,HS_CHILD_SNACK_PM,19,226,0,0,226,452,0,0,452,23.7895
SAN DIEGO,Feb 2016,CACF,2016,VOLUNTEERS OF AMERICA SOUTHWEST CA CORP,CHILD_BREAKFAST,20,152,23,11,186,1882,285,136,2303,115.15
SAN DIEGO,Feb 2016,CACF,2016,VOLUNTEERS OF AMERICA SOUTHWEST CA CORP,CHILD_LUNCH,20,152,23,11,186,1844,279,134,2257,112.85
SAN DIEGO,Feb 2016,CACF,2016,VOLUNTEERS OF AMERICA SOUTHWEST CA CORP,CHILD_SNACK_PM,20,152,23,11,186,879,133,64,1076,53.8
SAN DIEGO,Feb 2016,CACF,2016,VOLUNTEERS OF AMERICA SOUTHWEST CA CORP,HS_CHILD_BREAKFAST,20,226,0,0,226,815,0,0,815,40.75
SAN DIEGO,Feb 2016,CACF,2016,VOLUNTEERS OF AMERICA SOUTHWEST CA CORP,HS_CHILD_LUNCH,20,226,0,0,226,934,0,0,934,46.7
SAN DIEGO,Feb 2016,CACF,2016,VOLUNTEERS OF AMERICA SOUTHWEST CA CORP,HS_CHILD_SNACK_PM,20,226,0,0,226,503,0,0,503,25.15
SAN DIEGO,Mar 2016,CACF,2016,VOLUNTEERS OF AMERICA SOUTHWEST CA CORP,CHILD_BREAKFAST,23,152,23,11,186,2161,327,156,2644,114.9565
SAN DIEGO,Mar 2016,CACF,2016,VOLUNTEERS OF AMERICA SOUTHWEST CA CORP,CHILD_LUNCH,23,152,23,11,186,2111,320,152,2583,112.3043
SAN DIEGO,Mar 2016,CACF,2016,VOLUNTEERS OF AMERICA SOUTHWEST CA CORP,CHILD_SNACK_PM,23,152,23,11,186,1071,162,77,1310,56.9565
SAN DIEGO,Mar 2016,CACF,2016,VOLUNTEERS OF AMERICA SOUTHWEST CA CORP,HS_CHILD_BREAKFAST,23,226,0,0,226,924,0,0,924,40.1739
SAN DIEGO,Mar 2016,CACF,2016,VOLUNTEERS OF AMERICA SOUTHWEST CA CORP,HS_CHILD_LUNCH,23,226,0,0,226,1026,0,0,1026,44.6087
SAN DIEGO,Mar 2016,CACF,2016,VOLUNTEERS OF AMERICA SOUTHWEST CA CORP,HS_CHILD_SNACK_PM,23,226,0,0,226,625,0,0,625,27.1739
SAN DIEGO,Apr 2016,CACF,2016,VOLUNTEERS OF AMERICA SOUTHWEST CA CORP,CHILD_BREAKFAST,21,152,23,11,186,2036,308,147,2491,118.619
SAN DIEGO,Apr 2016,CACF,2016,VOLUNTEERS OF AMERICA SOUTHWEST CA CORP,CHILD_LUNCH,21,152,23,11,186,2050,310,149,2509,119.4762
SAN DIEGO,Apr 2016,CACF,2016,VOLUNTEERS OF AMERICA SOUTHWEST CA CORP,CHILD_SNACK_PM,21,152,23,11,186,1034,156,75,1265,60.2381
SAN DIEGO,Apr 2016,CACF,2016,VOLUNTEERS OF AMERICA SOUTHWEST CA CORP,HS_CHILD_BREAKFAST,21,226,0,0,226,896,0,0,896,42.6667
SAN DIEGO,Apr 2016,CACF,2016,VOLUNTEERS OF AMERICA SOUTHWEST CA CORP,HS_CHILD_LUNCH,21,226,0,0,226,1025,0,0,1025,48.8095
SAN DIEGO,Apr 2016,CACF,2016,VOLUNTEERS OF AMERICA SOUTHWEST CA CORP,HS_CHILD_SNACK_PM,21,226,0,0,226,573,0,0,573,27.2857
SAN DIEGO,May 2016,CACF,2016,VOLUNTEERS OF AMERICA SOUTHWEST CA CORP,CHILD_BREAKFAST,21,152,23,11,186,2036,308,148,2492,118.6667
SAN DIEGO,May 2016,CACF,2016,VOLUNTEERS OF AMERICA SOUTHWEST CA CORP,CHILD_LUNCH,21,152,23,11,186,1987,301,143,2431,115.7619
SAN DIEGO,May 2016,CACF,2016,VOLUNTEERS OF AMERICA SOUTHWEST CA CORP,CHILD_SNACK_PM,21,152,23,11,186,968,147,70,1185,56.4286
SAN DIEGO,May 2016,CACF,2016,VOLUNTEERS OF AMERICA SOUTHWEST CA CORP,HS_CHILD_BREAKFAST,21,226,0,0,226,913,0,0,913,43.4762
SAN DIEGO,May 2016,CACF,2016,VOLUNTEERS OF AMERICA SOUTHWEST CA CORP,HS_CHILD_LUNCH,21,226,0,0,226,1036,0,0,1036,49.3333
SAN DIEGO,May 2016,CACF,2016,VOLUNTEERS OF AMERICA SOUTHWEST CA CORP,HS_CHILD_SNACK_PM,21,226,0,0,226,598,0,0,598,28.4762
SAN DIEGO,Jun 2016,CACF,2016,VOLUNTEERS OF AMERICA SOUTHWEST CA CORP,CHILD_BREAKFAST,21,152,23,11,186,1735,263,125,2123,101.0952
SAN DIEGO,Jun 2016,CACF,2016,VOLUNTEERS OF AMERICA SOUTHWEST CA CORP,CHILD_LUNCH,21,152,23,11,186,1707,258,124,2089,99.4762
SAN DIEGO,Jun 2016,CACF,2016,VOLUNTEERS OF AMERICA SOUTHWEST CA CORP,CHILD_SNACK_PM,21,152,23,11,186,856,130,62,1048,49.9048
SAN DIEGO,Jun 2016,CACF,2016,VOLUNTEERS OF AMERICA SOUTHWEST CA CORP,HS_CHILD_BREAKFAST,21,226,0,0,226,867,0,0,867,41.2857
SAN DIEGO,Jun 2016,CACF,2016,VOLUNTEERS OF AMERICA SOUTHWEST CA CORP,HS_CHILD_LUNCH,21,226,0,0,226,947,0,0,947,45.0952
SAN DIEGO,Jun 2016,CACF,2016,VOLUNTEERS OF AMERICA SOUTHWEST CA CORP,HS_CHILD_SNACK_PM,21,226,0,0,226,571,0,0,571,27.1905
SAN DIEGO,Jul 2016,CACF,2016,VOLUNTEERS OF AMERICA SOUTHWEST CA CORP,CHILD_BREAKFAST,19,152,23,11,186,1522,230,110,1862,98
SAN DIEGO,Jul 2016,CACF,2016,VOLUNTEERS OF AMERICA SOUTHWEST CA CORP,CHILD_LUNCH,19,152,23,11,186,1300,197,94,1591,83.7368
SAN DIEGO,Jul 2016,CACF,2016,VOLUNTEERS OF AMERICA SOUTHWEST CA CORP,CHILD_SNACK_PM,19,152,23,11,186,878,133,63,1074,56.5263
SAN DIEGO,Jul 2016,CACF,2016,VOLUNTEERS OF AMERICA SOUTHWEST CA CORP,HS_CHILD_BREAKFAST,19,226,0,0,226,735,0,0,735,38.6842
SAN DIEGO,Jul 2016,CACF,2016,VOLUNTEERS OF AMERICA SOUTHWEST CA CORP,HS_CHILD_LUNCH,19,226,0,0,226,821,0,0,821,43.2105
SAN DIEGO,Jul 2016,CACF,2016,VOLUNTEERS OF AMERICA SOUTHWEST CA CORP,HS_CHILD_SNACK_PM,19,226,0,0,226,523,0,0,523,27.5263
SAN DIEGO,Oct 2015,CACF,2016,WESTERN CONSULTING & ANCILLARY SERVICES INC,ADULT_BREAKFAST,22,128,0,8,136,1564,0,98,1662,75.5455
SAN DIEGO,Oct 2015,CACF,2016,WESTERN CONSULTING & ANCILLARY SERVICES INC,ADULT_LUNCH,22,128,0,8,136,1771,0,111,1882,85.5455
SAN DIEGO,Oct 2015,CACF,2016,WESTERN CONSULTING & ANCILLARY SERVICES INC,ADULT_SNACK_PM,22,128,0,8,136,82,0,5,87,3.9545
SAN DIEGO,Nov 2015,CACF,2016,WESTERN CONSULTING & ANCILLARY SERVICES INC,ADULT_BREAKFAST,20,128,0,8,136,1387,0,87,1474,73.7
SAN DIEGO,Nov 2015,CACF,2016,WESTERN CONSULTING & ANCILLARY SERVICES INC,ADULT_LUNCH,20,128,0,8,136,1602,0,100,1702,85.1
SAN DIEGO,Nov 2015,CACF,2016,WESTERN CONSULTING & ANCILLARY SERVICES INC,ADULT_SNACK_PM,20,128,0,8,136,106,0,7,113,5.65
SAN DIEGO,Dec 2015,CACF,2016,WESTERN CONSULTING & ANCILLARY SERVICES INC,ADULT_BREAKFAST,22,128,0,8,136,1465,0,91,1556,70.7273
SAN DIEGO,Dec 2015,CACF,2016,WESTERN CONSULTING & ANCILLARY SERVICES INC,ADULT_LUNCH,22,128,0,8,136,1707,0,107,1814,82.4545
SAN DIEGO,Dec 2015,CACF,2016,WESTERN CONSULTING & ANCILLARY SERVICES INC,ADULT_SNACK_PM,22,128,0,8,136,70,0,4,74,3.3636
SAN DIEGO,Jan 2016,CACF,2016,WESTERN CONSULTING & ANCILLARY SERVICES INC,ADULT_BREAKFAST,20,128,0,8,136,1233,0,77,1310,65.5
SAN DIEGO,Jan 2016,CACF,2016,WESTERN CONSULTING & ANCILLARY SERVICES INC,ADULT_LUNCH,20,128,0,8,136,1459,0,91,1550,77.5
SAN DIEGO,Jan 2016,CACF,2016,WESTERN CONSULTING & ANCILLARY SERVICES INC,ADULT_SNACK_PM,20,128,0,8,136,57,0,4,61,3.05
SAN DIEGO,Feb 2016,CACF,2016,WESTERN CONSULTING & ANCILLARY SERVICES INC,ADULT_BREAKFAST,21,128,0,8,136,1231,0,77,1308,62.2857
SAN DIEGO,Feb 2016,CACF,2016,WESTERN CONSULTING & ANCILLARY SERVICES INC,ADULT_LUNCH,21,128,0,8,136,1498,0,94,1592,75.8095
SAN DIEGO,Feb 2016,CACF,2016,WESTERN CONSULTING & ANCILLARY SERVICES INC,ADULT_SNACK_PM,21,128,0,8,136,68,0,4,72,3.4286
SAN DIEGO,Mar 2016,CACF,2016,WESTERN CONSULTING & ANCILLARY SERVICES INC,ADULT_BREAKFAST,23,128,0,8,136,1417,0,89,1506,65.4783
SAN DIEGO,Mar 2016,CACF,2016,WESTERN CONSULTING & ANCILLARY SERVICES INC,ADULT_LUNCH,23,128,0,8,136,1676,0,105,1781,77.4348
SAN DIEGO,Apr 2016,CACF,2016,WESTERN CONSULTING & ANCILLARY SERVICES INC,ADULT_BREAKFAST,21,128,0,8,136,1325,0,83,1408,67.0476
SAN DIEGO,Apr 2016,CACF,2016,WESTERN CONSULTING & ANCILLARY SERVICES INC,ADULT_LUNCH,21,128,0,8,136,1612,0,101,1713,81.5714
SAN DIEGO,Apr 2016,CACF,2016,WESTERN CONSULTING & ANCILLARY SERVICES INC,ADULT_SNACK_PM,21,128,0,8,136,98,0,6,104,4.9524
SAN DIEGO,May 2016,CACF,2016,WESTERN CONSULTING & ANCILLARY SERVICES INC,ADULT_BREAKFAST,21,128,0,8,136,1356,0,85,1441,68.619
SAN DIEGO,May 2016,CACF,2016,WESTERN CONSULTING & ANCILLARY SERVICES INC,ADULT_LUNCH,21,128,0,8,136,1640,0,102,1742,82.9524
SAN DIEGO,May 2016,CACF,2016,WESTERN CONSULTING & ANCILLARY SERVICES INC,ADULT_SNACK_PM,21,128,0,8,136,99,0,6,105,5
SAN DIEGO,Jun 2016,CACF,2016,WESTERN CONSULTING & ANCILLARY SERVICES INC,ADULT_BREAKFAST,22,128,0,8,136,1403,0,88,1491,67.7727
SAN DIEGO,Jun 2016,CACF,2016,WESTERN CONSULTING & ANCILLARY SERVICES INC,ADULT_LUNCH,22,128,0,8,136,1670,0,104,1774,80.6364
SAN DIEGO,Jun 2016,CACF,2016,WESTERN CONSULTING & ANCILLARY SERVICES INC,ADULT_SNACK_PM,22,128,0,8,136,88,0,6,94,4.2727
SAN DIEGO,Jul 2016,CACF,2016,WESTERN CONSULTING & ANCILLARY SERVICES INC,ADULT_BREAKFAST,20,128,0,8,136,1283,0,80,1363,68.15
SAN DIEGO,Jul 2016,CACF,2016,WESTERN CONSULTING & ANCILLARY SERVICES INC,ADULT_LUNCH,20,128,0,8,136,1543,0,96,1639,81.95
SAN DIEGO,Jul 2016,CACF,2016,WESTERN CONSULTING & ANCILLARY SERVICES INC,ADULT_SNACK_PM,20,128,0,8,136,67,0,4,71,3.55
SAN DIEGO,Oct 2015,CACF,2016,YWCA OF SAN DIEGO COUNTY,ES_CHILD_BREAKFAST,31,106,0,0,106,637,0,0,637,20.5484
SAN DIEGO,Oct 2015,CACF,2016,YWCA OF SAN DIEGO COUNTY,ES_CHILD_SNACK_PM,31,106,0,0,106,228,0,0,228,7.3548
SAN DIEGO,Oct 2015,CACF,2016,YWCA OF SAN DIEGO COUNTY,ES_CHILD_SUPPER,31,106,0,0,106,934,0,0,934,30.129
SAN DIEGO,Nov 2015,CACF,2016,YWCA OF SAN DIEGO COUNTY,ES_CHILD_BREAKFAST,30,115,0,0,115,585,0,0,585,19.5
SAN DIEGO,Nov 2015,CACF,2016,YWCA OF SAN DIEGO COUNTY,ES_CHILD_SNACK_PM,30,115,0,0,115,228,0,0,228,7.6
SAN DIEGO,Nov 2015,CACF,2016,YWCA OF SAN DIEGO COUNTY,ES_CHILD_SUPPER,30,115,0,0,115,885,0,0,885,29.5
SAN DIEGO,Dec 2015,CACF,2016,YWCA OF SAN DIEGO COUNTY,ES_CHILD_BREAKFAST,31,103,0,0,103,582,0,0,582,18.7742
SAN DIEGO,Dec 2015,CACF,2016,YWCA OF SAN DIEGO COUNTY,ES_CHILD_SNACK_PM,31,103,0,0,103,116,0,0,116,3.7419
SAN DIEGO,Dec 2015,CACF,2016,YWCA OF SAN DIEGO COUNTY,ES_CHILD_SUPPER,31,103,0,0,103,818,0,0,818,26.3871
SAN DIEGO,Jan 2016,CACF,2016,YWCA OF SAN DIEGO COUNTY,ES_CHILD_BREAKFAST,31,120,0,0,120,657,0,0,657,21.1935
SAN DIEGO,Jan 2016,CACF,2016,YWCA OF SAN DIEGO COUNTY,ES_CHILD_SNACK_PM,31,120,0,0,120,234,0,0,234,7.5484
SAN DIEGO,Jan 2016,CACF,2016,YWCA OF SAN DIEGO COUNTY,ES_CHILD_SUPPER,31,120,0,0,120,940,0,0,940,30.3226
SAN DIEGO,Feb 2016,CACF,2016,YWCA OF SAN DIEGO COUNTY,ES_CHILD_BREAKFAST,29,116,0,0,116,688,0,0,688,23.7241
SAN DIEGO,Feb 2016,CACF,2016,YWCA OF SAN DIEGO COUNTY,ES_CHILD_SNACK_PM,29,116,0,0,116,303,0,0,303,10.4483
SAN DIEGO,Feb 2016,CACF,2016,YWCA OF SAN DIEGO COUNTY,ES_CHILD_SUPPER,29,116,0,0,116,847,0,0,847,29.2069
SAN DIEGO,Mar 2016,CACF,2016,YWCA OF SAN DIEGO COUNTY,ES_CHILD_BREAKFAST,31,120,0,0,120,632,0,0,632,20.3871
SAN DIEGO,Mar 2016,CACF,2016,YWCA OF SAN DIEGO COUNTY,ES_CHILD_SNACK_PM,31,120,0,0,120,396,0,0,396,12.7742
SAN DIEGO,Mar 2016,CACF,2016,YWCA OF SAN DIEGO COUNTY,ES_CHILD_SUPPER,31,120,0,0,120,1063,0,0,1063,34.2903
SAN DIEGO,Apr 2016,CACF,2016,YWCA OF SAN DIEGO COUNTY,ES_CHILD_BREAKFAST,30,104,0,0,104,635,0,0,635,21.1667
SAN DIEGO,Apr 2016,CACF,2016,YWCA OF SAN DIEGO COUNTY,ES_CHILD_SNACK_PM,30,104,0,0,104,397,0,0,397,13.2333
SAN DIEGO,Apr 2016,CACF,2016,YWCA OF SAN DIEGO COUNTY,ES_CHILD_SUPPER,30,104,0,0,104,1057,0,0,1057,35.2333
SAN DIEGO,May 2016,CACF,2016,YWCA OF SAN DIEGO COUNTY,ES_CHILD_BREAKFAST,31,112,0,0,112,695,0,0,695,22.4194
SAN DIEGO,May 2016,CACF,2016,YWCA OF SAN DIEGO COUNTY,ES_CHILD_SNACK_PM,31,112,0,0,112,481,0,0,481,15.5161
SAN DIEGO,May 2016,CACF,2016,YWCA OF SAN DIEGO COUNTY,ES_CHILD_SUPPER,31,112,0,0,112,1027,0,0,1027,33.129
SAN DIEGO,Jun 2016,CACF,2016,YWCA OF SAN DIEGO COUNTY,ES_CHILD_BREAKFAST,30,107,0,0,107,743,0,0,743,24.7667
SAN DIEGO,Jun 2016,CACF,2016,YWCA OF SAN DIEGO COUNTY,ES_CHILD_SNACK_PM,30,107,0,0,107,379,0,0,379,12.6333
SAN DIEGO,Jun 2016,CACF,2016,YWCA OF SAN DIEGO COUNTY,ES_CHILD_SUPPER,30,107,0,0,107,959,0,0,959,31.9667
SAN DIEGO,Jul 2016,CACF,2016,YWCA OF SAN DIEGO COUNTY,ES_CHILD_BREAKFAST,31,102,0,0,102,594,0,0,594,19.1613
SAN DIEGO,Jul 2016,CACF,2016,YWCA OF SAN DIEGO COUNTY,ES_CHILD_SNACK_PM,31,102,0,0,102,309,0,0,309,9.9677
SAN DIEGO,Jul 2016,CACF,2016,YWCA OF SAN DIEGO COUNTY,ES_CHILD_SUPPER,31,102,0,0,102,853,0,0,853,27.5161
